County,Name,Labor Force,Employment,Unemployment,Unemployment Rate
Anderson County,2012-Jan,22164,20689,1475,6.7
Anderson County,2012-Feb,22288,20880,1408,6.3
Anderson County,2012-Mar,22405,21101,1304,5.8
Anderson County,2012-Apr,22413,21153,1260,5.6
Anderson County,2012-May,22363,20988,1375,6.1
Anderson County,2012-Jun,22621,21043,1578,7
Anderson County,2012-Jul,22782,21200,1582,6.9
Anderson County,2012-Aug,22469,20976,1493,6.6
Anderson County,2012-Sep,22369,21009,1360,6.1
Anderson County,2012-Oct,22181,20836,1345,6.1
Anderson County,2012-Nov,22019,20717,1302,5.9
Anderson County,2012-Dec,21935,20596,1339,6.1
Anderson County,2013-Jan,22218,20724,1494,6.7
Anderson County,2013-Feb,22055,20695,1360,6.2
Anderson County,2013-Mar,21936,20656,1280,5.8
Anderson County,2013-Apr,22001,20799,1202,5.5
Anderson County,2013-May,22121,20883,1238,5.6
Anderson County,2013-Jun,22343,20912,1431,6.4
Anderson County,2013-Jul,22159,20755,1404,6.3
Anderson County,2013-Aug,21987,20666,1321,6
Anderson County,2013-Sep,21920,20634,1286,5.9
Anderson County,2013-Oct,21646,20449,1197,5.5
Anderson County,2013-Nov,21784,20638,1146,5.3
Anderson County,2013-Dec,21794,20721,1073,4.9
Anderson County,2014-Jan,21960,20823,1137,5.2
Anderson County,2014-Feb,21968,20825,1143,5.2
Anderson County,2014-Mar,21900,20826,1074,4.9
Anderson County,2014-Apr,21779,20834,945,4.3
Anderson County,2014-May,21802,20806,996,4.6
Anderson County,2014-Jun,21869,20755,1114,5.1
Anderson County,2014-Jul,21966,20798,1168,5.3
Anderson County,2014-Aug,21793,20685,1108,5.1
Anderson County,2014-Sep,21600,20609,991,4.6
Anderson County,2014-Oct,21531,20585,946,4.4
Anderson County,2014-Nov,21553,20643,910,4.2
Anderson County,2014-Dec,21391,20589,802,3.7
Anderson County,2015-Jan,22429,21514,915,4.1
Anderson County,2015-Feb,22359,21467,892,4
Anderson County,2015-Mar,22346,21489,857,3.8
Anderson County,2015-Apr,22736,21936,800,3.5
Anderson County,2015-May,22819,21947,872,3.8
Anderson County,2015-Jun,23105,22143,962,4.2
Anderson County,2015-Jul,23043,22038,1005,4.4
Anderson County,2015-Aug,23152,22226,926,4
Anderson County,2015-Sep,22918,22043,875,3.8
Anderson County,2015-Oct,23020,22131,889,3.9
Anderson County,2015-Nov,23125,22185,940,4.1
Anderson County,2015-Dec,23187,22261,926,4
Anderson County,2016-Jan,23338,22343,995,4.3
Anderson County,2016-Feb,23453,22467,986,4.2
Anderson County,2016-Mar,23567,22547,1020,4.3
Anderson County,2016-Apr,23427,22488,939,4
Anderson County,2016-May,23468,22529,939,4
Anderson County,2016-Jun,23590,22473,1117,4.7
Anderson County,2016-Jul,23684,22541,1143,4.8
Anderson County,2016-Aug,23600,22468,1132,4.8
Anderson County,2016-Sep,23626,22557,1069,4.5
Anderson County,2016-Oct,23578,22594,984,4.2
Anderson County,2016-Nov,23494,22537,957,4.1
Anderson County,2016-Dec,23394,22447,947,4
Anderson County,2017-Jan,22801,21793,1008,4.4
Anderson County,2017-Feb,22972,21988,984,4.3
Anderson County,2017-Mar,22872,21973,899,3.9
Anderson County,2017-Apr,23199,22376,823,3.5
Anderson County,2017-May,23084,22262,822,3.6
Anderson County,2017-Jun,23227,22298,929,4
Anderson County,2017-Jul,23259,22348,911,3.9
Anderson County,2017-Aug,23193,22339,854,3.7
Anderson County,2017-Sep,23183,22390,793,3.4
Anderson County,2017-Oct,23104,22396,708,3.1
Anderson County,2017-Nov,23132,22386,746,3.2
Anderson County,2017-Dec,22996,22305,691,3
Anderson County,2018-Jan,22872,22110,762,3.3
Anderson County,2018-Feb,23070,22309,761,3.3
Anderson County,2018-Mar,23012,22260,752,3.3
Anderson County,2018-Apr,23094,22412,682,3
Anderson County,2018-May,23187,22526,661,2.9
Anderson County,2018-Jun,23380,22577,803,3.4
Anderson County,2018-Jul,23404,22624,780,3.3
Anderson County,2018-Aug,23187,22465,722,3.1
Anderson County,2018-Sep,23197,22510,687,3
Anderson County,2018-Oct,23107,22429,678,2.9
Anderson County,2018-Nov,23257,22562,695,3
Anderson County,2018-Dec,23261,22544,717,3.1
Anderson County,2019-Jan,23206,22386,820,3.5
Anderson County,2019-Feb,23474,22715,759,3.2
Anderson County,2019-Mar,23070,22393,677,2.9
Anderson County,2019-Apr,22972,22392,580,2.5
Anderson County,2019-May,22934,22350,584,2.5
Anderson County,2019-Jun,23115,22397,718,3.1
Anderson County,2019-Jul,23327,22580,747,3.2
Anderson County,2019-Aug,23342,22642,700,3
Anderson County,2019-Sep,23306,22657,649,2.8
Anderson County,2019-Oct,23297,22650,647,2.8
Anderson County,2019-Nov,23114,22458,656,2.8
Anderson County,2019-Dec,23096,22475,621,2.7
Anderson County,2020-Jan,22898,22200,698,3
Anderson County,2020-Feb,23105,22447,658,2.8
Anderson County,2020-Mar,22714,21706,1008,4.4
Anderson County,2020-Apr,21760,20239,1521,7
Anderson County,2020-May,22389,20685,1704,7.6
Anderson County,2020-Jun,22651,20905,1746,7.7
Anderson County,2020-Jul,22993,21345,1648,7.2
Anderson County,2020-Aug,23094,21720,1374,5.9
Anderson County,2020-Sep,23017,21651,1366,5.9
Anderson County,2020-Oct,23309,22064,1245,5.3
Anderson County,2020-Nov,23364,22051,1313,5.6
Anderson County,2020-Dec,23133,21809,1324,5.7
Anderson County,2021-Jan,23126,21738,1388,6
Anderson County,2021-Feb,23225,21857,1368,5.9
Anderson County,2021-Mar,23302,22000,1302,5.6
Anderson County,2021-Apr,23130,21963,1167,5
Anderson County,2021-May,23030,21892,1138,4.9
Anderson County,2021-Jun,23176,21880,1296,5.6
Anderson County,2021-Jul,23331,22152,1179,5.1
Anderson County,2021-Aug,23361,22307,1054,4.5
Anderson County,2021-Sep,23343,22334,1009,4.3
Anderson County,2021-Oct,23351,22421,930,4
Anderson County,2021-Nov,23313,22435,878,3.8
Anderson County,2021-Dec,23120,22327,793,3.4
Anderson County,2022-Jan,23143,22236,907,3.9
Anderson County,2022-Feb,23324,22402,922,4
Anderson County,2022-Mar,23428,22673,755,3.2
Anderson County,2022-Apr,23324,22621,703,3
Anderson County,2022-May,23254,22529,725,3.1
Anderson County,2022-Jun,23333,22481,852,3.7
Anderson County,2022-Jul,23520(P),22655(P),865(P),3.7(P)
Andrews County,2012-Jan,8331,7973,358,4.3
Andrews County,2012-Feb,8420,8073,347,4.1
Andrews County,2012-Mar,8391,8070,321,3.8
Andrews County,2012-Apr,8434,8121,313,3.7
Andrews County,2012-May,8436,8101,335,4
Andrews County,2012-Jun,8534,8151,383,4.5
Andrews County,2012-Jul,8541,8155,386,4.5
Andrews County,2012-Aug,8488,8134,354,4.2
Andrews County,2012-Sep,8510,8192,318,3.7
Andrews County,2012-Oct,8750,8442,308,3.5
Andrews County,2012-Nov,8725,8414,311,3.6
Andrews County,2012-Dec,8733,8410,323,3.7
Andrews County,2013-Jan,8954,8572,382,4.3
Andrews County,2013-Feb,8937,8585,352,3.9
Andrews County,2013-Mar,8839,8497,342,3.9
Andrews County,2013-Apr,9070,8739,331,3.6
Andrews County,2013-May,9061,8699,362,4
Andrews County,2013-Jun,9219,8810,409,4.4
Andrews County,2013-Jul,9378,8986,392,4.2
Andrews County,2013-Aug,9350,8995,355,3.8
Andrews County,2013-Sep,9378,9024,354,3.8
Andrews County,2013-Oct,9243,8914,329,3.6
Andrews County,2013-Nov,9231,8912,319,3.5
Andrews County,2013-Dec,9173,8871,302,3.3
Andrews County,2014-Jan,9295,8971,324,3.5
Andrews County,2014-Feb,9459,9138,321,3.4
Andrews County,2014-Mar,9353,9053,300,3.2
Andrews County,2014-Apr,9312,9054,258,2.8
Andrews County,2014-May,9359,9071,288,3.1
Andrews County,2014-Jun,9513,9195,318,3.3
Andrews County,2014-Jul,9656,9328,328,3.4
Andrews County,2014-Aug,9598,9300,298,3.1
Andrews County,2014-Sep,9666,9387,279,2.9
Andrews County,2014-Oct,9702,9440,262,2.7
Andrews County,2014-Nov,9687,9430,257,2.7
Andrews County,2014-Dec,9541,9312,229,2.4
Andrews County,2015-Jan,9602,9326,276,2.9
Andrews County,2015-Feb,9591,9303,288,3
Andrews County,2015-Mar,9431,9137,294,3.1
Andrews County,2015-Apr,9468,9186,282,3
Andrews County,2015-May,9437,9116,321,3.4
Andrews County,2015-Jun,9423,9071,352,3.7
Andrews County,2015-Jul,9214,8850,364,4
Andrews County,2015-Aug,9181,8850,331,3.6
Andrews County,2015-Sep,9128,8789,339,3.7
Andrews County,2015-Oct,9124,8763,361,4
Andrews County,2015-Nov,9073,8713,360,4
Andrews County,2015-Dec,8966,8623,343,3.8
Andrews County,2016-Jan,8966,8599,367,4.1
Andrews County,2016-Feb,8927,8532,395,4.4
Andrews County,2016-Mar,8788,8346,442,5
Andrews County,2016-Apr,8750,8320,430,4.9
Andrews County,2016-May,8714,8290,424,4.9
Andrews County,2016-Jun,8710,8250,460,5.3
Andrews County,2016-Jul,8538,8089,449,5.3
Andrews County,2016-Aug,8475,8043,432,5.1
Andrews County,2016-Sep,8577,8161,416,4.9
Andrews County,2016-Oct,8550,8163,387,4.5
Andrews County,2016-Nov,8649,8283,366,4.2
Andrews County,2016-Dec,8674,8312,362,4.2
Andrews County,2017-Jan,8674,8302,372,4.3
Andrews County,2017-Feb,8812,8459,353,4
Andrews County,2017-Mar,8856,8550,306,3.5
Andrews County,2017-Apr,8846,8571,275,3.1
Andrews County,2017-May,8950,8689,261,2.9
Andrews County,2017-Jun,8980,8687,293,3.3
Andrews County,2017-Jul,9063,8788,275,3
Andrews County,2017-Aug,9064,8798,266,2.9
Andrews County,2017-Sep,9095,8844,251,2.8
Andrews County,2017-Oct,8920,8692,228,2.6
Andrews County,2017-Nov,8982,8745,237,2.6
Andrews County,2017-Dec,8965,8747,218,2.4
Andrews County,2018-Jan,8800,8552,248,2.8
Andrews County,2018-Feb,9013,8768,245,2.7
Andrews County,2018-Mar,9101,8863,238,2.6
Andrews County,2018-Apr,9202,8988,214,2.3
Andrews County,2018-May,9381,9174,207,2.2
Andrews County,2018-Jun,9471,9220,251,2.7
Andrews County,2018-Jul,9428,9190,238,2.5
Andrews County,2018-Aug,9384,9153,231,2.5
Andrews County,2018-Sep,9494,9276,218,2.3
Andrews County,2018-Oct,9504,9298,206,2.2
Andrews County,2018-Nov,9527,9322,205,2.2
Andrews County,2018-Dec,9548,9338,210,2.2
Andrews County,2019-Jan,9783,9543,240,2.5
Andrews County,2019-Feb,9881,9656,225,2.3
Andrews County,2019-Mar,9886,9668,218,2.2
Andrews County,2019-Apr,9755,9583,172,1.8
Andrews County,2019-May,9810,9623,187,1.9
Andrews County,2019-Jun,9829,9581,248,2.5
Andrews County,2019-Jul,9818,9569,249,2.5
Andrews County,2019-Aug,9819,9583,236,2.4
Andrews County,2019-Sep,9793,9560,233,2.4
Andrews County,2019-Oct,9666,9440,226,2.3
Andrews County,2019-Nov,9800,9572,228,2.3
Andrews County,2019-Dec,9687,9466,221,2.3
Andrews County,2020-Jan,9622,9380,242,2.5
Andrews County,2020-Feb,9569,9337,232,2.4
Andrews County,2020-Mar,9370,9019,351,3.7
Andrews County,2020-Apr,8817,7905,912,10.3
Andrews County,2020-May,9024,7871,1153,12.8
Andrews County,2020-Jun,9056,7905,1151,12.7
Andrews County,2020-Jul,8991,7941,1050,11.7
Andrews County,2020-Aug,8996,8120,876,9.7
Andrews County,2020-Sep,9124,8295,829,9.1
Andrews County,2020-Oct,8999,8254,745,8.3
Andrews County,2020-Nov,8988,8251,737,8.2
Andrews County,2020-Dec,8968,8259,709,7.9
Andrews County,2021-Jan,8911,8208,703,7.9
Andrews County,2021-Feb,9114,8422,692,7.6
Andrews County,2021-Mar,9168,8546,622,6.8
Andrews County,2021-Apr,9083,8527,556,6.1
Andrews County,2021-May,9112,8592,520,5.7
Andrews County,2021-Jun,9126,8555,571,6.3
Andrews County,2021-Jul,8926,8414,512,5.7
Andrews County,2021-Aug,8896,8414,482,5.4
Andrews County,2021-Sep,8967,8523,444,5
Andrews County,2021-Oct,8855,8423,432,4.9
Andrews County,2021-Nov,8902,8492,410,4.6
Andrews County,2021-Dec,8848,8464,384,4.3
Andrews County,2022-Jan,8882,8459,423,4.8
Andrews County,2022-Feb,8964,8553,411,4.6
Andrews County,2022-Mar,9009,8672,337,3.7
Andrews County,2022-Apr,8800,8492,308,3.5
Andrews County,2022-May,8737,8420,317,3.6
Andrews County,2022-Jun,8691,8340,351,4
Andrews County,2022-Jul,8701(P),8367(P),334(P),3.8(P)
Angelina County,2012-Jan,37586,34819,2767,7.4
Angelina County,2012-Feb,37689,34967,2722,7.2
Angelina County,2012-Mar,37630,35135,2495,6.6
Angelina County,2012-Apr,37852,35437,2415,6.4
Angelina County,2012-May,37880,35331,2549,6.7
Angelina County,2012-Jun,38205,35365,2840,7.4
Angelina County,2012-Jul,38020,35166,2854,7.5
Angelina County,2012-Aug,37684,35006,2678,7.1
Angelina County,2012-Sep,37865,35375,2490,6.6
Angelina County,2012-Oct,37683,35287,2396,6.4
Angelina County,2012-Nov,37540,35163,2377,6.3
Angelina County,2012-Dec,37696,35189,2507,6.7
Angelina County,2013-Jan,38016,35246,2770,7.3
Angelina County,2013-Feb,37873,35256,2617,6.9
Angelina County,2013-Mar,37725,35271,2454,6.5
Angelina County,2013-Apr,37856,35478,2378,6.3
Angelina County,2013-May,37791,35332,2459,6.5
Angelina County,2013-Jun,38166,35440,2726,7.1
Angelina County,2013-Jul,38082,35426,2656,7
Angelina County,2013-Aug,37809,35296,2513,6.6
Angelina County,2013-Sep,37989,35507,2482,6.5
Angelina County,2013-Oct,37661,35345,2316,6.1
Angelina County,2013-Nov,37844,35624,2220,5.9
Angelina County,2013-Dec,37891,35815,2076,5.5
Angelina County,2014-Jan,37894,35713,2181,5.8
Angelina County,2014-Feb,37911,35726,2185,5.8
Angelina County,2014-Mar,37826,35755,2071,5.5
Angelina County,2014-Apr,37674,35843,1831,4.9
Angelina County,2014-May,37800,35719,2081,5.5
Angelina County,2014-Jun,37868,35732,2136,5.6
Angelina County,2014-Jul,38005,35810,2195,5.8
Angelina County,2014-Aug,37572,35491,2081,5.5
Angelina County,2014-Sep,37620,35699,1921,5.1
Angelina County,2014-Oct,37387,35551,1836,4.9
Angelina County,2014-Nov,37483,35672,1811,4.8
Angelina County,2014-Dec,37214,35545,1669,4.5
Angelina County,2015-Jan,37392,35517,1875,5
Angelina County,2015-Feb,37364,35539,1825,4.9
Angelina County,2015-Mar,37245,35415,1830,4.9
Angelina County,2015-Apr,37913,35883,2030,5.4
Angelina County,2015-May,37931,35752,2179,5.7
Angelina County,2015-Jun,37980,35668,2312,6.1
Angelina County,2015-Jul,37549,35243,2306,6.1
Angelina County,2015-Aug,37342,35089,2253,6
Angelina County,2015-Sep,37094,34982,2112,5.7
Angelina County,2015-Oct,37072,34840,2232,6
Angelina County,2015-Nov,37118,34919,2199,5.9
Angelina County,2015-Dec,36946,34826,2120,5.7
Angelina County,2016-Jan,36894,34733,2161,5.9
Angelina County,2016-Feb,36958,34868,2090,5.7
Angelina County,2016-Mar,36829,34712,2117,5.7
Angelina County,2016-Apr,37070,35088,1982,5.3
Angelina County,2016-May,36869,34932,1937,5.3
Angelina County,2016-Jun,37104,34830,2274,6.1
Angelina County,2016-Jul,37169,34826,2343,6.3
Angelina County,2016-Aug,37308,34902,2406,6.4
Angelina County,2016-Sep,37286,34869,2417,6.5
Angelina County,2016-Oct,37063,34832,2231,6
Angelina County,2016-Nov,37230,35053,2177,5.8
Angelina County,2016-Dec,37184,35006,2178,5.9
Angelina County,2017-Jan,36858,34535,2323,6.3
Angelina County,2017-Feb,37052,34810,2242,6.1
Angelina County,2017-Mar,36823,34768,2055,5.6
Angelina County,2017-Apr,36781,34897,1884,5.1
Angelina County,2017-May,36470,34646,1824,5
Angelina County,2017-Jun,36569,34623,1946,5.3
Angelina County,2017-Jul,36270,34397,1873,5.2
Angelina County,2017-Aug,36257,34392,1865,5.1
Angelina County,2017-Sep,36198,34526,1672,4.6
Angelina County,2017-Oct,35716,34182,1534,4.3
Angelina County,2017-Nov,35781,34171,1610,4.5
Angelina County,2017-Dec,35771,34219,1552,4.3
Angelina County,2018-Jan,35680,33968,1712,4.8
Angelina County,2018-Feb,35794,34132,1662,4.6
Angelina County,2018-Mar,35888,34294,1594,4.4
Angelina County,2018-Apr,35823,34345,1478,4.1
Angelina County,2018-May,35706,34260,1446,4
Angelina County,2018-Jun,35872,34194,1678,4.7
Angelina County,2018-Jul,35889,34232,1657,4.6
Angelina County,2018-Aug,35612,34003,1609,4.5
Angelina County,2018-Sep,35606,34064,1542,4.3
Angelina County,2018-Oct,35489,34033,1456,4.1
Angelina County,2018-Nov,35574,34098,1476,4.1
Angelina County,2018-Dec,35493,33989,1504,4.2
Angelina County,2019-Jan,35370,33672,1698,4.8
Angelina County,2019-Feb,35474,33939,1535,4.3
Angelina County,2019-Mar,35369,33967,1402,4
Angelina County,2019-Apr,35070,33860,1210,3.5
Angelina County,2019-May,34946,33708,1238,3.5
Angelina County,2019-Jun,35273,33767,1506,4.3
Angelina County,2019-Jul,35326,33791,1535,4.3
Angelina County,2019-Aug,35255,33804,1451,4.1
Angelina County,2019-Sep,35527,34132,1395,3.9
Angelina County,2019-Oct,35545,34203,1342,3.8
Angelina County,2019-Nov,35467,34107,1360,3.8
Angelina County,2019-Dec,35427,34115,1312,3.7
Angelina County,2020-Jan,35124,33599,1525,4.3
Angelina County,2020-Feb,35378,33963,1415,4
Angelina County,2020-Mar,34972,32814,2158,6.2
Angelina County,2020-Apr,33525,29957,3568,10.6
Angelina County,2020-May,34510,30831,3679,10.7
Angelina County,2020-Jun,35508,31930,3578,10.1
Angelina County,2020-Jul,35280,31917,3363,9.5
Angelina County,2020-Aug,35273,32529,2744,7.8
Angelina County,2020-Sep,35377,32648,2729,7.7
Angelina County,2020-Oct,35656,33238,2418,6.8
Angelina County,2020-Nov,35789,33285,2504,7
Angelina County,2020-Dec,35834,33291,2543,7.1
Angelina County,2021-Jan,35693,32923,2770,7.8
Angelina County,2021-Feb,35868,33175,2693,7.5
Angelina County,2021-Mar,35773,33214,2559,7.2
Angelina County,2021-Apr,35860,33488,2372,6.6
Angelina County,2021-May,35537,33265,2272,6.4
Angelina County,2021-Jun,35920,33338,2582,7.2
Angelina County,2021-Jul,35745,33320,2425,6.8
Angelina County,2021-Aug,35674,33361,2313,6.5
Angelina County,2021-Sep,35693,33585,2108,5.9
Angelina County,2021-Oct,35774,33758,2016,5.6
Angelina County,2021-Nov,35792,33864,1928,5.4
Angelina County,2021-Dec,35714,33880,1834,5.1
Angelina County,2022-Jan,35551,33493,2058,5.8
Angelina County,2022-Feb,35792,33753,2039,5.7
Angelina County,2022-Mar,35730,34088,1642,4.6
Angelina County,2022-Apr,35637,34106,1531,4.3
Angelina County,2022-May,35469,33850,1619,4.6
Angelina County,2022-Jun,35734,33885,1849,5.2
Angelina County,2022-Jul,35684(P),33866(P),1818(P),5.1(P)
Aransas County,2012-Jan,9820,9024,796,8.1
Aransas County,2012-Feb,9871,9112,759,7.7
Aransas County,2012-Mar,9859,9173,686,7
Aransas County,2012-Apr,9921,9275,646,6.5
Aransas County,2012-May,9937,9271,666,6.7
Aransas County,2012-Jun,9985,9250,735,7.4
Aransas County,2012-Jul,9976,9237,739,7.4
Aransas County,2012-Aug,9927,9235,692,7
Aransas County,2012-Sep,9957,9306,651,6.5
Aransas County,2012-Oct,9952,9334,618,6.2
Aransas County,2012-Nov,9947,9339,608,6.1
Aransas County,2012-Dec,9878,9237,641,6.5
Aransas County,2013-Jan,9940,9207,733,7.4
Aransas County,2013-Feb,10008,9333,675,6.7
Aransas County,2013-Mar,9999,9356,643,6.4
Aransas County,2013-Apr,10053,9426,627,6.2
Aransas County,2013-May,10056,9407,649,6.5
Aransas County,2013-Jun,10132,9407,725,7.2
Aransas County,2013-Jul,10094,9391,703,7
Aransas County,2013-Aug,10038,9378,660,6.6
Aransas County,2013-Sep,10093,9411,682,6.8
Aransas County,2013-Oct,10025,9387,638,6.4
Aransas County,2013-Nov,10083,9454,629,6.2
Aransas County,2013-Dec,10060,9450,610,6.1
Aransas County,2014-Jan,10078,9443,635,6.3
Aransas County,2014-Feb,10212,9586,626,6.1
Aransas County,2014-Mar,10240,9649,591,5.8
Aransas County,2014-Apr,10145,9646,499,4.9
Aransas County,2014-May,10202,9647,555,5.4
Aransas County,2014-Jun,10217,9624,593,5.8
Aransas County,2014-Jul,10220,9600,620,6.1
Aransas County,2014-Aug,10162,9569,593,5.8
Aransas County,2014-Sep,10218,9666,552,5.4
Aransas County,2014-Oct,10234,9691,543,5.3
Aransas County,2014-Nov,10201,9664,537,5.3
Aransas County,2014-Dec,10117,9604,513,5.1
Aransas County,2015-Jan,10044,9478,566,5.6
Aransas County,2015-Feb,10032,9515,517,5.2
Aransas County,2015-Mar,10085,9591,494,4.9
Aransas County,2015-Apr,10098,9636,462,4.6
Aransas County,2015-May,10130,9651,479,4.7
Aransas County,2015-Jun,10120,9604,516,5.1
Aransas County,2015-Jul,10061,9531,530,5.3
Aransas County,2015-Aug,10049,9536,513,5.1
Aransas County,2015-Sep,10040,9524,516,5.1
Aransas County,2015-Oct,10047,9538,509,5.1
Aransas County,2015-Nov,10053,9516,537,5.3
Aransas County,2015-Dec,10017,9486,531,5.3
Aransas County,2016-Jan,10079,9514,565,5.6
Aransas County,2016-Feb,10224,9668,556,5.4
Aransas County,2016-Mar,10280,9722,558,5.4
Aransas County,2016-Apr,10246,9722,524,5.1
Aransas County,2016-May,10244,9743,501,4.9
Aransas County,2016-Jun,10286,9716,570,5.5
Aransas County,2016-Jul,10291,9697,594,5.8
Aransas County,2016-Aug,10278,9692,586,5.7
Aransas County,2016-Sep,10220,9615,605,5.9
Aransas County,2016-Oct,10231,9633,598,5.8
Aransas County,2016-Nov,10273,9674,599,5.8
Aransas County,2016-Dec,10250,9637,613,6
Aransas County,2017-Jan,10124,9426,698,6.9
Aransas County,2017-Feb,10234,9555,679,6.6
Aransas County,2017-Mar,10320,9705,615,6
Aransas County,2017-Apr,10239,9682,557,5.4
Aransas County,2017-May,10199,9662,537,5.3
Aransas County,2017-Jun,10191,9636,555,5.4
Aransas County,2017-Jul,10065,9523,542,5.4
Aransas County,2017-Aug,10030,9483,547,5.5
Aransas County,2017-Sep,10549,9428,1121,10.6
Aransas County,2017-Oct,10397,9487,910,8.8
Aransas County,2017-Nov,10378,9488,890,8.6
Aransas County,2017-Dec,10365,9561,804,7.8
Aransas County,2018-Jan,9638,8811,827,8.6
Aransas County,2018-Feb,9653,8936,717,7.4
Aransas County,2018-Mar,9659,8999,660,6.8
Aransas County,2018-Apr,9594,9005,589,6.1
Aransas County,2018-May,9544,9002,542,5.7
Aransas County,2018-Jun,9529,8942,587,6.2
Aransas County,2018-Jul,9456,8916,540,5.7
Aransas County,2018-Aug,9366,8860,506,5.4
Aransas County,2018-Sep,9303,8803,500,5.4
Aransas County,2018-Oct,9328,8870,458,4.9
Aransas County,2018-Nov,9323,8882,441,4.7
Aransas County,2018-Dec,9338,8894,444,4.8
Aransas County,2019-Jan,9208,8710,498,5.4
Aransas County,2019-Feb,9229,8774,455,4.9
Aransas County,2019-Mar,9212,8802,410,4.5
Aransas County,2019-Apr,9174,8826,348,3.8
Aransas County,2019-May,9151,8802,349,3.8
Aransas County,2019-Jun,9195,8777,418,4.5
Aransas County,2019-Jul,9194,8770,424,4.6
Aransas County,2019-Aug,9197,8804,393,4.3
Aransas County,2019-Sep,9111,8752,359,3.9
Aransas County,2019-Oct,9135,8782,353,3.9
Aransas County,2019-Nov,9129,8772,357,3.9
Aransas County,2019-Dec,9137,8783,354,3.9
Aransas County,2020-Jan,9180,8772,408,4.4
Aransas County,2020-Feb,9266,8883,383,4.1
Aransas County,2020-Mar,9189,8596,593,6.5
Aransas County,2020-Apr,8676,7541,1135,13.1
Aransas County,2020-May,8919,7862,1057,11.9
Aransas County,2020-Jun,9114,8156,958,10.5
Aransas County,2020-Jul,9111,8173,938,10.3
Aransas County,2020-Aug,9136,8376,760,8.3
Aransas County,2020-Sep,9113,8352,761,8.4
Aransas County,2020-Oct,9168,8490,678,7.4
Aransas County,2020-Nov,9169,8451,718,7.8
Aransas County,2020-Dec,9189,8450,739,8
Aransas County,2021-Jan,9135,8358,777,8.5
Aransas County,2021-Feb,9239,8478,761,8.2
Aransas County,2021-Mar,9372,8614,758,8.1
Aransas County,2021-Apr,9263,8583,680,7.3
Aransas County,2021-May,9236,8574,662,7.2
Aransas County,2021-Jun,9280,8540,740,8
Aransas County,2021-Jul,9305,8609,696,7.5
Aransas County,2021-Aug,9285,8618,667,7.2
Aransas County,2021-Sep,9251,8629,622,6.7
Aransas County,2021-Oct,9239,8649,590,6.4
Aransas County,2021-Nov,9234,8669,565,6.1
Aransas County,2021-Dec,9231,8691,540,5.8
Aransas County,2022-Jan,9198,8571,627,6.8
Aransas County,2022-Feb,9336,8734,602,6.4
Aransas County,2022-Mar,9368,8873,495,5.3
Aransas County,2022-Apr,9246,8775,471,5.1
Aransas County,2022-May,9264,8784,480,5.2
Aransas County,2022-Jun,9316,8776,540,5.8
Aransas County,2022-Jul,9364(P),8817(P),547(P),5.8(P)
Archer County,2012-Jan,4400,4142,258,5.9
Archer County,2012-Feb,4389,4132,257,5.9
Archer County,2012-Mar,4383,4153,230,5.2
Archer County,2012-Apr,4388,4166,222,5.1
Archer County,2012-May,4396,4159,237,5.4
Archer County,2012-Jun,4420,4154,266,6
Archer County,2012-Jul,4404,4135,269,6.1
Archer County,2012-Aug,4331,4089,242,5.6
Archer County,2012-Sep,4331,4110,221,5.1
Archer County,2012-Oct,4296,4083,213,5
Archer County,2012-Nov,4303,4088,215,5
Archer County,2012-Dec,4284,4062,222,5.2
Archer County,2013-Jan,4218,3973,245,5.8
Archer County,2013-Feb,4204,3972,232,5.5
Archer County,2013-Mar,4186,3961,225,5.4
Archer County,2013-Apr,4235,4015,220,5.2
Archer County,2013-May,4255,4030,225,5.3
Archer County,2013-Jun,4294,4041,253,5.9
Archer County,2013-Jul,4277,4040,237,5.5
Archer County,2013-Aug,4203,3985,218,5.2
Archer County,2013-Sep,4210,3994,216,5.1
Archer County,2013-Oct,4204,3994,210,5
Archer County,2013-Nov,4188,3982,206,4.9
Archer County,2013-Dec,4192,4005,187,4.5
Archer County,2014-Jan,4221,4013,208,4.9
Archer County,2014-Feb,4256,4046,210,4.9
Archer County,2014-Mar,4264,4066,198,4.6
Archer County,2014-Apr,4248,4070,178,4.2
Archer County,2014-May,4265,4071,194,4.5
Archer County,2014-Jun,4287,4078,209,4.9
Archer County,2014-Jul,4280,4064,216,5
Archer County,2014-Aug,4235,4030,205,4.8
Archer County,2014-Sep,4228,4040,188,4.4
Archer County,2014-Oct,4213,4034,179,4.2
Archer County,2014-Nov,4185,4006,179,4.3
Archer County,2014-Dec,4143,3984,159,3.8
Archer County,2015-Jan,4109,3921,188,4.6
Archer County,2015-Feb,4127,3952,175,4.2
Archer County,2015-Mar,4138,3963,175,4.2
Archer County,2015-Apr,4142,3970,172,4.2
Archer County,2015-May,4172,3980,192,4.6
Archer County,2015-Jun,4181,3975,206,4.9
Archer County,2015-Jul,4144,3946,198,4.8
Archer County,2015-Aug,4099,3914,185,4.5
Archer County,2015-Sep,4093,3906,187,4.6
Archer County,2015-Oct,4102,3925,177,4.3
Archer County,2015-Nov,4094,3915,179,4.4
Archer County,2015-Dec,4092,3921,171,4.2
Archer County,2016-Jan,4046,3856,190,4.7
Archer County,2016-Feb,4108,3929,179,4.4
Archer County,2016-Mar,4140,3955,185,4.5
Archer County,2016-Apr,4125,3957,168,4.1
Archer County,2016-May,4124,3958,166,4
Archer County,2016-Jun,4136,3940,196,4.7
Archer County,2016-Jul,4095,3908,187,4.6
Archer County,2016-Aug,4078,3900,178,4.4
Archer County,2016-Sep,4042,3860,182,4.5
Archer County,2016-Oct,4066,3892,174,4.3
Archer County,2016-Nov,4059,3898,161,4
Archer County,2016-Dec,4069,3912,157,3.9
Archer County,2017-Jan,4066,3901,165,4.1
Archer County,2017-Feb,4112,3951,161,3.9
Archer County,2017-Mar,4157,4007,150,3.6
Archer County,2017-Apr,4154,4021,133,3.2
Archer County,2017-May,4142,4004,138,3.3
Archer County,2017-Jun,4135,3986,149,3.6
Archer County,2017-Jul,4091,3953,138,3.4
Archer County,2017-Aug,4086,3948,138,3.4
Archer County,2017-Sep,4073,3941,132,3.2
Archer County,2017-Oct,4092,3971,121,3
Archer County,2017-Nov,4108,3982,126,3.1
Archer County,2017-Dec,4109,3990,119,2.9
Archer County,2018-Jan,4069,3935,134,3.3
Archer County,2018-Feb,4112,3979,133,3.2
Archer County,2018-Mar,4133,4002,131,3.2
Archer County,2018-Apr,4119,4007,112,2.7
Archer County,2018-May,4133,4018,115,2.8
Archer County,2018-Jun,4131,3994,137,3.3
Archer County,2018-Jul,4096,3962,134,3.3
Archer County,2018-Aug,4093,3963,130,3.2
Archer County,2018-Sep,4081,3948,133,3.3
Archer County,2018-Oct,4082,3961,121,3
Archer County,2018-Nov,4091,3973,118,2.9
Archer County,2018-Dec,4076,3957,119,2.9
Archer County,2019-Jan,3945,3813,132,3.3
Archer County,2019-Feb,3967,3840,127,3.2
Archer County,2019-Mar,3976,3857,119,3
Archer County,2019-Apr,3941,3844,97,2.5
Archer County,2019-May,3942,3845,97,2.5
Archer County,2019-Jun,3972,3851,121,3
Archer County,2019-Jul,3974,3851,123,3.1
Archer County,2019-Aug,3987,3872,115,2.9
Archer County,2019-Sep,3966,3857,109,2.7
Archer County,2019-Oct,3959,3854,105,2.7
Archer County,2019-Nov,3941,3839,102,2.6
Archer County,2019-Dec,3956,3857,99,2.5
Archer County,2020-Jan,4022,3906,116,2.9
Archer County,2020-Feb,4042,3928,114,2.8
Archer County,2020-Mar,3981,3815,166,4.2
Archer County,2020-Apr,3718,3433,285,7.7
Archer County,2020-May,3810,3537,273,7.2
Archer County,2020-Jun,3933,3657,276,7
Archer County,2020-Jul,3939,3680,259,6.6
Archer County,2020-Aug,3972,3765,207,5.2
Archer County,2020-Sep,3944,3737,207,5.2
Archer County,2020-Oct,3990,3802,188,4.7
Archer County,2020-Nov,3976,3780,196,4.9
Archer County,2020-Dec,3977,3775,202,5.1
Archer County,2021-Jan,3980,3771,209,5.3
Archer County,2021-Feb,4026,3820,206,5.1
Archer County,2021-Mar,4045,3850,195,4.8
Archer County,2021-Apr,4001,3839,162,4
Archer County,2021-May,3970,3804,166,4.2
Archer County,2021-Jun,3982,3798,184,4.6
Archer County,2021-Jul,3972,3803,169,4.3
Archer County,2021-Aug,3969,3810,159,4
Archer County,2021-Sep,3968,3820,148,3.7
Archer County,2021-Oct,3939,3796,143,3.6
Archer County,2021-Nov,3925,3786,139,3.5
Archer County,2021-Dec,3925,3801,124,3.2
Archer County,2022-Jan,3947,3794,153,3.9
Archer County,2022-Feb,4033,3879,154,3.8
Archer County,2022-Mar,4067,3942,125,3.1
Archer County,2022-Apr,4027,3914,113,2.8
Archer County,2022-May,4009,3886,123,3.1
Archer County,2022-Jun,4035,3887,148,3.7
Archer County,2022-Jul,4062(P),3921(P),141(P),3.5(P)
Armstrong County,2012-Jan,1020,967,53,5.2
Armstrong County,2012-Feb,1014,963,51,5
Armstrong County,2012-Mar,1018,972,46,4.5
Armstrong County,2012-Apr,1031,986,45,4.4
Armstrong County,2012-May,1030,983,47,4.6
Armstrong County,2012-Jun,1038,989,49,4.7
Armstrong County,2012-Jul,1040,989,51,4.9
Armstrong County,2012-Aug,1018,974,44,4.3
Armstrong County,2012-Sep,1026,986,40,3.9
Armstrong County,2012-Oct,1024,987,37,3.6
Armstrong County,2012-Nov,1026,986,40,3.9
Armstrong County,2012-Dec,1013,972,41,4
Armstrong County,2013-Jan,990,945,45,4.5
Armstrong County,2013-Feb,990,947,43,4.3
Armstrong County,2013-Mar,983,942,41,4.2
Armstrong County,2013-Apr,1009,970,39,3.9
Armstrong County,2013-May,1017,974,43,4.2
Armstrong County,2013-Jun,1024,977,47,4.6
Armstrong County,2013-Jul,1022,978,44,4.3
Armstrong County,2013-Aug,1001,962,39,3.9
Armstrong County,2013-Sep,1011,971,40,4
Armstrong County,2013-Oct,1008,972,36,3.6
Armstrong County,2013-Nov,993,958,35,3.5
Armstrong County,2013-Dec,1000,968,32,3.2
Armstrong County,2014-Jan,990,952,38,3.8
Armstrong County,2014-Feb,1008,970,38,3.8
Armstrong County,2014-Mar,1003,971,32,3.2
Armstrong County,2014-Apr,1017,986,31,3
Armstrong County,2014-May,1020,987,33,3.2
Armstrong County,2014-Jun,1019,983,36,3.5
Armstrong County,2014-Jul,1013,975,38,3.8
Armstrong County,2014-Aug,990,958,32,3.2
Armstrong County,2014-Sep,997,966,31,3.1
Armstrong County,2014-Oct,1001,973,28,2.8
Armstrong County,2014-Nov,990,962,28,2.8
Armstrong County,2014-Dec,978,953,25,2.6
Armstrong County,2015-Jan,963,935,28,2.9
Armstrong County,2015-Feb,981,954,27,2.8
Armstrong County,2015-Mar,988,964,24,2.4
Armstrong County,2015-Apr,982,960,22,2.2
Armstrong County,2015-May,992,968,24,2.4
Armstrong County,2015-Jun,986,959,27,2.7
Armstrong County,2015-Jul,976,948,28,2.9
Armstrong County,2015-Aug,959,934,25,2.6
Armstrong County,2015-Sep,968,942,26,2.7
Armstrong County,2015-Oct,973,946,27,2.8
Armstrong County,2015-Nov,967,939,28,2.9
Armstrong County,2015-Dec,969,945,24,2.5
Armstrong County,2016-Jan,910,887,23,2.5
Armstrong County,2016-Feb,943,919,24,2.5
Armstrong County,2016-Mar,952,927,25,2.6
Armstrong County,2016-Apr,954,931,23,2.4
Armstrong County,2016-May,961,939,22,2.3
Armstrong County,2016-Jun,945,917,28,3
Armstrong County,2016-Jul,928,898,30,3.2
Armstrong County,2016-Aug,935,904,31,3.3
Armstrong County,2016-Sep,924,895,29,3.1
Armstrong County,2016-Oct,923,895,28,3
Armstrong County,2016-Nov,921,894,27,2.9
Armstrong County,2016-Dec,919,892,27,2.9
Armstrong County,2017-Jan,897,868,29,3.2
Armstrong County,2017-Feb,914,886,28,3.1
Armstrong County,2017-Mar,929,906,23,2.5
Armstrong County,2017-Apr,930,909,21,2.3
Armstrong County,2017-May,926,905,21,2.3
Armstrong County,2017-Jun,917,893,24,2.6
Armstrong County,2017-Jul,897,871,26,2.9
Armstrong County,2017-Aug,903,879,24,2.7
Armstrong County,2017-Sep,900,877,23,2.6
Armstrong County,2017-Oct,911,888,23,2.5
Armstrong County,2017-Nov,903,880,23,2.5
Armstrong County,2017-Dec,904,880,24,2.7
Armstrong County,2018-Jan,897,870,27,3
Armstrong County,2018-Feb,910,887,23,2.5
Armstrong County,2018-Mar,931,906,25,2.7
Armstrong County,2018-Apr,920,896,24,2.6
Armstrong County,2018-May,930,907,23,2.5
Armstrong County,2018-Jun,919,891,28,3
Armstrong County,2018-Jul,913,883,30,3.3
Armstrong County,2018-Aug,921,891,30,3.3
Armstrong County,2018-Sep,914,887,27,3
Armstrong County,2018-Oct,902,882,20,2.2
Armstrong County,2018-Nov,904,882,22,2.4
Armstrong County,2018-Dec,892,871,21,2.4
Armstrong County,2019-Jan,894,866,28,3.1
Armstrong County,2019-Feb,914,885,29,3.2
Armstrong County,2019-Mar,924,898,26,2.8
Armstrong County,2019-Apr,918,897,21,2.3
Armstrong County,2019-May,928,905,23,2.5
Armstrong County,2019-Jun,919,894,25,2.7
Armstrong County,2019-Jul,914,889,25,2.7
Armstrong County,2019-Aug,930,904,26,2.8
Armstrong County,2019-Sep,917,893,24,2.6
Armstrong County,2019-Oct,927,905,22,2.4
Armstrong County,2019-Nov,916,893,23,2.5
Armstrong County,2019-Dec,921,897,24,2.6
Armstrong County,2020-Jan,906,878,28,3.1
Armstrong County,2020-Feb,915,888,27,3
Armstrong County,2020-Mar,902,863,39,4.3
Armstrong County,2020-Apr,820,771,49,6
Armstrong County,2020-May,862,813,49,5.7
Armstrong County,2020-Jun,878,832,46,5.2
Armstrong County,2020-Jul,884,842,42,4.8
Armstrong County,2020-Aug,905,870,35,3.9
Armstrong County,2020-Sep,900,864,36,4
Armstrong County,2020-Oct,915,882,33,3.6
Armstrong County,2020-Nov,903,868,35,3.9
Armstrong County,2020-Dec,905,867,38,4.2
Armstrong County,2021-Jan,915,874,41,4.5
Armstrong County,2021-Feb,931,891,40,4.3
Armstrong County,2021-Mar,946,906,40,4.2
Armstrong County,2021-Apr,935,900,35,3.7
Armstrong County,2021-May,922,888,34,3.7
Armstrong County,2021-Jun,916,879,37,4
Armstrong County,2021-Jul,911,878,33,3.6
Armstrong County,2021-Aug,920,888,32,3.5
Armstrong County,2021-Sep,912,886,26,2.9
Armstrong County,2021-Oct,916,891,25,2.7
Armstrong County,2021-Nov,907,882,25,2.8
Armstrong County,2021-Dec,906,883,23,2.5
Armstrong County,2022-Jan,909,883,26,2.9
Armstrong County,2022-Feb,944,915,29,3.1
Armstrong County,2022-Mar,963,940,23,2.4
Armstrong County,2022-Apr,948,928,20,2.1
Armstrong County,2022-May,933,911,22,2.4
Armstrong County,2022-Jun,926,900,26,2.8
Armstrong County,2022-Jul,945(P),920(P),25(P),2.6(P)
Atascosa County,2012-Jan,19751,18303,1448,7.3
Atascosa County,2012-Feb,19839,18405,1434,7.2
Atascosa County,2012-Mar,19858,18526,1332,6.7
Atascosa County,2012-Apr,19924,18661,1263,6.3
Atascosa County,2012-May,19978,18667,1311,6.6
Atascosa County,2012-Jun,20230,18738,1492,7.4
Atascosa County,2012-Jul,20247,18751,1496,7.4
Atascosa County,2012-Aug,20100,18715,1385,6.9
Atascosa County,2012-Sep,20105,18850,1255,6.2
Atascosa County,2012-Oct,20097,18857,1240,6.2
Atascosa County,2012-Nov,20085,18884,1201,6
Atascosa County,2012-Dec,20055,18820,1235,6.2
Atascosa County,2013-Jan,19893,18527,1366,6.9
Atascosa County,2013-Feb,19968,18672,1296,6.5
Atascosa County,2013-Mar,19917,18686,1231,6.2
Atascosa County,2013-Apr,20113,18932,1181,5.9
Atascosa County,2013-May,20218,18972,1246,6.2
Atascosa County,2013-Jun,20461,19039,1422,6.9
Atascosa County,2013-Jul,20520,19129,1391,6.8
Atascosa County,2013-Aug,20300,18999,1301,6.4
Atascosa County,2013-Sep,20377,19073,1304,6.4
Atascosa County,2013-Oct,20219,18989,1230,6.1
Atascosa County,2013-Nov,20253,19088,1165,5.8
Atascosa County,2013-Dec,20231,19136,1095,5.4
Atascosa County,2014-Jan,20009,18876,1133,5.7
Atascosa County,2014-Feb,20220,19082,1138,5.6
Atascosa County,2014-Mar,20278,19213,1065,5.3
Atascosa County,2014-Apr,20306,19364,942,4.6
Atascosa County,2014-May,20411,19389,1022,5
Atascosa County,2014-Jun,20548,19430,1118,5.4
Atascosa County,2014-Jul,20573,19436,1137,5.5
Atascosa County,2014-Aug,20382,19307,1075,5.3
Atascosa County,2014-Sep,20395,19386,1009,4.9
Atascosa County,2014-Oct,20420,19499,921,4.5
Atascosa County,2014-Nov,20393,19501,892,4.4
Atascosa County,2014-Dec,20179,19388,791,3.9
Atascosa County,2015-Jan,20089,19168,921,4.6
Atascosa County,2015-Feb,20266,19344,922,4.5
Atascosa County,2015-Mar,20360,19450,910,4.5
Atascosa County,2015-Apr,20492,19607,885,4.3
Atascosa County,2015-May,20662,19687,975,4.7
Atascosa County,2015-Jun,20656,19613,1043,5
Atascosa County,2015-Jul,20656,19592,1064,5.2
Atascosa County,2015-Aug,20520,19522,998,4.9
Atascosa County,2015-Sep,20596,19587,1009,4.9
Atascosa County,2015-Oct,20690,19666,1024,4.9
Atascosa County,2015-Nov,20794,19735,1059,5.1
Atascosa County,2015-Dec,20767,19748,1019,4.9
Atascosa County,2016-Jan,20507,19432,1075,5.2
Atascosa County,2016-Feb,20879,19770,1109,5.3
Atascosa County,2016-Mar,21055,19890,1165,5.5
Atascosa County,2016-Apr,21087,19966,1121,5.3
Atascosa County,2016-May,21108,20023,1085,5.1
Atascosa County,2016-Jun,21118,19935,1183,5.6
Atascosa County,2016-Jul,21168,19927,1241,5.9
Atascosa County,2016-Aug,21152,19956,1196,5.7
Atascosa County,2016-Sep,21107,19947,1160,5.5
Atascosa County,2016-Oct,21028,19957,1071,5.1
Atascosa County,2016-Nov,21093,20048,1045,5
Atascosa County,2016-Dec,21066,20017,1049,5
Atascosa County,2017-Jan,20630,19527,1103,5.3
Atascosa County,2017-Feb,20761,19699,1062,5.1
Atascosa County,2017-Mar,20872,19902,970,4.6
Atascosa County,2017-Apr,20837,19975,862,4.1
Atascosa County,2017-May,20755,19909,846,4.1
Atascosa County,2017-Jun,20859,19936,923,4.4
Atascosa County,2017-Jul,20820,19914,906,4.4
Atascosa County,2017-Aug,20820,19916,904,4.3
Atascosa County,2017-Sep,20848,20025,823,3.9
Atascosa County,2017-Oct,20734,19973,761,3.7
Atascosa County,2017-Nov,20755,19967,788,3.8
Atascosa County,2017-Dec,20752,19995,757,3.6
Atascosa County,2018-Jan,20864,20025,839,4
Atascosa County,2018-Feb,21112,20265,847,4
Atascosa County,2018-Mar,21234,20415,819,3.9
Atascosa County,2018-Apr,21253,20501,752,3.5
Atascosa County,2018-May,21251,20492,759,3.6
Atascosa County,2018-Jun,21355,20460,895,4.2
Atascosa County,2018-Jul,21323,20464,859,4
Atascosa County,2018-Aug,21234,20414,820,3.9
Atascosa County,2018-Sep,21214,20423,791,3.7
Atascosa County,2018-Oct,21187,20444,743,3.5
Atascosa County,2018-Nov,21237,20471,766,3.6
Atascosa County,2018-Dec,21222,20438,784,3.7
Atascosa County,2019-Jan,21227,20335,892,4.2
Atascosa County,2019-Feb,21361,20536,825,3.9
Atascosa County,2019-Mar,21396,20627,769,3.6
Atascosa County,2019-Apr,21309,20647,662,3.1
Atascosa County,2019-May,21337,20641,696,3.3
Atascosa County,2019-Jun,21521,20688,833,3.9
Atascosa County,2019-Jul,21574,20728,846,3.9
Atascosa County,2019-Aug,21624,20814,810,3.7
Atascosa County,2019-Sep,21588,20821,767,3.6
Atascosa County,2019-Oct,21625,20892,733,3.4
Atascosa County,2019-Nov,21607,20863,744,3.4
Atascosa County,2019-Dec,21632,20928,704,3.3
Atascosa County,2020-Jan,21474,20665,809,3.8
Atascosa County,2020-Feb,21626,20857,769,3.6
Atascosa County,2020-Mar,21305,20118,1187,5.6
Atascosa County,2020-Apr,20022,17550,2472,12.3
Atascosa County,2020-May,21019,18293,2726,13
Atascosa County,2020-Jun,21537,19014,2523,11.7
Atascosa County,2020-Jul,21616,19195,2421,11.2
Atascosa County,2020-Aug,21737,19758,1979,9.1
Atascosa County,2020-Sep,21756,19822,1934,8.9
Atascosa County,2020-Oct,21887,20167,1720,7.9
Atascosa County,2020-Nov,21909,20134,1775,8.1
Atascosa County,2020-Dec,21876,20172,1704,7.8
Atascosa County,2021-Jan,21681,20001,1680,7.7
Atascosa County,2021-Feb,21844,20202,1642,7.5
Atascosa County,2021-Mar,21893,20384,1509,6.9
Atascosa County,2021-Apr,21869,20484,1385,6.3
Atascosa County,2021-May,21793,20475,1318,6
Atascosa County,2021-Jun,21983,20488,1495,6.8
Atascosa County,2021-Jul,21981,20617,1364,6.2
Atascosa County,2021-Aug,21927,20633,1294,5.9
Atascosa County,2021-Sep,21972,20748,1224,5.6
Atascosa County,2021-Oct,21990,20811,1179,5.4
Atascosa County,2021-Nov,21984,20874,1110,5
Atascosa County,2021-Dec,21901,20886,1015,4.6
Atascosa County,2022-Jan,21992,20851,1141,5.2
Atascosa County,2022-Feb,22389,21253,1136,5.1
Atascosa County,2022-Mar,22356,21421,935,4.2
Atascosa County,2022-Apr,22193,21320,873,3.9
Atascosa County,2022-May,22176,21271,905,4.1
Atascosa County,2022-Jun,22309,21274,1035,4.6
Atascosa County,2022-Jul,22427(P),21398(P),1029(P),4.6(P)
Austin County,2012-Jan,13853,12847,1006,7.3
Austin County,2012-Feb,13878,12921,957,6.9
Austin County,2012-Mar,13901,13025,876,6.3
Austin County,2012-Apr,13958,13113,845,6.1
Austin County,2012-May,14030,13138,892,6.4
Austin County,2012-Jun,14168,13182,986,7
Austin County,2012-Jul,14198,13229,969,6.8
Austin County,2012-Aug,14091,13183,908,6.4
Austin County,2012-Sep,14153,13317,836,5.9
Austin County,2012-Oct,14155,13345,810,5.7
Austin County,2012-Nov,14172,13366,806,5.7
Austin County,2012-Dec,14160,13326,834,5.9
Austin County,2013-Jan,13937,12990,947,6.8
Austin County,2013-Feb,13982,13107,875,6.3
Austin County,2013-Mar,13950,13119,831,6
Austin County,2013-Apr,14060,13259,801,5.7
Austin County,2013-May,14135,13293,842,6
Austin County,2013-Jun,14215,13301,914,6.4
Austin County,2013-Jul,14270,13380,890,6.2
Austin County,2013-Aug,14133,13288,845,6
Austin County,2013-Sep,14194,13358,836,5.9
Austin County,2013-Oct,14122,13343,779,5.5
Austin County,2013-Nov,14153,13392,761,5.4
Austin County,2013-Dec,14160,13455,705,5
Austin County,2014-Jan,13884,13139,745,5.4
Austin County,2014-Feb,14054,13291,763,5.4
Austin County,2014-Mar,14094,13364,730,5.2
Austin County,2014-Apr,14059,13443,616,4.4
Austin County,2014-May,14148,13459,689,4.9
Austin County,2014-Jun,14179,13450,729,5.1
Austin County,2014-Jul,14232,13484,748,5.3
Austin County,2014-Aug,14130,13404,726,5.1
Austin County,2014-Sep,14166,13499,667,4.7
Austin County,2014-Oct,14199,13575,624,4.4
Austin County,2014-Nov,14154,13560,594,4.2
Austin County,2014-Dec,14092,13525,567,4
Austin County,2015-Jan,13948,13317,631,4.5
Austin County,2015-Feb,14001,13411,590,4.2
Austin County,2015-Mar,14016,13449,567,4
Austin County,2015-Apr,14040,13482,558,4
Austin County,2015-May,14118,13494,624,4.4
Austin County,2015-Jun,14140,13434,706,5
Austin County,2015-Jul,14121,13398,723,5.1
Austin County,2015-Aug,14028,13322,706,5
Austin County,2015-Sep,14015,13332,683,4.9
Austin County,2015-Oct,14070,13384,686,4.9
Austin County,2015-Nov,14035,13357,678,4.8
Austin County,2015-Dec,14032,13388,644,4.6
Austin County,2016-Jan,13835,13152,683,4.9
Austin County,2016-Feb,14059,13351,708,5
Austin County,2016-Mar,14131,13384,747,5.3
Austin County,2016-Apr,14105,13402,703,5
Austin County,2016-May,14116,13409,707,5
Austin County,2016-Jun,14156,13320,836,5.9
Austin County,2016-Jul,14112,13266,846,6
Austin County,2016-Aug,14070,13241,829,5.9
Austin County,2016-Sep,14027,13217,810,5.8
Austin County,2016-Oct,13954,13235,719,5.2
Austin County,2016-Nov,13944,13244,700,5
Austin County,2016-Dec,13914,13220,694,5
Austin County,2017-Jan,13583,12836,747,5.5
Austin County,2017-Feb,13708,12987,721,5.3
Austin County,2017-Mar,13826,13140,686,5
Austin County,2017-Apr,13785,13180,605,4.4
Austin County,2017-May,13768,13155,613,4.5
Austin County,2017-Jun,13782,13134,648,4.7
Austin County,2017-Jul,13698,13071,627,4.6
Austin County,2017-Aug,13677,13069,608,4.4
Austin County,2017-Sep,13625,13074,551,4
Austin County,2017-Oct,13632,13145,487,3.6
Austin County,2017-Nov,13675,13155,520,3.8
Austin County,2017-Dec,13674,13178,496,3.6
Austin County,2018-Jan,13514,12950,564,4.2
Austin County,2018-Feb,13716,13157,559,4.1
Austin County,2018-Mar,13783,13253,530,3.8
Austin County,2018-Apr,13723,13244,479,3.5
Austin County,2018-May,13749,13274,475,3.5
Austin County,2018-Jun,13801,13236,565,4.1
Austin County,2018-Jul,13777,13240,537,3.9
Austin County,2018-Aug,13717,13202,515,3.8
Austin County,2018-Sep,13704,13222,482,3.5
Austin County,2018-Oct,13746,13297,449,3.3
Austin County,2018-Nov,13765,13309,456,3.3
Austin County,2018-Dec,13768,13294,474,3.4
Austin County,2019-Jan,13645,13092,553,4.1
Austin County,2019-Feb,13776,13269,507,3.7
Austin County,2019-Mar,13778,13307,471,3.4
Austin County,2019-Apr,13689,13291,398,2.9
Austin County,2019-May,13729,13314,415,3
Austin County,2019-Jun,13822,13307,515,3.7
Austin County,2019-Jul,13860,13331,529,3.8
Austin County,2019-Aug,13870,13370,500,3.6
Austin County,2019-Sep,13852,13390,462,3.3
Austin County,2019-Oct,13908,13458,450,3.2
Austin County,2019-Nov,13897,13428,469,3.4
Austin County,2019-Dec,13878,13440,438,3.2
Austin County,2020-Jan,13680,13183,497,3.6
Austin County,2020-Feb,13823,13352,471,3.4
Austin County,2020-Mar,13608,12875,733,5.4
Austin County,2020-Apr,12463,11342,1121,9
Austin County,2020-May,12937,11757,1180,9.1
Austin County,2020-Jun,13224,12069,1155,8.7
Austin County,2020-Jul,13272,12159,1113,8.4
Austin County,2020-Aug,13359,12443,916,6.9
Austin County,2020-Sep,13356,12462,894,6.7
Austin County,2020-Oct,13529,12700,829,6.1
Austin County,2020-Nov,13551,12686,865,6.4
Austin County,2020-Dec,13542,12665,877,6.5
Austin County,2021-Jan,13512,12599,913,6.8
Austin County,2021-Feb,13648,12764,884,6.5
Austin County,2021-Mar,13715,12875,840,6.1
Austin County,2021-Apr,13670,12891,779,5.7
Austin County,2021-May,13609,12856,753,5.5
Austin County,2021-Jun,13684,12822,862,6.3
Austin County,2021-Jul,13731,12953,778,5.7
Austin County,2021-Aug,13733,12994,739,5.4
Austin County,2021-Sep,13741,13060,681,5
Austin County,2021-Oct,13745,13099,646,4.7
Austin County,2021-Nov,13788,13158,630,4.6
Austin County,2021-Dec,13776,13209,567,4.1
Austin County,2022-Jan,13754,13106,648,4.7
Austin County,2022-Feb,14004,13357,647,4.6
Austin County,2022-Mar,14061,13529,532,3.8
Austin County,2022-Apr,13999,13509,490,3.5
Austin County,2022-May,14042,13510,532,3.8
Austin County,2022-Jun,14154,13537,617,4.4
Austin County,2022-Jul,14249(P),13646(P),603(P),4.2(P)
Bailey County,2012-Jan,3097,2857,240,7.7
Bailey County,2012-Feb,3082,2837,245,7.9
Bailey County,2012-Mar,3131,2898,233,7.4
Bailey County,2012-Apr,3215,3014,201,6.3
Bailey County,2012-May,3262,3045,217,6.7
Bailey County,2012-Jun,3339,3093,246,7.4
Bailey County,2012-Jul,3304,3061,243,7.4
Bailey County,2012-Aug,3255,3031,224,6.9
Bailey County,2012-Sep,3213,3022,191,5.9
Bailey County,2012-Oct,3094,2912,182,5.9
Bailey County,2012-Nov,3062,2882,180,5.9
Bailey County,2012-Dec,3041,2831,210,6.9
Bailey County,2013-Jan,2926,2679,247,8.4
Bailey County,2013-Feb,2962,2718,244,8.2
Bailey County,2013-Mar,2933,2695,238,8.1
Bailey County,2013-Apr,3062,2850,212,6.9
Bailey County,2013-May,3139,2921,218,6.9
Bailey County,2013-Jun,3217,2966,251,7.8
Bailey County,2013-Jul,3199,2955,244,7.6
Bailey County,2013-Aug,3094,2866,228,7.4
Bailey County,2013-Sep,3096,2891,205,6.6
Bailey County,2013-Oct,3005,2817,188,6.3
Bailey County,2013-Nov,2912,2730,182,6.3
Bailey County,2013-Dec,2952,2784,168,5.7
Bailey County,2014-Jan,2896,2728,168,5.8
Bailey County,2014-Feb,2987,2811,176,5.9
Bailey County,2014-Mar,3042,2852,190,6.2
Bailey County,2014-Apr,3055,2909,146,4.8
Bailey County,2014-May,3055,2903,152,5
Bailey County,2014-Jun,3114,2942,172,5.5
Bailey County,2014-Jul,3032,2862,170,5.6
Bailey County,2014-Aug,2910,2760,150,5.2
Bailey County,2014-Sep,2898,2766,132,4.6
Bailey County,2014-Oct,2874,2752,122,4.2
Bailey County,2014-Nov,2807,2685,122,4.3
Bailey County,2014-Dec,2775,2663,112,4
Bailey County,2015-Jan,2757,2620,137,5
Bailey County,2015-Feb,2840,2704,136,4.8
Bailey County,2015-Mar,2919,2792,127,4.4
Bailey County,2015-Apr,2863,2748,115,4
Bailey County,2015-May,2914,2790,124,4.3
Bailey County,2015-Jun,2966,2816,150,5.1
Bailey County,2015-Jul,2852,2713,139,4.9
Bailey County,2015-Aug,2754,2636,118,4.3
Bailey County,2015-Sep,2729,2621,108,4
Bailey County,2015-Oct,2736,2633,103,3.8
Bailey County,2015-Nov,2628,2527,101,3.8
Bailey County,2015-Dec,2655,2558,97,3.7
Bailey County,2016-Jan,2576,2464,112,4.3
Bailey County,2016-Feb,2780,2654,126,4.5
Bailey County,2016-Mar,2833,2709,124,4.4
Bailey County,2016-Apr,2839,2724,115,4.1
Bailey County,2016-May,2884,2767,117,4.1
Bailey County,2016-Jun,2832,2695,137,4.8
Bailey County,2016-Jul,2681,2539,142,5.3
Bailey County,2016-Aug,2714,2590,124,4.6
Bailey County,2016-Sep,2653,2544,109,4.1
Bailey County,2016-Oct,2633,2525,108,4.1
Bailey County,2016-Nov,2607,2500,107,4.1
Bailey County,2016-Dec,2598,2491,107,4.1
Bailey County,2017-Jan,2570,2444,126,4.9
Bailey County,2017-Feb,2634,2500,134,5.1
Bailey County,2017-Mar,2789,2658,131,4.7
Bailey County,2017-Apr,2740,2632,108,3.9
Bailey County,2017-May,2747,2634,113,4.1
Bailey County,2017-Jun,2754,2620,134,4.9
Bailey County,2017-Jul,2596,2466,130,5
Bailey County,2017-Aug,2650,2523,127,4.8
Bailey County,2017-Sep,2519,2422,97,3.9
Bailey County,2017-Oct,2595,2506,89,3.4
Bailey County,2017-Nov,2547,2453,94,3.7
Bailey County,2017-Dec,2559,2469,90,3.5
Bailey County,2018-Jan,2498,2392,106,4.2
Bailey County,2018-Feb,2591,2465,126,4.9
Bailey County,2018-Mar,2689,2563,126,4.7
Bailey County,2018-Apr,2653,2538,115,4.3
Bailey County,2018-May,2724,2606,118,4.3
Bailey County,2018-Jun,2661,2516,145,5.4
Bailey County,2018-Jul,2569,2439,130,5.1
Bailey County,2018-Aug,2647,2533,114,4.3
Bailey County,2018-Sep,2605,2497,108,4.1
Bailey County,2018-Oct,2554,2450,104,4.1
Bailey County,2018-Nov,2498,2403,95,3.8
Bailey County,2018-Dec,2439,2348,91,3.7
Bailey County,2019-Jan,2352,2249,103,4.4
Bailey County,2019-Feb,2453,2350,103,4.2
Bailey County,2019-Mar,2511,2409,102,4.1
Bailey County,2019-Apr,2468,2387,81,3.3
Bailey County,2019-May,2533,2445,88,3.5
Bailey County,2019-Jun,2560,2448,112,4.4
Bailey County,2019-Jul,2482,2373,109,4.4
Bailey County,2019-Aug,2532,2447,85,3.4
Bailey County,2019-Sep,2442,2360,82,3.4
Bailey County,2019-Oct,2499,2419,80,3.2
Bailey County,2019-Nov,2394,2316,78,3.3
Bailey County,2019-Dec,2408,2340,68,2.8
Bailey County,2020-Jan,2369,2281,88,3.7
Bailey County,2020-Feb,2394,2312,82,3.4
Bailey County,2020-Mar,2392,2267,125,5.2
Bailey County,2020-Apr,2302,2177,125,5.4
Bailey County,2020-May,2313,2179,134,5.8
Bailey County,2020-Jun,2350,2209,141,6
Bailey County,2020-Jul,2383,2248,135,5.7
Bailey County,2020-Aug,2424,2321,103,4.2
Bailey County,2020-Sep,2384,2283,101,4.2
Bailey County,2020-Oct,2420,2324,96,4
Bailey County,2020-Nov,2338,2233,105,4.5
Bailey County,2020-Dec,2351,2233,118,5
Bailey County,2021-Jan,2434,2298,136,5.6
Bailey County,2021-Feb,2470,2334,136,5.5
Bailey County,2021-Mar,2578,2454,124,4.8
Bailey County,2021-Apr,2522,2416,106,4.2
Bailey County,2021-May,2452,2345,107,4.4
Bailey County,2021-Jun,2427,2278,149,6.1
Bailey County,2021-Jul,2390,2253,137,5.7
Bailey County,2021-Aug,2406,2289,117,4.9
Bailey County,2021-Sep,2390,2282,108,4.5
Bailey County,2021-Oct,2343,2234,109,4.7
Bailey County,2021-Nov,2266,2165,101,4.5
Bailey County,2021-Dec,2252,2158,94,4.2
Bailey County,2022-Jan,2284,2176,108,4.7
Bailey County,2022-Feb,2426,2316,110,4.5
Bailey County,2022-Mar,2545,2456,89,3.5
Bailey County,2022-Apr,2489,2406,83,3.3
Bailey County,2022-May,2409,2315,94,3.9
Bailey County,2022-Jun,2382,2266,116,4.9
Bailey County,2022-Jul,2518(P),2400(P),118(P),4.7(P)
Bandera County,2012-Jan,9011,8349,662,7.3
Bandera County,2012-Feb,9014,8385,629,7
Bandera County,2012-Mar,9026,8437,589,6.5
Bandera County,2012-Apr,9053,8497,556,6.1
Bandera County,2012-May,9078,8484,594,6.5
Bandera County,2012-Jun,9174,8531,643,7
Bandera County,2012-Jul,9187,8537,650,7.1
Bandera County,2012-Aug,9129,8525,604,6.6
Bandera County,2012-Sep,9169,8600,569,6.2
Bandera County,2012-Oct,9145,8598,547,6
Bandera County,2012-Nov,9153,8622,531,5.8
Bandera County,2012-Dec,9129,8587,542,5.9
Bandera County,2013-Jan,8939,8327,612,6.8
Bandera County,2013-Feb,8955,8389,566,6.3
Bandera County,2013-Mar,8930,8385,545,6.1
Bandera County,2013-Apr,9025,8508,517,5.7
Bandera County,2013-May,9070,8513,557,6.1
Bandera County,2013-Jun,9140,8541,599,6.6
Bandera County,2013-Jul,9176,8584,592,6.5
Bandera County,2013-Aug,9073,8526,547,6
Bandera County,2013-Sep,9118,8563,555,6.1
Bandera County,2013-Oct,9049,8525,524,5.8
Bandera County,2013-Nov,9092,8582,510,5.6
Bandera County,2013-Dec,9070,8599,471,5.2
Bandera County,2014-Jan,8971,8468,503,5.6
Bandera County,2014-Feb,9063,8567,496,5.5
Bandera County,2014-Mar,9091,8620,471,5.2
Bandera County,2014-Apr,9087,8687,400,4.4
Bandera County,2014-May,9135,8693,442,4.8
Bandera County,2014-Jun,9175,8715,460,5
Bandera County,2014-Jul,9201,8715,486,5.3
Bandera County,2014-Aug,9114,8656,458,5
Bandera County,2014-Sep,9137,8708,429,4.7
Bandera County,2014-Oct,9161,8763,398,4.3
Bandera County,2014-Nov,9161,8769,392,4.3
Bandera County,2014-Dec,9048,8703,345,3.8
Bandera County,2015-Jan,9035,8632,403,4.5
Bandera County,2015-Feb,9071,8697,374,4.1
Bandera County,2015-Mar,9115,8756,359,3.9
Bandera County,2015-Apr,9179,8842,337,3.7
Bandera County,2015-May,9248,8883,365,3.9
Bandera County,2015-Jun,9232,8843,389,4.2
Bandera County,2015-Jul,9222,8833,389,4.2
Bandera County,2015-Aug,9146,8795,351,3.8
Bandera County,2015-Sep,9199,8828,371,4
Bandera County,2015-Oct,9230,8869,361,3.9
Bandera County,2015-Nov,9267,8900,367,4
Bandera County,2015-Dec,9239,8894,345,3.7
Bandera County,2016-Jan,9275,8894,381,4.1
Bandera County,2016-Feb,9414,9042,372,4
Bandera County,2016-Mar,9504,9107,397,4.2
Bandera County,2016-Apr,9514,9151,363,3.8
Bandera County,2016-May,9536,9176,360,3.8
Bandera County,2016-Jun,9553,9143,410,4.3
Bandera County,2016-Jul,9561,9134,427,4.5
Bandera County,2016-Aug,9545,9141,404,4.2
Bandera County,2016-Sep,9531,9122,409,4.3
Bandera County,2016-Oct,9530,9137,393,4.1
Bandera County,2016-Nov,9564,9175,389,4.1
Bandera County,2016-Dec,9559,9175,384,4
Bandera County,2017-Jan,9550,9146,404,4.2
Bandera County,2017-Feb,9636,9231,405,4.2
Bandera County,2017-Mar,9676,9317,359,3.7
Bandera County,2017-Apr,9661,9349,312,3.2
Bandera County,2017-May,9647,9319,328,3.4
Bandera County,2017-Jun,9705,9341,364,3.8
Bandera County,2017-Jul,9690,9320,370,3.8
Bandera County,2017-Aug,9693,9320,373,3.8
Bandera County,2017-Sep,9717,9366,351,3.6
Bandera County,2017-Oct,9664,9347,317,3.3
Bandera County,2017-Nov,9684,9351,333,3.4
Bandera County,2017-Dec,9689,9379,310,3.2
Bandera County,2018-Jan,9695,9345,350,3.6
Bandera County,2018-Feb,9812,9448,364,3.7
Bandera County,2018-Mar,9881,9525,356,3.6
Bandera County,2018-Apr,9871,9564,307,3.1
Bandera County,2018-May,9856,9549,307,3.1
Bandera County,2018-Jun,9877,9528,349,3.5
Bandera County,2018-Jul,9870,9533,337,3.4
Bandera County,2018-Aug,9857,9499,358,3.6
Bandera County,2018-Sep,9847,9504,343,3.5
Bandera County,2018-Oct,9838,9511,327,3.3
Bandera County,2018-Nov,9854,9528,326,3.3
Bandera County,2018-Dec,9854,9528,326,3.3
Bandera County,2019-Jan,9831,9446,385,3.9
Bandera County,2019-Feb,9888,9532,356,3.6
Bandera County,2019-Mar,9918,9571,347,3.5
Bandera County,2019-Apr,9852,9573,279,2.8
Bandera County,2019-May,9851,9567,284,2.9
Bandera County,2019-Jun,9918,9588,330,3.3
Bandera County,2019-Jul,9955,9606,349,3.5
Bandera County,2019-Aug,10006,9648,358,3.6
Bandera County,2019-Sep,9984,9649,335,3.4
Bandera County,2019-Oct,9990,9669,321,3.2
Bandera County,2019-Nov,9970,9668,302,3
Bandera County,2019-Dec,9986,9703,283,2.8
Bandera County,2020-Jan,10117,9783,334,3.3
Bandera County,2020-Feb,10192,9877,315,3.1
Bandera County,2020-Mar,10007,9520,487,4.9
Bandera County,2020-Apr,9068,8287,781,8.6
Bandera County,2020-May,9472,8652,820,8.7
Bandera County,2020-Jun,9749,8996,753,7.7
Bandera County,2020-Jul,9787,9097,690,7.1
Bandera County,2020-Aug,9939,9369,570,5.7
Bandera County,2020-Sep,9960,9390,570,5.7
Bandera County,2020-Oct,10036,9540,496,4.9
Bandera County,2020-Nov,10054,9522,532,5.3
Bandera County,2020-Dec,10078,9544,534,5.3
Bandera County,2021-Jan,10039,9464,575,5.7
Bandera County,2021-Feb,10138,9560,578,5.7
Bandera County,2021-Mar,10202,9661,541,5.3
Bandera County,2021-Apr,10175,9700,475,4.7
Bandera County,2021-May,10181,9706,475,4.7
Bandera County,2021-Jun,10248,9711,537,5.2
Bandera County,2021-Jul,10283,9793,490,4.8
Bandera County,2021-Aug,10263,9804,459,4.5
Bandera County,2021-Sep,10300,9852,448,4.3
Bandera County,2021-Oct,10302,9872,430,4.2
Bandera County,2021-Nov,10316,9902,414,4
Bandera County,2021-Dec,10272,9909,363,3.5
Bandera County,2022-Jan,10283,9863,420,4.1
Bandera County,2022-Feb,10478,10049,429,4.1
Bandera County,2022-Mar,10492,10147,345,3.3
Bandera County,2022-Apr,10397,10084,313,3
Bandera County,2022-May,10425,10074,351,3.4
Bandera County,2022-Jun,10480,10084,396,3.8
Bandera County,2022-Jul,10539(P),10145(P),394(P),3.7(P)
Bastrop County,2012-Jan,34748,32167,2581,7.4
Bastrop County,2012-Feb,34837,32344,2493,7.2
Bastrop County,2012-Mar,34976,32523,2453,7
Bastrop County,2012-Apr,34952,32752,2200,6.3
Bastrop County,2012-May,35054,32739,2315,6.6
Bastrop County,2012-Jun,35367,32783,2584,7.3
Bastrop County,2012-Jul,35393,32815,2578,7.3
Bastrop County,2012-Aug,35148,32787,2361,6.7
Bastrop County,2012-Sep,35329,33165,2164,6.1
Bastrop County,2012-Oct,35580,33421,2159,6.1
Bastrop County,2012-Nov,35686,33637,2049,5.7
Bastrop County,2012-Dec,35530,33406,2124,6
Bastrop County,2013-Jan,35205,32815,2390,6.8
Bastrop County,2013-Feb,35308,33036,2272,6.4
Bastrop County,2013-Mar,35458,33120,2338,6.6
Bastrop County,2013-Apr,35643,33566,2077,5.8
Bastrop County,2013-May,35785,33610,2175,6.1
Bastrop County,2013-Jun,36158,33635,2523,7
Bastrop County,2013-Jul,36181,33728,2453,6.8
Bastrop County,2013-Aug,35952,33641,2311,6.4
Bastrop County,2013-Sep,36083,33865,2218,6.1
Bastrop County,2013-Oct,36035,33875,2160,6
Bastrop County,2013-Nov,36199,34265,1934,5.3
Bastrop County,2013-Dec,36041,34224,1817,5
Bastrop County,2014-Jan,36045,34117,1928,5.3
Bastrop County,2014-Feb,36435,34478,1957,5.4
Bastrop County,2014-Mar,36698,34716,1982,5.4
Bastrop County,2014-Apr,36501,34907,1594,4.4
Bastrop County,2014-May,36580,34852,1728,4.7
Bastrop County,2014-Jun,36888,34898,1990,5.4
Bastrop County,2014-Jul,36969,34886,2083,5.6
Bastrop County,2014-Aug,36701,34739,1962,5.3
Bastrop County,2014-Sep,36732,34946,1786,4.9
Bastrop County,2014-Oct,36847,35221,1626,4.4
Bastrop County,2014-Nov,36937,35328,1609,4.4
Bastrop County,2014-Dec,36588,35134,1454,4
Bastrop County,2015-Jan,36846,35210,1636,4.4
Bastrop County,2015-Feb,37053,35516,1537,4.1
Bastrop County,2015-Mar,37161,35732,1429,3.8
Bastrop County,2015-Apr,37377,36057,1320,3.5
Bastrop County,2015-May,37577,36178,1399,3.7
Bastrop County,2015-Jun,37849,36185,1664,4.4
Bastrop County,2015-Jul,37746,36050,1696,4.5
Bastrop County,2015-Aug,37482,36001,1481,4
Bastrop County,2015-Sep,37643,36214,1429,3.8
Bastrop County,2015-Oct,37855,36465,1390,3.7
Bastrop County,2015-Nov,38029,36676,1353,3.6
Bastrop County,2015-Dec,38023,36716,1307,3.4
Bastrop County,2016-Jan,38087,36683,1404,3.7
Bastrop County,2016-Feb,38643,37240,1403,3.6
Bastrop County,2016-Mar,38814,37417,1397,3.6
Bastrop County,2016-Apr,38884,37589,1295,3.3
Bastrop County,2016-May,38908,37615,1293,3.3
Bastrop County,2016-Jun,39254,37617,1637,4.2
Bastrop County,2016-Jul,39340,37633,1707,4.3
Bastrop County,2016-Aug,39177,37573,1604,4.1
Bastrop County,2016-Sep,39242,37713,1529,3.9
Bastrop County,2016-Oct,39374,37908,1466,3.7
Bastrop County,2016-Nov,39462,38058,1404,3.6
Bastrop County,2016-Dec,39363,37945,1418,3.6
Bastrop County,2017-Jan,39096,37538,1558,4
Bastrop County,2017-Feb,39524,37933,1591,4
Bastrop County,2017-Mar,39803,38225,1578,4
Bastrop County,2017-Apr,39794,38508,1286,3.2
Bastrop County,2017-May,39758,38432,1326,3.3
Bastrop County,2017-Jun,40040,38460,1580,3.9
Bastrop County,2017-Jul,40074,38481,1593,4
Bastrop County,2017-Aug,40013,38390,1623,4.1
Bastrop County,2017-Sep,40102,38744,1358,3.4
Bastrop County,2017-Oct,40118,38874,1244,3.1
Bastrop County,2017-Nov,40235,38915,1320,3.3
Bastrop County,2017-Dec,40184,38926,1258,3.1
Bastrop County,2018-Jan,40383,38972,1411,3.5
Bastrop County,2018-Feb,40914,39487,1427,3.5
Bastrop County,2018-Mar,41148,39625,1523,3.7
Bastrop County,2018-Apr,41119,39854,1265,3.1
Bastrop County,2018-May,41154,39893,1261,3.1
Bastrop County,2018-Jun,41564,39930,1634,3.9
Bastrop County,2018-Jul,41545,39926,1619,3.9
Bastrop County,2018-Aug,41164,39724,1440,3.5
Bastrop County,2018-Sep,41288,39929,1359,3.3
Bastrop County,2018-Oct,41596,40307,1289,3.1
Bastrop County,2018-Nov,41700,40403,1297,3.1
Bastrop County,2018-Dec,41659,40336,1323,3.2
Bastrop County,2019-Jan,41533,39944,1589,3.8
Bastrop County,2019-Feb,41813,40444,1369,3.3
Bastrop County,2019-Mar,41800,40549,1251,3
Bastrop County,2019-Apr,41764,40710,1054,2.5
Bastrop County,2019-May,41748,40668,1080,2.6
Bastrop County,2019-Jun,42249,40791,1458,3.5
Bastrop County,2019-Jul,42415,40904,1511,3.6
Bastrop County,2019-Aug,42269,40939,1330,3.1
Bastrop County,2019-Sep,42395,41123,1272,3
Bastrop County,2019-Oct,42698,41466,1232,2.9
Bastrop County,2019-Nov,42750,41557,1193,2.8
Bastrop County,2019-Dec,42781,41630,1151,2.7
Bastrop County,2020-Jan,43034,41725,1309,3
Bastrop County,2020-Feb,43381,42155,1226,2.8
Bastrop County,2020-Mar,42535,40659,1876,4.4
Bastrop County,2020-Apr,39344,35476,3868,9.8
Bastrop County,2020-May,40730,36885,3845,9.4
Bastrop County,2020-Jun,41869,38301,3568,8.5
Bastrop County,2020-Jul,42235,39025,3210,7.6
Bastrop County,2020-Aug,42664,40064,2600,6.1
Bastrop County,2020-Sep,42783,40310,2473,5.8
Bastrop County,2020-Oct,43421,41223,2198,5.1
Bastrop County,2020-Nov,43562,41289,2273,5.2
Bastrop County,2020-Dec,43635,41410,2225,5.1
Bastrop County,2021-Jan,43694,41273,2421,5.5
Bastrop County,2021-Feb,44128,41734,2394,5.4
Bastrop County,2021-Mar,44326,42043,2283,5.2
Bastrop County,2021-Apr,44542,42525,2017,4.5
Bastrop County,2021-May,44619,42659,1960,4.4
Bastrop County,2021-Jun,45220,42871,2349,5.2
Bastrop County,2021-Jul,45492,43343,2149,4.7
Bastrop County,2021-Aug,45437,43492,1945,4.3
Bastrop County,2021-Sep,45480,43714,1766,3.9
Bastrop County,2021-Oct,45956,44214,1742,3.8
Bastrop County,2021-Nov,46181,44533,1648,3.6
Bastrop County,2021-Dec,46129,44603,1526,3.3
Bastrop County,2022-Jan,46034,44266,1768,3.8
Bastrop County,2022-Feb,46704,44922,1782,3.8
Bastrop County,2022-Mar,46961,45508,1453,3.1
Bastrop County,2022-Apr,46605,45252,1353,2.9
Bastrop County,2022-May,46446,45007,1439,3.1
Bastrop County,2022-Jun,46911,45162,1749,3.7
Bastrop County,2022-Jul,47147(P),45414(P),1733(P),3.7(P)
Baylor County,2012-Jan,1983,1881,102,5.1
Baylor County,2012-Feb,1908,1812,96,5
Baylor County,2012-Mar,1930,1842,88,4.6
Baylor County,2012-Apr,1914,1831,83,4.3
Baylor County,2012-May,1903,1808,95,5
Baylor County,2012-Jun,1918,1816,102,5.3
Baylor County,2012-Jul,1885,1782,103,5.5
Baylor County,2012-Aug,1819,1720,99,5.4
Baylor County,2012-Sep,1800,1705,95,5.3
Baylor County,2012-Oct,1792,1699,93,5.2
Baylor County,2012-Nov,1786,1702,84,4.7
Baylor County,2012-Dec,1704,1610,94,5.5
Baylor County,2013-Jan,1676,1570,106,6.3
Baylor County,2013-Feb,1656,1555,101,6.1
Baylor County,2013-Mar,1657,1561,96,5.8
Baylor County,2013-Apr,1678,1590,88,5.2
Baylor County,2013-May,1666,1576,90,5.4
Baylor County,2013-Jun,1716,1619,97,5.7
Baylor County,2013-Jul,1706,1614,92,5.4
Baylor County,2013-Aug,1640,1557,83,5.1
Baylor County,2013-Sep,1646,1561,85,5.2
Baylor County,2013-Oct,1673,1589,84,5
Baylor County,2013-Nov,1656,1579,77,4.6
Baylor County,2013-Dec,1663,1590,73,4.4
Baylor County,2014-Jan,1608,1532,76,4.7
Baylor County,2014-Feb,1628,1548,80,4.9
Baylor County,2014-Mar,1625,1550,75,4.6
Baylor County,2014-Apr,1634,1563,71,4.3
Baylor County,2014-May,1674,1602,72,4.3
Baylor County,2014-Jun,1664,1588,76,4.6
Baylor County,2014-Jul,1659,1579,80,4.8
Baylor County,2014-Aug,1637,1565,72,4.4
Baylor County,2014-Sep,1669,1603,66,4
Baylor County,2014-Oct,1687,1623,64,3.8
Baylor County,2014-Nov,1663,1602,61,3.7
Baylor County,2014-Dec,1646,1588,58,3.5
Baylor County,2015-Jan,1619,1553,66,4.1
Baylor County,2015-Feb,1603,1543,60,3.7
Baylor County,2015-Mar,1611,1553,58,3.6
Baylor County,2015-Apr,1605,1549,56,3.5
Baylor County,2015-May,1621,1558,63,3.9
Baylor County,2015-Jun,1674,1609,65,3.9
Baylor County,2015-Jul,1631,1570,61,3.7
Baylor County,2015-Aug,1600,1546,54,3.4
Baylor County,2015-Sep,1630,1572,58,3.6
Baylor County,2015-Oct,1675,1622,53,3.2
Baylor County,2015-Nov,1610,1558,52,3.2
Baylor County,2015-Dec,1650,1602,48,2.9
Baylor County,2016-Jan,1588,1526,62,3.9
Baylor County,2016-Feb,1606,1551,55,3.4
Baylor County,2016-Mar,1615,1561,54,3.3
Baylor County,2016-Apr,1589,1536,53,3.3
Baylor County,2016-May,1628,1572,56,3.4
Baylor County,2016-Jun,1656,1593,63,3.8
Baylor County,2016-Jul,1619,1558,61,3.8
Baylor County,2016-Aug,1611,1556,55,3.4
Baylor County,2016-Sep,1593,1540,53,3.3
Baylor County,2016-Oct,1607,1547,60,3.7
Baylor County,2016-Nov,1574,1515,59,3.7
Baylor County,2016-Dec,1586,1521,65,4.1
Baylor County,2017-Jan,1551,1486,65,4.2
Baylor County,2017-Feb,1563,1497,66,4.2
Baylor County,2017-Mar,1592,1533,59,3.7
Baylor County,2017-Apr,1563,1515,48,3.1
Baylor County,2017-May,1598,1549,49,3.1
Baylor County,2017-Jun,1628,1570,58,3.6
Baylor County,2017-Jul,1569,1510,59,3.8
Baylor County,2017-Aug,1574,1516,58,3.7
Baylor County,2017-Sep,1564,1516,48,3.1
Baylor County,2017-Oct,1568,1523,45,2.9
Baylor County,2017-Nov,1571,1523,48,3.1
Baylor County,2017-Dec,1578,1537,41,2.6
Baylor County,2018-Jan,1483,1437,46,3.1
Baylor County,2018-Feb,1493,1442,51,3.4
Baylor County,2018-Mar,1527,1478,49,3.2
Baylor County,2018-Apr,1543,1497,46,3
Baylor County,2018-May,1565,1519,46,2.9
Baylor County,2018-Jun,1588,1534,54,3.4
Baylor County,2018-Jul,1565,1507,58,3.7
Baylor County,2018-Aug,1572,1514,58,3.7
Baylor County,2018-Sep,1558,1505,53,3.4
Baylor County,2018-Oct,1531,1483,48,3.1
Baylor County,2018-Nov,1523,1480,43,2.8
Baylor County,2018-Dec,1531,1490,41,2.7
Baylor County,2019-Jan,1676,1627,49,2.9
Baylor County,2019-Feb,1678,1636,42,2.5
Baylor County,2019-Mar,1711,1671,40,2.3
Baylor County,2019-Apr,1688,1656,32,1.9
Baylor County,2019-May,1737,1705,32,1.8
Baylor County,2019-Jun,1749,1709,40,2.3
Baylor County,2019-Jul,1756,1713,43,2.4
Baylor County,2019-Aug,1769,1726,43,2.4
Baylor County,2019-Sep,1739,1701,38,2.2
Baylor County,2019-Oct,1756,1720,36,2.1
Baylor County,2019-Nov,1737,1700,37,2.1
Baylor County,2019-Dec,1776,1738,38,2.1
Baylor County,2020-Jan,1790,1749,41,2.3
Baylor County,2020-Feb,1752,1710,42,2.4
Baylor County,2020-Mar,1749,1687,62,3.5
Baylor County,2020-Apr,1581,1525,56,3.5
Baylor County,2020-May,1669,1595,74,4.4
Baylor County,2020-Jun,1754,1675,79,4.5
Baylor County,2020-Jul,1768,1694,74,4.2
Baylor County,2020-Aug,1798,1744,54,3
Baylor County,2020-Sep,1814,1753,61,3.4
Baylor County,2020-Oct,1820,1762,58,3.2
Baylor County,2020-Nov,1788,1727,61,3.4
Baylor County,2020-Dec,1791,1735,56,3.1
Baylor County,2021-Jan,1825,1762,63,3.5
Baylor County,2021-Feb,1836,1771,65,3.5
Baylor County,2021-Mar,1851,1787,64,3.5
Baylor County,2021-Apr,1796,1737,59,3.3
Baylor County,2021-May,1827,1758,69,3.8
Baylor County,2021-Jun,1847,1780,67,3.6
Baylor County,2021-Jul,1814,1748,66,3.6
Baylor County,2021-Aug,1814,1750,64,3.5
Baylor County,2021-Sep,1823,1760,63,3.5
Baylor County,2021-Oct,1802,1745,57,3.2
Baylor County,2021-Nov,1773,1722,51,2.9
Baylor County,2021-Dec,1784,1737,47,2.6
Baylor County,2022-Jan,1818,1760,58,3.2
Baylor County,2022-Feb,1845,1787,58,3.1
Baylor County,2022-Mar,1889,1840,49,2.6
Baylor County,2022-Apr,1808,1764,44,2.4
Baylor County,2022-May,1841,1794,47,2.6
Baylor County,2022-Jun,1877,1825,52,2.8
Baylor County,2022-Jul,1865(P),1814(P),51(P),2.7(P)
Bee County,2012-Jan,10714,9904,810,7.6
Bee County,2012-Feb,10797,10010,787,7.3
Bee County,2012-Mar,10735,10012,723,6.7
Bee County,2012-Apr,10874,10173,701,6.4
Bee County,2012-May,10927,10171,756,6.9
Bee County,2012-Jun,10971,10140,831,7.6
Bee County,2012-Jul,10773,9950,823,7.6
Bee County,2012-Aug,10720,9965,755,7
Bee County,2012-Sep,10827,10124,703,6.5
Bee County,2012-Oct,10835,10122,713,6.6
Bee County,2012-Nov,10867,10143,724,6.7
Bee County,2012-Dec,10875,10123,752,6.9
Bee County,2013-Jan,10998,10184,814,7.4
Bee County,2013-Feb,11079,10307,772,7
Bee County,2013-Mar,11075,10339,736,6.6
Bee County,2013-Apr,11255,10536,719,6.4
Bee County,2013-May,11491,10719,772,6.7
Bee County,2013-Jun,11700,10859,841,7.2
Bee County,2013-Jul,11758,10959,799,6.8
Bee County,2013-Aug,11683,10930,753,6.4
Bee County,2013-Sep,11679,10936,743,6.4
Bee County,2013-Oct,10988,10273,715,6.5
Bee County,2013-Nov,10972,10287,685,6.2
Bee County,2013-Dec,10902,10272,630,5.8
Bee County,2014-Jan,10786,10122,664,6.2
Bee County,2014-Feb,10947,10264,683,6.2
Bee County,2014-Mar,10958,10308,650,5.9
Bee County,2014-Apr,10887,10310,577,5.3
Bee County,2014-May,10883,10280,603,5.5
Bee County,2014-Jun,10967,10269,698,6.4
Bee County,2014-Jul,10592,9875,717,6.8
Bee County,2014-Aug,10513,9844,669,6.4
Bee County,2014-Sep,10668,10048,620,5.8
Bee County,2014-Oct,10520,9938,582,5.5
Bee County,2014-Nov,10513,9930,583,5.5
Bee County,2014-Dec,10413,9885,528,5.1
Bee County,2015-Jan,10336,9754,582,5.6
Bee County,2015-Feb,10457,9902,555,5.3
Bee County,2015-Mar,10462,9874,588,5.6
Bee County,2015-Apr,10577,9976,601,5.7
Bee County,2015-May,10565,9918,647,6.1
Bee County,2015-Jun,10457,9735,722,6.9
Bee County,2015-Jul,10269,9528,741,7.2
Bee County,2015-Aug,10120,9421,699,6.9
Bee County,2015-Sep,10364,9703,661,6.4
Bee County,2015-Oct,10335,9684,651,6.3
Bee County,2015-Nov,10350,9681,669,6.5
Bee County,2015-Dec,10334,9699,635,6.1
Bee County,2016-Jan,10074,9394,680,6.8
Bee County,2016-Feb,10427,9744,683,6.6
Bee County,2016-Mar,10480,9725,755,7.2
Bee County,2016-Apr,10525,9767,758,7.2
Bee County,2016-May,10496,9736,760,7.2
Bee County,2016-Jun,10387,9509,878,8.5
Bee County,2016-Jul,10210,9340,870,8.5
Bee County,2016-Aug,10227,9371,856,8.4
Bee County,2016-Sep,10283,9462,821,8
Bee County,2016-Oct,10250,9501,749,7.3
Bee County,2016-Nov,10181,9429,752,7.4
Bee County,2016-Dec,10237,9470,767,7.5
Bee County,2017-Jan,9912,9133,779,7.9
Bee County,2017-Feb,10083,9327,756,7.5
Bee County,2017-Mar,10146,9450,696,6.9
Bee County,2017-Apr,10081,9425,656,6.5
Bee County,2017-May,10025,9402,623,6.2
Bee County,2017-Jun,9916,9275,641,6.5
Bee County,2017-Jul,9775,9133,642,6.6
Bee County,2017-Aug,9715,9060,655,6.7
Bee County,2017-Sep,9765,9167,598,6.1
Bee County,2017-Oct,9799,9233,566,5.8
Bee County,2017-Nov,9773,9191,582,6
Bee County,2017-Dec,9781,9229,552,5.6
Bee County,2018-Jan,9811,9216,595,6.1
Bee County,2018-Feb,9996,9428,568,5.7
Bee County,2018-Mar,10038,9498,540,5.4
Bee County,2018-Apr,9897,9398,499,5
Bee County,2018-May,9922,9441,481,4.8
Bee County,2018-Jun,9864,9322,542,5.5
Bee County,2018-Jul,9802,9288,514,5.2
Bee County,2018-Aug,9774,9291,483,4.9
Bee County,2018-Sep,9778,9306,472,4.8
Bee County,2018-Oct,9758,9299,459,4.7
Bee County,2018-Nov,9809,9368,441,4.5
Bee County,2018-Dec,9703,9246,457,4.7
Bee County,2019-Jan,9658,9165,493,5.1
Bee County,2019-Feb,9847,9389,458,4.7
Bee County,2019-Mar,9837,9416,421,4.3
Bee County,2019-Apr,9685,9322,363,3.7
Bee County,2019-May,9692,9323,369,3.8
Bee County,2019-Jun,9677,9239,438,4.5
Bee County,2019-Jul,9625,9165,460,4.8
Bee County,2019-Aug,9692,9236,456,4.7
Bee County,2019-Sep,9731,9301,430,4.4
Bee County,2019-Oct,9679,9266,413,4.3
Bee County,2019-Nov,9683,9258,425,4.4
Bee County,2019-Dec,9684,9277,407,4.2
Bee County,2020-Jan,9768,9308,460,4.7
Bee County,2020-Feb,9971,9521,450,4.5
Bee County,2020-Mar,9927,9236,691,7
Bee County,2020-Apr,9422,8324,1098,11.7
Bee County,2020-May,9759,8486,1273,13
Bee County,2020-Jun,9745,8398,1347,13.8
Bee County,2020-Jul,9900,8614,1286,13
Bee County,2020-Aug,9849,8791,1058,10.7
Bee County,2020-Sep,9802,8748,1054,10.8
Bee County,2020-Oct,9706,8743,963,9.9
Bee County,2020-Nov,9605,8634,971,10.1
Bee County,2020-Dec,9516,8569,947,10
Bee County,2021-Jan,9483,8513,970,10.2
Bee County,2021-Feb,9593,8614,979,10.2
Bee County,2021-Mar,9615,8707,908,9.4
Bee County,2021-Apr,9427,8577,850,9
Bee County,2021-May,9377,8571,806,8.6
Bee County,2021-Jun,9330,8456,874,9.4
Bee County,2021-Jul,9185,8358,827,9
Bee County,2021-Aug,9203,8412,791,8.6
Bee County,2021-Sep,9223,8496,727,7.9
Bee County,2021-Oct,9081,8394,687,7.6
Bee County,2021-Nov,9033,8373,660,7.3
Bee County,2021-Dec,8961,8334,627,7
Bee County,2022-Jan,8990,8269,721,8
Bee County,2022-Feb,9134,8444,690,7.6
Bee County,2022-Mar,9199,8623,576,6.3
Bee County,2022-Apr,8895,8334,561,6.3
Bee County,2022-May,8875,8290,585,6.6
Bee County,2022-Jun,8803,8137,666,7.6
Bee County,2022-Jul,8824(P),8171(P),653(P),7.4(P)
Bell County,2012-Jan,133012,122367,10645,8
Bell County,2012-Feb,133556,123189,10367,7.8
Bell County,2012-Mar,133179,123558,9621,7.2
Bell County,2012-Apr,133076,123822,9254,7
Bell County,2012-May,133727,123814,9913,7.4
Bell County,2012-Jun,134166,123303,10863,8.1
Bell County,2012-Jul,135022,124278,10744,8
Bell County,2012-Aug,134238,124247,9991,7.4
Bell County,2012-Sep,134282,124873,9409,7
Bell County,2012-Oct,134435,125125,9310,6.9
Bell County,2012-Nov,133527,124522,9005,6.7
Bell County,2012-Dec,133391,124244,9147,6.9
Bell County,2013-Jan,134375,124235,10140,7.5
Bell County,2013-Feb,134210,124623,9587,7.1
Bell County,2013-Mar,134140,124941,9199,6.9
Bell County,2013-Apr,134772,125830,8942,6.6
Bell County,2013-May,135360,125979,9381,6.9
Bell County,2013-Jun,135286,125056,10230,7.6
Bell County,2013-Jul,136038,126076,9962,7.3
Bell County,2013-Aug,135554,126041,9513,7
Bell County,2013-Sep,136085,126469,9616,7.1
Bell County,2013-Oct,134771,125508,9263,6.9
Bell County,2013-Nov,135465,126660,8805,6.5
Bell County,2013-Dec,134873,126545,8328,6.2
Bell County,2014-Jan,134799,126132,8667,6.4
Bell County,2014-Feb,135146,126440,8706,6.4
Bell County,2014-Mar,134832,126535,8297,6.2
Bell County,2014-Apr,135159,127800,7359,5.4
Bell County,2014-May,135489,127577,7912,5.8
Bell County,2014-Jun,135010,126616,8394,6.2
Bell County,2014-Jul,134943,126329,8614,6.4
Bell County,2014-Aug,134171,125877,8294,6.2
Bell County,2014-Sep,134202,126354,7848,5.8
Bell County,2014-Oct,134343,126963,7380,5.5
Bell County,2014-Nov,134659,127309,7350,5.5
Bell County,2014-Dec,133881,127223,6658,5
Bell County,2015-Jan,134345,127056,7289,5.4
Bell County,2015-Feb,134899,128168,6731,5
Bell County,2015-Mar,134683,128332,6351,4.7
Bell County,2015-Apr,135528,129660,5868,4.3
Bell County,2015-May,136097,129881,6216,4.6
Bell County,2015-Jun,135595,128880,6715,5
Bell County,2015-Jul,136507,129661,6846,5
Bell County,2015-Aug,136275,129942,6333,4.6
Bell County,2015-Sep,136581,130223,6358,4.7
Bell County,2015-Oct,137350,131135,6215,4.5
Bell County,2015-Nov,138937,132786,6151,4.4
Bell County,2015-Dec,139276,133550,5726,4.1
Bell County,2016-Jan,137925,131834,6091,4.4
Bell County,2016-Feb,139073,133068,6005,4.3
Bell County,2016-Mar,139157,133072,6085,4.4
Bell County,2016-Apr,139242,133474,5768,4.1
Bell County,2016-May,139131,133374,5757,4.1
Bell County,2016-Jun,139512,132691,6821,4.9
Bell County,2016-Jul,140088,133138,6950,5
Bell County,2016-Aug,139610,132982,6628,4.7
Bell County,2016-Sep,140113,133369,6744,4.8
Bell County,2016-Oct,139922,133574,6348,4.5
Bell County,2016-Nov,140705,134513,6192,4.4
Bell County,2016-Dec,140255,134077,6178,4.4
Bell County,2017-Jan,140408,133531,6877,4.9
Bell County,2017-Feb,140936,134069,6867,4.9
Bell County,2017-Mar,140746,134351,6395,4.5
Bell County,2017-Apr,141676,135840,5836,4.1
Bell County,2017-May,141585,135740,5845,4.1
Bell County,2017-Jun,141342,135031,6311,4.5
Bell County,2017-Jul,141372,135102,6270,4.4
Bell County,2017-Aug,141144,134959,6185,4.4
Bell County,2017-Sep,141215,135463,5752,4.1
Bell County,2017-Oct,140340,134993,5347,3.8
Bell County,2017-Nov,141365,135730,5635,4
Bell County,2017-Dec,140624,135254,5370,3.8
Bell County,2018-Jan,140884,134808,6076,4.3
Bell County,2018-Feb,141753,135677,6076,4.3
Bell County,2018-Mar,140700,134853,5847,4.2
Bell County,2018-Apr,141324,135832,5492,3.9
Bell County,2018-May,140989,135466,5523,3.9
Bell County,2018-Jun,141069,134620,6449,4.6
Bell County,2018-Jul,141389,135156,6233,4.4
Bell County,2018-Aug,140549,134414,6135,4.4
Bell County,2018-Sep,141191,135269,5922,4.2
Bell County,2018-Oct,141404,135742,5662,4
Bell County,2018-Nov,141798,136178,5620,4
Bell County,2018-Dec,141792,136055,5737,4
Bell County,2019-Jan,141640,135051,6589,4.7
Bell County,2019-Feb,142016,136027,5989,4.2
Bell County,2019-Mar,141127,135667,5460,3.9
Bell County,2019-Apr,141401,136705,4696,3.3
Bell County,2019-May,141156,136303,4853,3.4
Bell County,2019-Jun,141818,135925,5893,4.2
Bell County,2019-Jul,142396,136400,5996,4.2
Bell County,2019-Aug,141743,136118,5625,4
Bell County,2019-Sep,142558,137181,5377,3.8
Bell County,2019-Oct,142797,137579,5218,3.7
Bell County,2019-Nov,143376,138198,5178,3.6
Bell County,2019-Dec,143038,138236,4802,3.4
Bell County,2020-Jan,143334,137891,5443,3.8
Bell County,2020-Feb,144086,138846,5240,3.6
Bell County,2020-Mar,141981,134055,7926,5.6
Bell County,2020-Apr,136860,122330,14530,10.6
Bell County,2020-May,140290,125961,14329,10.2
Bell County,2020-Jun,143033,129562,13471,9.4
Bell County,2020-Jul,144564,132195,12369,8.6
Bell County,2020-Aug,145255,135102,10153,7
Bell County,2020-Sep,145323,135397,9926,6.8
Bell County,2020-Oct,146015,137246,8769,6
Bell County,2020-Nov,146833,137584,9249,6.3
Bell County,2020-Dec,146860,137513,9347,6.4
Bell County,2021-Jan,146789,136811,9978,6.8
Bell County,2021-Feb,147217,137255,9962,6.8
Bell County,2021-Mar,146861,137437,9424,6.4
Bell County,2021-Apr,147195,138766,8429,5.7
Bell County,2021-May,147580,139255,8325,5.6
Bell County,2021-Jun,148151,138603,9548,6.4
Bell County,2021-Jul,147303,138587,8716,5.9
Bell County,2021-Aug,147087,138828,8259,5.6
Bell County,2021-Sep,147184,139428,7756,5.3
Bell County,2021-Oct,148133,140649,7484,5.1
Bell County,2021-Nov,148646,141478,7168,4.8
Bell County,2021-Dec,148168,141586,6582,4.4
Bell County,2022-Jan,148397,140916,7481,5
Bell County,2022-Feb,150040,142571,7469,5
Bell County,2022-Mar,149456,143338,6118,4.1
Bell County,2022-Apr,148573,142780,5793,3.9
Bell County,2022-May,148188,141988,6200,4.2
Bell County,2022-Jun,148360,141223,7137,4.8
Bell County,2022-Jul,148554(P),141415(P),7139(P),4.8(P)
Bexar County,2012-Jan,827016,770202,56814,6.9
Bexar County,2012-Feb,833167,777518,55649,6.7
Bexar County,2012-Mar,832686,780801,51885,6.2
Bexar County,2012-Apr,833680,784474,49206,5.9
Bexar County,2012-May,837855,785692,52163,6.2
Bexar County,2012-Jun,843432,785282,58150,6.9
Bexar County,2012-Jul,844467,786344,58123,6.9
Bexar County,2012-Aug,840026,785864,54162,6.4
Bexar County,2012-Sep,840687,790346,50341,6
Bexar County,2012-Oct,842576,793260,49316,5.9
Bexar County,2012-Nov,841800,793838,47962,5.7
Bexar County,2012-Dec,842891,794007,48884,5.8
Bexar County,2013-Jan,842884,788165,54719,6.5
Bexar County,2013-Feb,845954,794426,51528,6.1
Bexar County,2013-Mar,846041,796572,49469,5.8
Bexar County,2013-Apr,850041,802770,47271,5.6
Bexar County,2013-May,853144,803364,49780,5.8
Bexar County,2013-Jun,859221,804263,54958,6.4
Bexar County,2013-Jul,861148,807234,53914,6.3
Bexar County,2013-Aug,855857,805404,50453,5.9
Bexar County,2013-Sep,857717,807130,50587,5.9
Bexar County,2013-Oct,851278,803022,48256,5.7
Bexar County,2013-Nov,857084,811208,45876,5.4
Bexar County,2013-Dec,854391,811396,42995,5
Bexar County,2014-Jan,853352,807859,45493,5.3
Bexar County,2014-Feb,858789,812994,45795,5.3
Bexar County,2014-Mar,862358,818870,43488,5
Bexar County,2014-Apr,861831,824030,37801,4.4
Bexar County,2014-May,864782,824238,40544,4.7
Bexar County,2014-Jun,869676,825964,43712,5
Bexar County,2014-Jul,872920,827678,45242,5.2
Bexar County,2014-Aug,867991,824969,43022,5
Bexar County,2014-Sep,866184,826092,40092,4.6
Bexar County,2014-Oct,868812,831385,37427,4.3
Bexar County,2014-Nov,870451,833863,36588,4.2
Bexar County,2014-Dec,864644,831696,32948,3.8
Bexar County,2015-Jan,867925,830449,37476,4.3
Bexar County,2015-Feb,870633,835805,34828,4
Bexar County,2015-Mar,869873,836821,33052,3.8
Bexar County,2015-Apr,875323,844932,30391,3.5
Bexar County,2015-May,879146,846162,32984,3.8
Bexar County,2015-Jun,879996,843763,36233,4.1
Bexar County,2015-Jul,882727,846059,36668,4.2
Bexar County,2015-Aug,880303,846494,33809,3.8
Bexar County,2015-Sep,881174,847530,33644,3.8
Bexar County,2015-Oct,883642,850788,32854,3.7
Bexar County,2015-Nov,890400,857737,32663,3.7
Bexar County,2015-Dec,888810,858202,30608,3.4
Bexar County,2016-Jan,888887,856004,32883,3.7
Bexar County,2016-Feb,897221,864565,32656,3.6
Bexar County,2016-Mar,899666,866791,32875,3.7
Bexar County,2016-Apr,899760,869404,30356,3.4
Bexar County,2016-May,899867,869113,30754,3.4
Bexar County,2016-Jun,905146,868569,36577,4
Bexar County,2016-Jul,912360,874650,37710,4.1
Bexar County,2016-Aug,910420,874187,36233,4
Bexar County,2016-Sep,913575,877213,36362,4
Bexar County,2016-Oct,912017,877483,34534,3.8
Bexar County,2016-Nov,916742,883266,33476,3.7
Bexar County,2016-Dec,914483,881010,33473,3.7
Bexar County,2017-Jan,907082,870943,36139,4
Bexar County,2017-Feb,912660,875774,36886,4
Bexar County,2017-Mar,913673,879437,34236,3.7
Bexar County,2017-Apr,915115,884429,30686,3.4
Bexar County,2017-May,911969,880418,31551,3.5
Bexar County,2017-Jun,918395,883333,35062,3.8
Bexar County,2017-Jul,924370,889306,35064,3.8
Bexar County,2017-Aug,921041,886518,34523,3.7
Bexar County,2017-Sep,926218,895290,30928,3.3
Bexar County,2017-Oct,916926,888364,28562,3.1
Bexar County,2017-Nov,921330,891077,30253,3.3
Bexar County,2017-Dec,919101,890146,28955,3.2
Bexar County,2018-Jan,914196,881595,32601,3.6
Bexar County,2018-Feb,924037,891098,32939,3.6
Bexar County,2018-Mar,922795,891020,31775,3.4
Bexar County,2018-Apr,927536,898572,28964,3.1
Bexar County,2018-May,924151,895335,28816,3.1
Bexar County,2018-Jun,931687,897238,34449,3.7
Bexar County,2018-Jul,933732,900135,33597,3.6
Bexar County,2018-Aug,927047,894555,32492,3.5
Bexar County,2018-Sep,928348,897171,31177,3.4
Bexar County,2018-Oct,929353,899723,29630,3.2
Bexar County,2018-Nov,931671,902251,29420,3.2
Bexar County,2018-Dec,931647,901866,29781,3.2
Bexar County,2019-Jan,923557,889674,33883,3.7
Bexar County,2019-Feb,927816,896364,31452,3.4
Bexar County,2019-Mar,925810,896551,29259,3.2
Bexar County,2019-Apr,924933,899897,25036,2.7
Bexar County,2019-May,923769,897893,25876,2.8
Bexar County,2019-Jun,933730,901938,31792,3.4
Bexar County,2019-Jul,936866,904167,32699,3.5
Bexar County,2019-Aug,934234,903092,31142,3.3
Bexar County,2019-Sep,937158,907926,29232,3.1
Bexar County,2019-Oct,938225,909857,28368,3
Bexar County,2019-Nov,940572,912539,28033,3
Bexar County,2019-Dec,939471,913483,25988,2.8
Bexar County,2020-Jan,932966,902943,30023,3.2
Bexar County,2020-Feb,938335,909839,28496,3
Bexar County,2020-Mar,920819,876387,44432,4.8
Bexar County,2020-Apr,879870,764317,115553,13.1
Bexar County,2020-May,911297,797202,114095,12.5
Bexar County,2020-Jun,928064,829825,98239,10.6
Bexar County,2020-Jul,928642,836049,92593,10
Bexar County,2020-Aug,932125,858034,74091,7.9
Bexar County,2020-Sep,934884,864905,69979,7.5
Bexar County,2020-Oct,938588,878263,60325,6.4
Bexar County,2020-Nov,942804,881453,61351,6.5
Bexar County,2020-Dec,942298,882542,59756,6.3
Bexar County,2021-Jan,934677,872448,62229,6.7
Bexar County,2021-Feb,939590,878441,61149,6.5
Bexar County,2021-Mar,938887,880715,58172,6.2
Bexar County,2021-Apr,940784,888504,52280,5.6
Bexar County,2021-May,941102,891301,49801,5.3
Bexar County,2021-Jun,950923,894109,56814,6
Bexar County,2021-Jul,950194,898123,52071,5.5
Bexar County,2021-Aug,946073,896920,49153,5.2
Bexar County,2021-Sep,948874,903252,45622,4.8
Bexar County,2021-Oct,951577,908358,43219,4.5
Bexar County,2021-Nov,955367,914783,40584,4.2
Bexar County,2021-Dec,952211,915317,36894,3.9
Bexar County,2022-Jan,957275,915133,42142,4.4
Bexar County,2022-Feb,967234,925357,41877,4.3
Bexar County,2022-Mar,960301,925986,34315,3.6
Bexar County,2022-Apr,955593,923370,32223,3.4
Bexar County,2022-May,959186,924912,34274,3.6
Bexar County,2022-Jun,965949,926524,39425,4.1
Bexar County,2022-Jul,964357(P),925463(P),38894(P),4.0(P)
Blanco County,2012-Jan,5365,5065,300,5.6
Blanco County,2012-Feb,5341,5050,291,5.4
Blanco County,2012-Mar,5355,5084,271,5.1
Blanco County,2012-Apr,5448,5192,256,4.7
Blanco County,2012-May,5493,5210,283,5.2
Blanco County,2012-Jun,5594,5278,316,5.6
Blanco County,2012-Jul,5580,5266,314,5.6
Blanco County,2012-Aug,5542,5255,287,5.2
Blanco County,2012-Sep,5564,5293,271,4.9
Blanco County,2012-Oct,5528,5259,269,4.9
Blanco County,2012-Nov,5495,5239,256,4.7
Blanco County,2012-Dec,5459,5200,259,4.7
Blanco County,2013-Jan,5430,5138,292,5.4
Blanco County,2013-Feb,5441,5175,266,4.9
Blanco County,2013-Mar,5404,5151,253,4.7
Blanco County,2013-Apr,5505,5249,256,4.7
Blanco County,2013-May,5534,5267,267,4.8
Blanco County,2013-Jun,5604,5309,295,5.3
Blanco County,2013-Jul,5633,5347,286,5.1
Blanco County,2013-Aug,5585,5317,268,4.8
Blanco County,2013-Sep,5593,5325,268,4.8
Blanco County,2013-Oct,5552,5309,243,4.4
Blanco County,2013-Nov,5540,5316,224,4
Blanco County,2013-Dec,5513,5296,217,3.9
Blanco County,2014-Jan,5472,5239,233,4.3
Blanco County,2014-Feb,5562,5331,231,4.2
Blanco County,2014-Mar,5596,5379,217,3.9
Blanco County,2014-Apr,5641,5457,184,3.3
Blanco County,2014-May,5666,5456,210,3.7
Blanco County,2014-Jun,5702,5479,223,3.9
Blanco County,2014-Jul,5736,5503,233,4.1
Blanco County,2014-Aug,5658,5438,220,3.9
Blanco County,2014-Sep,5686,5478,208,3.7
Blanco County,2014-Oct,5810,5618,192,3.3
Blanco County,2014-Nov,5785,5595,190,3.3
Blanco County,2014-Dec,5719,5542,177,3.1
Blanco County,2015-Jan,5708,5506,202,3.5
Blanco County,2015-Feb,5703,5515,188,3.3
Blanco County,2015-Mar,5716,5539,177,3.1
Blanco County,2015-Apr,5782,5614,168,2.9
Blanco County,2015-May,5810,5628,182,3.1
Blanco County,2015-Jun,5827,5632,195,3.3
Blanco County,2015-Jul,5808,5611,197,3.4
Blanco County,2015-Aug,5754,5572,182,3.2
Blanco County,2015-Sep,5727,5545,182,3.2
Blanco County,2015-Oct,5807,5630,177,3
Blanco County,2015-Nov,5799,5625,174,3
Blanco County,2015-Dec,5791,5631,160,2.8
Blanco County,2016-Jan,5772,5595,177,3.1
Blanco County,2016-Feb,5888,5709,179,3
Blanco County,2016-Mar,5972,5782,190,3.2
Blanco County,2016-Apr,5979,5808,171,2.9
Blanco County,2016-May,6017,5848,169,2.8
Blanco County,2016-Jun,6017,5820,197,3.3
Blanco County,2016-Jul,5958,5755,203,3.4
Blanco County,2016-Aug,5946,5750,196,3.3
Blanco County,2016-Sep,5919,5727,192,3.2
Blanco County,2016-Oct,5923,5739,184,3.1
Blanco County,2016-Nov,5906,5734,172,2.9
Blanco County,2016-Dec,5946,5772,174,2.9
Blanco County,2017-Jan,6145,5954,191,3.1
Blanco County,2017-Feb,6246,6050,196,3.1
Blanco County,2017-Mar,6259,6070,189,3
Blanco County,2017-Apr,6171,6013,158,2.6
Blanco County,2017-May,6187,6019,168,2.7
Blanco County,2017-Jun,6236,6063,173,2.8
Blanco County,2017-Jul,6168,5986,182,3
Blanco County,2017-Aug,6156,5983,173,2.8
Blanco County,2017-Sep,6134,5974,160,2.6
Blanco County,2017-Oct,6158,6005,153,2.5
Blanco County,2017-Nov,6141,5978,163,2.7
Blanco County,2017-Dec,6167,6015,152,2.5
Blanco County,2018-Jan,6101,5924,177,2.9
Blanco County,2018-Feb,6142,5965,177,2.9
Blanco County,2018-Mar,6193,6025,168,2.7
Blanco County,2018-Apr,6169,6024,145,2.4
Blanco County,2018-May,6226,6073,153,2.5
Blanco County,2018-Jun,6213,6035,178,2.9
Blanco County,2018-Jul,6218,6050,168,2.7
Blanco County,2018-Aug,6177,6008,169,2.7
Blanco County,2018-Sep,6138,5979,159,2.6
Blanco County,2018-Oct,6211,6063,148,2.4
Blanco County,2018-Nov,6228,6072,156,2.5
Blanco County,2018-Dec,6251,6092,159,2.5
Blanco County,2019-Jan,6301,6115,186,3
Blanco County,2019-Feb,6357,6185,172,2.7
Blanco County,2019-Mar,6388,6220,168,2.6
Blanco County,2019-Apr,6364,6229,135,2.1
Blanco County,2019-May,6347,6206,141,2.2
Blanco County,2019-Jun,6426,6254,172,2.7
Blanco County,2019-Jul,6461,6281,180,2.8
Blanco County,2019-Aug,6487,6323,164,2.5
Blanco County,2019-Sep,6443,6292,151,2.3
Blanco County,2019-Oct,6528,6383,145,2.2
Blanco County,2019-Nov,6525,6386,139,2.1
Blanco County,2019-Dec,6585,6451,134,2
Blanco County,2020-Jan,6649,6492,157,2.4
Blanco County,2020-Feb,6683,6533,150,2.2
Blanco County,2020-Mar,6576,6343,233,3.5
Blanco County,2020-Apr,5969,5611,358,6
Blanco County,2020-May,6243,5899,344,5.5
Blanco County,2020-Jun,6414,6099,315,4.9
Blanco County,2020-Jul,6526,6229,297,4.6
Blanco County,2020-Aug,6611,6368,243,3.7
Blanco County,2020-Sep,6606,6359,247,3.7
Blanco County,2020-Oct,6691,6475,216,3.2
Blanco County,2020-Nov,6661,6439,222,3.3
Blanco County,2020-Dec,6737,6502,235,3.5
Blanco County,2021-Jan,6606,6352,254,3.8
Blanco County,2021-Feb,6646,6394,252,3.8
Blanco County,2021-Mar,6760,6505,255,3.8
Blanco County,2021-Apr,6793,6564,229,3.4
Blanco County,2021-May,6779,6557,222,3.3
Blanco County,2021-Jun,6921,6651,270,3.9
Blanco County,2021-Jul,7009,6767,242,3.5
Blanco County,2021-Aug,6987,6761,226,3.2
Blanco County,2021-Sep,6935,6719,216,3.1
Blanco County,2021-Oct,6975,6772,203,2.9
Blanco County,2021-Nov,6973,6779,194,2.8
Blanco County,2021-Dec,7008,6832,176,2.5
Blanco County,2022-Jan,6904,6698,206,3
Blanco County,2022-Feb,7005,6788,217,3.1
Blanco County,2022-Mar,7135,6955,180,2.5
Blanco County,2022-Apr,7053,6885,168,2.4
Blanco County,2022-May,7027,6846,181,2.6
Blanco County,2022-Jun,7123,6917,206,2.9
Blanco County,2022-Jul,7210(P),7006(P),204(P),2.8(P)
Borden County,2012-Jan,397,379,18,4.5
Borden County,2012-Feb,408,390,18,4.4
Borden County,2012-Mar,406,390,16,3.9
Borden County,2012-Apr,411,394,17,4.1
Borden County,2012-May,424,407,17,4
Borden County,2012-Jun,434,416,18,4.1
Borden County,2012-Jul,436,419,17,3.9
Borden County,2012-Aug,428,413,15,3.5
Borden County,2012-Sep,415,397,18,4.3
Borden County,2012-Oct,421,403,18,4.3
Borden County,2012-Nov,417,399,18,4.3
Borden County,2012-Dec,415,398,17,4.1
Borden County,2013-Jan,408,388,20,4.9
Borden County,2013-Feb,396,381,15,3.8
Borden County,2013-Mar,405,390,15,3.7
Borden County,2013-Apr,412,398,14,3.4
Borden County,2013-May,423,405,18,4.3
Borden County,2013-Jun,426,408,18,4.2
Borden County,2013-Jul,416,399,17,4.1
Borden County,2013-Aug,415,398,17,4.1
Borden County,2013-Sep,415,399,16,3.9
Borden County,2013-Oct,429,411,18,4.2
Borden County,2013-Nov,416,400,16,3.8
Borden County,2013-Dec,425,410,15,3.5
Borden County,2014-Jan,430,414,16,3.7
Borden County,2014-Feb,419,403,16,3.8
Borden County,2014-Mar,425,411,14,3.3
Borden County,2014-Apr,421,410,11,2.6
Borden County,2014-May,440,427,13,3
Borden County,2014-Jun,428,415,13,3
Borden County,2014-Jul,434,419,15,3.5
Borden County,2014-Aug,425,410,15,3.5
Borden County,2014-Sep,426,412,14,3.3
Borden County,2014-Oct,419,407,12,2.9
Borden County,2014-Nov,407,397,10,2.5
Borden County,2014-Dec,399,389,10,2.5
Borden County,2015-Jan,388,378,10,2.6
Borden County,2015-Feb,411,400,11,2.7
Borden County,2015-Mar,416,406,10,2.4
Borden County,2015-Apr,418,409,9,2.2
Borden County,2015-May,425,415,10,2.4
Borden County,2015-Jun,431,418,13,3
Borden County,2015-Jul,411,399,12,2.9
Borden County,2015-Aug,413,400,13,3.1
Borden County,2015-Sep,411,398,13,3.2
Borden County,2015-Oct,403,388,15,3.7
Borden County,2015-Nov,413,398,15,3.6
Borden County,2015-Dec,405,394,11,2.7
Borden County,2016-Jan,410,395,15,3.7
Borden County,2016-Feb,412,395,17,4.1
Borden County,2016-Mar,398,383,15,3.8
Borden County,2016-Apr,383,370,13,3.4
Borden County,2016-May,375,363,12,3.2
Borden County,2016-Jun,379,365,14,3.7
Borden County,2016-Jul,347,332,15,4.3
Borden County,2016-Aug,347,333,14,4
Borden County,2016-Sep,340,329,11,3.2
Borden County,2016-Oct,332,320,12,3.6
Borden County,2016-Nov,339,327,12,3.5
Borden County,2016-Dec,333,322,11,3.3
Borden County,2017-Jan,317,305,12,3.8
Borden County,2017-Feb,325,312,13,4
Borden County,2017-Mar,340,329,11,3.2
Borden County,2017-Apr,339,329,10,2.9
Borden County,2017-May,333,324,9,2.7
Borden County,2017-Jun,329,317,12,3.6
Borden County,2017-Jul,311,298,13,4.2
Borden County,2017-Aug,314,302,12,3.8
Borden County,2017-Sep,299,288,11,3.7
Borden County,2017-Oct,310,300,10,3.2
Borden County,2017-Nov,309,297,12,3.9
Borden County,2017-Dec,317,305,12,3.8
Borden County,2018-Jan,347,334,13,3.7
Borden County,2018-Feb,361,346,15,4.2
Borden County,2018-Mar,367,353,14,3.8
Borden County,2018-Apr,328,317,11,3.4
Borden County,2018-May,335,323,12,3.6
Borden County,2018-Jun,318,307,11,3.5
Borden County,2018-Jul,331,321,10,3
Borden County,2018-Aug,335,325,10,3
Borden County,2018-Sep,346,336,10,2.9
Borden County,2018-Oct,349,339,10,2.9
Borden County,2018-Nov,347,337,10,2.9
Borden County,2018-Dec,321,311,10,3.1
Borden County,2019-Jan,343,332,11,3.2
Borden County,2019-Feb,360,350,10,2.8
Borden County,2019-Mar,380,370,10,2.6
Borden County,2019-Apr,390,381,9,2.3
Borden County,2019-May,422,412,10,2.4
Borden County,2019-Jun,379,370,9,2.4
Borden County,2019-Jul,433,422,11,2.5
Borden County,2019-Aug,409,397,12,2.9
Borden County,2019-Sep,409,398,11,2.7
Borden County,2019-Oct,403,395,8,2
Borden County,2019-Nov,403,394,9,2.2
Borden County,2019-Dec,461,453,8,1.7
Borden County,2020-Jan,477,467,10,2.1
Borden County,2020-Feb,450,441,9,2
Borden County,2020-Mar,443,426,17,3.8
Borden County,2020-Apr,394,380,14,3.6
Borden County,2020-May,380,362,18,4.7
Borden County,2020-Jun,381,362,19,5
Borden County,2020-Jul,407,391,16,3.9
Borden County,2020-Aug,428,414,14,3.3
Borden County,2020-Sep,445,430,15,3.4
Borden County,2020-Oct,457,443,14,3.1
Borden County,2020-Nov,495,480,15,3
Borden County,2020-Dec,494,480,14,2.8
Borden County,2021-Jan,504,490,14,2.8
Borden County,2021-Feb,520,505,15,2.9
Borden County,2021-Mar,583,569,14,2.4
Borden County,2021-Apr,614,602,12,2
Borden County,2021-May,583,570,13,2.2
Borden County,2021-Jun,568,552,16,2.8
Borden County,2021-Jul,600,587,13,2.2
Borden County,2021-Aug,614,600,14,2.3
Borden County,2021-Sep,578,564,14,2.4
Borden County,2021-Oct,578,564,14,2.4
Borden County,2021-Nov,605,591,14,2.3
Borden County,2021-Dec,626,613,13,2.1
Borden County,2022-Jan,655,639,16,2.4
Borden County,2022-Feb,667,651,16,2.4
Borden County,2022-Mar,714,700,14,2
Borden County,2022-Apr,717,707,10,1.4
Borden County,2022-May,697,685,12,1.7
Borden County,2022-Jun,655,643,12,1.8
Borden County,2022-Jul,734(P),723(P),11(P),1.5(P)
Bosque County,2012-Jan,8149,7503,646,7.9
Bosque County,2012-Feb,8104,7482,622,7.7
Bosque County,2012-Mar,8096,7513,583,7.2
Bosque County,2012-Apr,8193,7636,557,6.8
Bosque County,2012-May,8205,7615,590,7.2
Bosque County,2012-Jun,8299,7657,642,7.7
Bosque County,2012-Jul,8325,7673,652,7.8
Bosque County,2012-Aug,8247,7648,599,7.3
Bosque County,2012-Sep,8208,7652,556,6.8
Bosque County,2012-Oct,8121,7574,547,6.7
Bosque County,2012-Nov,8072,7562,510,6.3
Bosque County,2012-Dec,8016,7486,530,6.6
Bosque County,2013-Jan,8001,7415,586,7.3
Bosque County,2013-Feb,7988,7435,553,6.9
Bosque County,2013-Mar,7936,7414,522,6.6
Bosque County,2013-Apr,8037,7555,482,6
Bosque County,2013-May,8117,7588,529,6.5
Bosque County,2013-Jun,8235,7645,590,7.2
Bosque County,2013-Jul,8244,7666,578,7
Bosque County,2013-Aug,8098,7557,541,6.7
Bosque County,2013-Sep,8155,7620,535,6.6
Bosque County,2013-Oct,8043,7548,495,6.2
Bosque County,2013-Nov,7964,7497,467,5.9
Bosque County,2013-Dec,7968,7531,437,5.5
Bosque County,2014-Jan,8021,7559,462,5.8
Bosque County,2014-Feb,8117,7645,472,5.8
Bosque County,2014-Mar,8154,7697,457,5.6
Bosque County,2014-Apr,8145,7761,384,4.7
Bosque County,2014-May,8220,7787,433,5.3
Bosque County,2014-Jun,8223,7750,473,5.8
Bosque County,2014-Jul,8239,7757,482,5.9
Bosque County,2014-Aug,8127,7668,459,5.6
Bosque County,2014-Sep,8123,7708,415,5.1
Bosque County,2014-Oct,8087,7722,365,4.5
Bosque County,2014-Nov,8066,7702,364,4.5
Bosque County,2014-Dec,8019,7685,334,4.2
Bosque County,2015-Jan,8002,7615,387,4.8
Bosque County,2015-Feb,8075,7710,365,4.5
Bosque County,2015-Mar,8034,7688,346,4.3
Bosque County,2015-Apr,8068,7745,323,4
Bosque County,2015-May,8123,7775,348,4.3
Bosque County,2015-Jun,8145,7748,397,4.9
Bosque County,2015-Jul,8149,7747,402,4.9
Bosque County,2015-Aug,8031,7663,368,4.6
Bosque County,2015-Sep,8047,7676,371,4.6
Bosque County,2015-Oct,8037,7676,361,4.5
Bosque County,2015-Nov,8018,7661,357,4.5
Bosque County,2015-Dec,8031,7679,352,4.4
Bosque County,2016-Jan,8009,7637,372,4.6
Bosque County,2016-Feb,8116,7767,349,4.3
Bosque County,2016-Mar,8150,7799,351,4.3
Bosque County,2016-Apr,8250,7930,320,3.9
Bosque County,2016-May,8297,7981,316,3.8
Bosque County,2016-Jun,8301,7925,376,4.5
Bosque County,2016-Jul,8276,7894,382,4.6
Bosque County,2016-Aug,8288,7910,378,4.6
Bosque County,2016-Sep,8211,7854,357,4.3
Bosque County,2016-Oct,8146,7804,342,4.2
Bosque County,2016-Nov,8135,7793,342,4.2
Bosque County,2016-Dec,8117,7765,352,4.3
Bosque County,2017-Jan,8059,7678,381,4.7
Bosque County,2017-Feb,8137,7751,386,4.7
Bosque County,2017-Mar,8228,7875,353,4.3
Bosque County,2017-Apr,8185,7870,315,3.8
Bosque County,2017-May,8200,7876,324,4
Bosque County,2017-Jun,8195,7852,343,4.2
Bosque County,2017-Jul,8124,7786,338,4.2
Bosque County,2017-Aug,8136,7812,324,4
Bosque County,2017-Sep,8120,7820,300,3.7
Bosque County,2017-Oct,8066,7795,271,3.4
Bosque County,2017-Nov,8077,7779,298,3.7
Bosque County,2017-Dec,8101,7807,294,3.6
Bosque County,2018-Jan,8085,7753,332,4.1
Bosque County,2018-Feb,8175,7851,324,4
Bosque County,2018-Mar,8238,7919,319,3.9
Bosque County,2018-Apr,8115,7830,285,3.5
Bosque County,2018-May,8130,7851,279,3.4
Bosque County,2018-Jun,8182,7847,335,4.1
Bosque County,2018-Jul,8213,7889,324,3.9
Bosque County,2018-Aug,8132,7821,311,3.8
Bosque County,2018-Sep,8131,7830,301,3.7
Bosque County,2018-Oct,8134,7851,283,3.5
Bosque County,2018-Nov,8103,7823,280,3.5
Bosque County,2018-Dec,8014,7734,280,3.5
Bosque County,2019-Jan,8121,7783,338,4.2
Bosque County,2019-Feb,8150,7858,292,3.6
Bosque County,2019-Mar,8215,7944,271,3.3
Bosque County,2019-Apr,8173,7937,236,2.9
Bosque County,2019-May,8183,7935,248,3
Bosque County,2019-Jun,8274,7976,298,3.6
Bosque County,2019-Jul,8286,7980,306,3.7
Bosque County,2019-Aug,8314,8012,302,3.6
Bosque County,2019-Sep,8198,7918,280,3.4
Bosque County,2019-Oct,8267,8002,265,3.2
Bosque County,2019-Nov,8201,7929,272,3.3
Bosque County,2019-Dec,8188,7926,262,3.2
Bosque County,2020-Jan,8222,7918,304,3.7
Bosque County,2020-Feb,8265,7986,279,3.4
Bosque County,2020-Mar,8180,7756,424,5.2
Bosque County,2020-Apr,7740,7160,580,7.5
Bosque County,2020-May,8024,7434,590,7.4
Bosque County,2020-Jun,8160,7587,573,7
Bosque County,2020-Jul,8228,7683,545,6.6
Bosque County,2020-Aug,8349,7918,431,5.2
Bosque County,2020-Sep,8314,7884,430,5.2
Bosque County,2020-Oct,8279,7911,368,4.4
Bosque County,2020-Nov,8224,7817,407,4.9
Bosque County,2020-Dec,8231,7797,434,5.3
Bosque County,2021-Jan,8314,7853,461,5.5
Bosque County,2021-Feb,8404,7947,457,5.4
Bosque County,2021-Mar,8472,8044,428,5.1
Bosque County,2021-Apr,8352,7986,366,4.4
Bosque County,2021-May,8305,7936,369,4.4
Bosque County,2021-Jun,8369,7943,426,5.1
Bosque County,2021-Jul,8500,8098,402,4.7
Bosque County,2021-Aug,8512,8127,385,4.5
Bosque County,2021-Sep,8555,8197,358,4.2
Bosque County,2021-Oct,8497,8158,339,4
Bosque County,2021-Nov,8462,8131,331,3.9
Bosque County,2021-Dec,8403,8106,297,3.5
Bosque County,2022-Jan,8501,8133,368,4.3
Bosque County,2022-Feb,8684,8319,365,4.2
Bosque County,2022-Mar,8788,8495,293,3.3
Bosque County,2022-Apr,8636,8365,271,3.1
Bosque County,2022-May,8615,8327,288,3.3
Bosque County,2022-Jun,8659,8319,340,3.9
Bosque County,2022-Jul,8830(P),8490(P),340(P),3.9(P)
Bowie County,2012-Jan,41853,38422,3431,8.2
Bowie County,2012-Feb,41825,38517,3308,7.9
Bowie County,2012-Mar,41725,38680,3045,7.3
Bowie County,2012-Apr,41754,38867,2887,6.9
Bowie County,2012-May,41797,38800,2997,7.2
Bowie County,2012-Jun,42099,38822,3277,7.8
Bowie County,2012-Jul,41145,37851,3294,8
Bowie County,2012-Aug,40946,37804,3142,7.7
Bowie County,2012-Sep,41206,38286,2920,7.1
Bowie County,2012-Oct,41104,38242,2862,7
Bowie County,2012-Nov,41022,38255,2767,6.7
Bowie County,2012-Dec,40940,38108,2832,6.9
Bowie County,2013-Jan,40904,37736,3168,7.7
Bowie County,2013-Feb,40704,37635,3069,7.5
Bowie County,2013-Mar,40717,37632,3085,7.6
Bowie County,2013-Apr,40682,37713,2969,7.3
Bowie County,2013-May,40859,37818,3041,7.4
Bowie County,2013-Jun,41139,37829,3310,8
Bowie County,2013-Jul,40110,36885,3225,8
Bowie County,2013-Aug,39964,36714,3250,8.1
Bowie County,2013-Sep,40368,37121,3247,8
Bowie County,2013-Oct,40125,37018,3107,7.7
Bowie County,2013-Nov,40202,37203,2999,7.5
Bowie County,2013-Dec,39997,37148,2849,7.1
Bowie County,2014-Jan,39815,36826,2989,7.5
Bowie County,2014-Feb,39839,36921,2918,7.3
Bowie County,2014-Mar,39884,37145,2739,6.9
Bowie County,2014-Apr,39669,37272,2397,6
Bowie County,2014-May,39815,37326,2489,6.3
Bowie County,2014-Jun,39795,37159,2636,6.6
Bowie County,2014-Jul,39204,36542,2662,6.8
Bowie County,2014-Aug,39102,36514,2588,6.6
Bowie County,2014-Sep,39601,37234,2367,6
Bowie County,2014-Oct,39514,37271,2243,5.7
Bowie County,2014-Nov,39624,37405,2219,5.6
Bowie County,2014-Dec,39478,37436,2042,5.2
Bowie County,2015-Jan,38975,36756,2219,5.7
Bowie County,2015-Feb,39042,36985,2057,5.3
Bowie County,2015-Mar,38937,37015,1922,4.9
Bowie County,2015-Apr,39228,37489,1739,4.4
Bowie County,2015-May,39338,37505,1833,4.7
Bowie County,2015-Jun,39398,37448,1950,4.9
Bowie County,2015-Jul,38738,36730,2008,5.2
Bowie County,2015-Aug,38865,36974,1891,4.9
Bowie County,2015-Sep,39293,37431,1862,4.7
Bowie County,2015-Oct,39276,37472,1804,4.6
Bowie County,2015-Nov,39534,37737,1797,4.5
Bowie County,2015-Dec,39428,37751,1677,4.3
Bowie County,2016-Jan,39462,37629,1833,4.6
Bowie County,2016-Feb,39961,38160,1801,4.5
Bowie County,2016-Mar,39829,38082,1747,4.4
Bowie County,2016-Apr,39880,38283,1597,4
Bowie County,2016-May,39844,38235,1609,4
Bowie County,2016-Jun,39988,38098,1890,4.7
Bowie County,2016-Jul,39509,37423,2086,5.3
Bowie County,2016-Aug,39414,37343,2071,5.3
Bowie County,2016-Sep,39638,37571,2067,5.2
Bowie County,2016-Oct,39387,37463,1924,4.9
Bowie County,2016-Nov,39473,37589,1884,4.8
Bowie County,2016-Dec,39330,37420,1910,4.9
Bowie County,2017-Jan,39169,37074,2095,5.3
Bowie County,2017-Feb,39363,37299,2064,5.2
Bowie County,2017-Mar,39351,37477,1874,4.8
Bowie County,2017-Apr,39362,37621,1741,4.4
Bowie County,2017-May,39107,37360,1747,4.5
Bowie County,2017-Jun,39113,37196,1917,4.9
Bowie County,2017-Jul,38591,36711,1880,4.9
Bowie County,2017-Aug,38493,36637,1856,4.8
Bowie County,2017-Sep,39072,37417,1655,4.2
Bowie County,2017-Oct,38562,37032,1530,4
Bowie County,2017-Nov,38840,37203,1637,4.2
Bowie County,2017-Dec,38797,37199,1598,4.1
Bowie County,2018-Jan,38719,36911,1808,4.7
Bowie County,2018-Feb,39030,37174,1856,4.8
Bowie County,2018-Mar,39027,37251,1776,4.6
Bowie County,2018-Apr,39017,37393,1624,4.2
Bowie County,2018-May,39093,37258,1835,4.7
Bowie County,2018-Jun,39380,37159,2221,5.6
Bowie County,2018-Jul,38776,36641,2135,5.5
Bowie County,2018-Aug,38668,36612,2056,5.3
Bowie County,2018-Sep,39403,37286,2117,5.4
Bowie County,2018-Oct,39252,37273,1979,5
Bowie County,2018-Nov,39450,37486,1964,5
Bowie County,2018-Dec,39397,37466,1931,4.9
Bowie County,2019-Jan,39205,37064,2141,5.5
Bowie County,2019-Feb,39257,37286,1971,5
Bowie County,2019-Mar,39219,37436,1783,4.5
Bowie County,2019-Apr,39081,37566,1515,3.9
Bowie County,2019-May,39140,37594,1546,3.9
Bowie County,2019-Jun,39462,37599,1863,4.7
Bowie County,2019-Jul,38794,36886,1908,4.9
Bowie County,2019-Aug,38776,36950,1826,4.7
Bowie County,2019-Sep,39275,37576,1699,4.3
Bowie County,2019-Oct,39239,37606,1633,4.2
Bowie County,2019-Nov,39223,37653,1570,4
Bowie County,2019-Dec,39125,37680,1445,3.7
Bowie County,2020-Jan,38950,37344,1606,4.1
Bowie County,2020-Feb,39034,37439,1595,4.1
Bowie County,2020-Mar,38579,36255,2324,6
Bowie County,2020-Apr,36281,31562,4719,13
Bowie County,2020-May,37575,33565,4010,10.7
Bowie County,2020-Jun,38034,34332,3702,9.7
Bowie County,2020-Jul,38399,35039,3360,8.8
Bowie County,2020-Aug,38675,35896,2779,7.2
Bowie County,2020-Sep,38714,36021,2693,7
Bowie County,2020-Oct,38972,36604,2368,6.1
Bowie County,2020-Nov,38932,36444,2488,6.4
Bowie County,2020-Dec,38798,36332,2466,6.4
Bowie County,2021-Jan,38762,36114,2648,6.8
Bowie County,2021-Feb,39059,36389,2670,6.8
Bowie County,2021-Mar,39020,36488,2532,6.5
Bowie County,2021-Apr,39038,36739,2299,5.9
Bowie County,2021-May,39116,36868,2248,5.7
Bowie County,2021-Jun,39214,36674,2540,6.5
Bowie County,2021-Jul,38883,36547,2336,6
Bowie County,2021-Aug,38871,36655,2216,5.7
Bowie County,2021-Sep,38951,36910,2041,5.2
Bowie County,2021-Oct,39052,37070,1982,5.1
Bowie County,2021-Nov,39252,37284,1968,5
Bowie County,2021-Dec,39347,37499,1848,4.7
Bowie County,2022-Jan,39311,37217,2094,5.3
Bowie County,2022-Feb,39851,37751,2100,5.3
Bowie County,2022-Mar,39587,37873,1714,4.3
Bowie County,2022-Apr,39232,37586,1646,4.2
Bowie County,2022-May,39235,37517,1718,4.4
Bowie County,2022-Jun,39434,37491,1943,4.9
Bowie County,2022-Jul,39212(P),37276(P),1936(P),4.9(P)
Brazoria County,2012-Jan,158674,146546,12128,7.6
Brazoria County,2012-Feb,159567,147981,11586,7.3
Brazoria County,2012-Mar,159575,148863,10712,6.7
Brazoria County,2012-Apr,159504,149479,10025,6.3
Brazoria County,2012-May,160529,150010,10519,6.6
Brazoria County,2012-Jun,161365,149813,11552,7.2
Brazoria County,2012-Jul,162037,150473,11564,7.1
Brazoria County,2012-Aug,160937,150126,10811,6.7
Brazoria County,2012-Sep,161468,151436,10032,6.2
Brazoria County,2012-Oct,161974,152277,9697,6
Brazoria County,2012-Nov,161803,152371,9432,5.8
Brazoria County,2012-Dec,162294,152485,9809,6
Brazoria County,2013-Jan,162004,151101,10903,6.7
Brazoria County,2013-Feb,162746,152498,10248,6.3
Brazoria County,2013-Mar,162835,152968,9867,6.1
Brazoria County,2013-Apr,163200,153727,9473,5.8
Brazoria County,2013-May,163939,153938,10001,6.1
Brazoria County,2013-Jun,164647,153658,10989,6.7
Brazoria County,2013-Jul,165204,154433,10771,6.5
Brazoria County,2013-Aug,164392,154040,10352,6.3
Brazoria County,2013-Sep,164769,154591,10178,6.2
Brazoria County,2013-Oct,164114,154344,9770,6
Brazoria County,2013-Nov,165187,155624,9563,5.8
Brazoria County,2013-Dec,165147,156035,9112,5.5
Brazoria County,2014-Jan,164657,155016,9641,5.9
Brazoria County,2014-Feb,165571,156083,9488,5.7
Brazoria County,2014-Mar,166035,157001,9034,5.4
Brazoria County,2014-Apr,165543,157646,7897,4.8
Brazoria County,2014-May,166083,157704,8379,5
Brazoria County,2014-Jun,166604,157540,9064,5.4
Brazoria County,2014-Jul,167637,158263,9374,5.6
Brazoria County,2014-Aug,166910,157858,9052,5.4
Brazoria County,2014-Sep,166884,158529,8355,5
Brazoria County,2014-Oct,167209,159502,7707,4.6
Brazoria County,2014-Nov,167554,159744,7810,4.7
Brazoria County,2014-Dec,167165,159924,7241,4.3
Brazoria County,2015-Jan,167052,159012,8040,4.8
Brazoria County,2015-Feb,167262,159722,7540,4.5
Brazoria County,2015-Mar,166709,159426,7283,4.4
Brazoria County,2015-Apr,166817,159982,6835,4.1
Brazoria County,2015-May,166894,159632,7262,4.4
Brazoria County,2015-Jun,166986,159084,7902,4.7
Brazoria County,2015-Jul,167519,159265,8254,4.9
Brazoria County,2015-Aug,167092,159011,8081,4.8
Brazoria County,2015-Sep,166711,158744,7967,4.8
Brazoria County,2015-Oct,167066,159314,7752,4.6
Brazoria County,2015-Nov,167650,159699,7951,4.7
Brazoria County,2015-Dec,167752,160099,7653,4.6
Brazoria County,2016-Jan,168790,160583,8207,4.9
Brazoria County,2016-Feb,169815,161792,8023,4.7
Brazoria County,2016-Mar,169760,161555,8205,4.8
Brazoria County,2016-Apr,169461,161549,7912,4.7
Brazoria County,2016-May,169114,161108,8006,4.7
Brazoria County,2016-Jun,169974,160613,9361,5.5
Brazoria County,2016-Jul,170811,161156,9655,5.7
Brazoria County,2016-Aug,170123,160527,9596,5.6
Brazoria County,2016-Sep,170611,160903,9708,5.7
Brazoria County,2016-Oct,170054,161075,8979,5.3
Brazoria County,2016-Nov,170440,161488,8952,5.3
Brazoria County,2016-Dec,170325,160987,9338,5.5
Brazoria County,2017-Jan,170401,160109,10292,6
Brazoria County,2017-Feb,171465,161458,10007,5.8
Brazoria County,2017-Mar,171688,162355,9333,5.4
Brazoria County,2017-Apr,171990,163199,8791,5.1
Brazoria County,2017-May,171372,162686,8686,5.1
Brazoria County,2017-Jun,172419,162703,9716,5.6
Brazoria County,2017-Jul,172821,163254,9567,5.5
Brazoria County,2017-Aug,172376,162686,9690,5.6
Brazoria County,2017-Sep,172911,163450,9461,5.5
Brazoria County,2017-Oct,171625,163527,8098,4.7
Brazoria County,2017-Nov,172638,164202,8436,4.9
Brazoria County,2017-Dec,172358,164027,8331,4.8
Brazoria County,2018-Jan,173037,163798,9239,5.3
Brazoria County,2018-Feb,175067,166269,8798,5
Brazoria County,2018-Mar,174397,166170,8227,4.7
Brazoria County,2018-Apr,174329,166741,7588,4.4
Brazoria County,2018-May,174041,166638,7403,4.3
Brazoria County,2018-Jun,175409,166802,8607,4.9
Brazoria County,2018-Jul,175815,167362,8453,4.8
Brazoria County,2018-Aug,174393,166254,8139,4.7
Brazoria County,2018-Sep,174810,166961,7849,4.5
Brazoria County,2018-Oct,175392,168263,7129,4.1
Brazoria County,2018-Nov,175818,168688,7130,4.1
Brazoria County,2018-Dec,176051,168648,7403,4.2
Brazoria County,2019-Jan,175892,167559,8333,4.7
Brazoria County,2019-Feb,177000,169475,7525,4.3
Brazoria County,2019-Mar,176159,169228,6931,3.9
Brazoria County,2019-Apr,175701,169516,6185,3.5
Brazoria County,2019-May,175955,169475,6480,3.7
Brazoria County,2019-Jun,177668,169773,7895,4.4
Brazoria County,2019-Jul,178496,170172,8324,4.7
Brazoria County,2019-Aug,177997,169695,8302,4.7
Brazoria County,2019-Sep,178601,170865,7736,4.3
Brazoria County,2019-Oct,178822,171546,7276,4.1
Brazoria County,2019-Nov,179397,171895,7502,4.2
Brazoria County,2019-Dec,179145,171634,7511,4.2
Brazoria County,2020-Jan,179951,171681,8270,4.6
Brazoria County,2020-Feb,181151,173607,7544,4.2
Brazoria County,2020-Mar,178768,167174,11594,6.5
Brazoria County,2020-Apr,168340,147377,20963,12.5
Brazoria County,2020-May,174391,152786,21605,12.4
Brazoria County,2020-Jun,176666,156928,19738,11.2
Brazoria County,2020-Jul,176675,157728,18947,10.7
Brazoria County,2020-Aug,176682,160853,15829,9
Brazoria County,2020-Sep,177282,161903,15379,8.7
Brazoria County,2020-Oct,178262,164722,13540,7.6
Brazoria County,2020-Nov,179786,165448,14338,8
Brazoria County,2020-Dec,179782,165023,14759,8.2
Brazoria County,2021-Jan,178910,163664,15246,8.5
Brazoria County,2021-Feb,179929,165297,14632,8.1
Brazoria County,2021-Mar,179191,165569,13622,7.6
Brazoria County,2021-Apr,179259,166452,12807,7.1
Brazoria County,2021-May,178607,166571,12036,6.7
Brazoria County,2021-Jun,180145,166545,13600,7.5
Brazoria County,2021-Jul,180822,167894,12928,7.1
Brazoria County,2021-Aug,180367,168076,12291,6.8
Brazoria County,2021-Sep,180413,169207,11206,6.2
Brazoria County,2021-Oct,180769,170206,10563,5.8
Brazoria County,2021-Nov,181893,171714,10179,5.6
Brazoria County,2021-Dec,182180,172396,9784,5.4
Brazoria County,2022-Jan,182480,171363,11117,6.1
Brazoria County,2022-Feb,183865,173193,10672,5.8
Brazoria County,2022-Mar,182945,174103,8842,4.8
Brazoria County,2022-Apr,182555,174266,8289,4.5
Brazoria County,2022-May,183614,174995,8619,4.7
Brazoria County,2022-Jun,185584,175628,9956,5.4
Brazoria County,2022-Jul,185541(P),175783(P),9758(P),5.3(P)
Brazos County,2012-Jan,95337,89866,5471,5.7
Brazos County,2012-Feb,99275,93911,5364,5.4
Brazos County,2012-Mar,98754,93822,4932,5
Brazos County,2012-Apr,100403,95620,4783,4.8
Brazos County,2012-May,101418,96260,5158,5.1
Brazos County,2012-Jun,99030,93054,5976,6
Brazos County,2012-Jul,97890,91885,6005,6.1
Brazos County,2012-Aug,96532,91067,5465,5.7
Brazos County,2012-Sep,100714,95714,5000,5
Brazos County,2012-Oct,102032,97122,4910,4.8
Brazos County,2012-Nov,102291,97478,4813,4.7
Brazos County,2012-Dec,101496,96702,4794,4.7
Brazos County,2013-Jan,99222,93783,5439,5.5
Brazos County,2013-Feb,102491,97405,5086,5
Brazos County,2013-Mar,102493,97626,4867,4.7
Brazos County,2013-Apr,102174,97456,4718,4.6
Brazos County,2013-May,103224,98037,5187,5
Brazos County,2013-Jun,100533,94579,5954,5.9
Brazos County,2013-Jul,99100,93385,5715,5.8
Brazos County,2013-Aug,100462,95215,5247,5.2
Brazos County,2013-Sep,105226,100130,5096,4.8
Brazos County,2013-Oct,105517,100730,4787,4.5
Brazos County,2013-Nov,106066,101539,4527,4.3
Brazos County,2013-Dec,104623,100371,4252,4.1
Brazos County,2014-Jan,101342,96815,4527,4.5
Brazos County,2014-Feb,104809,100203,4606,4.4
Brazos County,2014-Mar,104730,100449,4281,4.1
Brazos County,2014-Apr,104680,100996,3684,3.5
Brazos County,2014-May,105341,101134,4207,4
Brazos County,2014-Jun,102407,97585,4822,4.7
Brazos County,2014-Jul,102067,97067,5000,4.9
Brazos County,2014-Aug,101813,97277,4536,4.5
Brazos County,2014-Sep,105130,101028,4102,3.9
Brazos County,2014-Oct,106194,102383,3811,3.6
Brazos County,2014-Nov,106593,102906,3687,3.5
Brazos County,2014-Dec,105054,101828,3226,3.1
Brazos County,2015-Jan,109236,105344,3892,3.6
Brazos County,2015-Feb,110651,106999,3652,3.3
Brazos County,2015-Mar,110388,106995,3393,3.1
Brazos County,2015-Apr,108318,105064,3254,3
Brazos County,2015-May,109329,105720,3609,3.3
Brazos County,2015-Jun,105653,101444,4209,4
Brazos County,2015-Jul,104598,100514,4084,3.9
Brazos County,2015-Aug,105161,101545,3616,3.4
Brazos County,2015-Sep,109264,105680,3584,3.3
Brazos County,2015-Oct,110618,107112,3506,3.2
Brazos County,2015-Nov,110984,107486,3498,3.2
Brazos County,2015-Dec,109456,106212,3244,3
Brazos County,2016-Jan,110038,106380,3658,3.3
Brazos County,2016-Feb,112457,108793,3664,3.3
Brazos County,2016-Mar,112229,108574,3655,3.3
Brazos County,2016-Apr,111329,107920,3409,3.1
Brazos County,2016-May,112299,108766,3533,3.1
Brazos County,2016-Jun,108413,104001,4412,4.1
Brazos County,2016-Jul,108369,103927,4442,4.1
Brazos County,2016-Aug,107424,103149,4275,4
Brazos County,2016-Sep,112755,108721,4034,3.6
Brazos County,2016-Oct,113661,109818,3843,3.4
Brazos County,2016-Nov,114194,110512,3682,3.2
Brazos County,2016-Dec,112886,109212,3674,3.3
Brazos County,2017-Jan,110009,106051,3958,3.6
Brazos County,2017-Feb,113226,109285,3941,3.5
Brazos County,2017-Mar,113763,110182,3581,3.1
Brazos County,2017-Apr,113039,109933,3106,2.7
Brazos County,2017-May,112111,108827,3284,2.9
Brazos County,2017-Jun,107916,104011,3905,3.6
Brazos County,2017-Jul,109232,105418,3814,3.5
Brazos County,2017-Aug,108091,104337,3754,3.5
Brazos County,2017-Sep,113866,110592,3274,2.9
Brazos County,2017-Oct,114898,111907,2991,2.6
Brazos County,2017-Nov,115853,112659,3194,2.8
Brazos County,2017-Dec,114216,111178,3038,2.7
Brazos County,2018-Jan,112966,109486,3480,3.1
Brazos County,2018-Feb,116402,112963,3439,3
Brazos County,2018-Mar,116632,113296,3336,2.9
Brazos County,2018-Apr,116050,113092,2958,2.5
Brazos County,2018-May,115313,112347,2966,2.6
Brazos County,2018-Jun,111705,107843,3862,3.5
Brazos County,2018-Jul,112039,108373,3666,3.3
Brazos County,2018-Aug,111469,107943,3526,3.2
Brazos County,2018-Sep,116814,113535,3279,2.8
Brazos County,2018-Oct,118216,115116,3100,2.6
Brazos County,2018-Nov,119500,116425,3075,2.6
Brazos County,2018-Dec,117119,113963,3156,2.7
Brazos County,2019-Jan,114834,111245,3589,3.1
Brazos County,2019-Feb,118958,115645,3313,2.8
Brazos County,2019-Mar,119110,116006,3104,2.6
Brazos County,2019-Apr,117261,114682,2579,2.2
Brazos County,2019-May,116813,113962,2851,2.4
Brazos County,2019-Jun,113243,109602,3641,3.2
Brazos County,2019-Jul,113264,109622,3642,3.2
Brazos County,2019-Aug,113309,109923,3386,3
Brazos County,2019-Sep,118670,115521,3149,2.7
Brazos County,2019-Oct,120863,117755,3108,2.6
Brazos County,2019-Nov,122123,119113,3010,2.5
Brazos County,2019-Dec,119298,116560,2738,2.3
Brazos County,2020-Jan,118350,115122,3228,2.7
Brazos County,2020-Feb,121925,118873,3052,2.5
Brazos County,2020-Mar,118736,114027,4709,4
Brazos County,2020-Apr,107938,98882,9056,8.4
Brazos County,2020-May,112937,103715,9222,8.2
Brazos County,2020-Jun,111312,102521,8791,7.9
Brazos County,2020-Jul,111689,103791,7898,7.1
Brazos County,2020-Aug,112704,106564,6140,5.4
Brazos County,2020-Sep,117666,111782,5884,5
Brazos County,2020-Oct,120536,115268,5268,4.4
Brazos County,2020-Nov,121420,115901,5519,4.5
Brazos County,2020-Dec,120645,115091,5554,4.6
Brazos County,2021-Jan,118642,112620,6022,5.1
Brazos County,2021-Feb,121383,115462,5921,4.9
Brazos County,2021-Mar,121509,116017,5492,4.5
Brazos County,2021-Apr,123004,118092,4912,4
Brazos County,2021-May,121118,116226,4892,4
Brazos County,2021-Jun,118770,112909,5861,4.9
Brazos County,2021-Jul,118664,113463,5201,4.4
Brazos County,2021-Aug,118037,113233,4804,4.1
Brazos County,2021-Sep,121215,116747,4468,3.7
Brazos County,2021-Oct,123112,118756,4356,3.5
Brazos County,2021-Nov,124193,120165,4028,3.2
Brazos County,2021-Dec,122902,119206,3696,3
Brazos County,2022-Jan,122331,117984,4347,3.6
Brazos County,2022-Feb,125508,121213,4295,3.4
Brazos County,2022-Mar,125825,122331,3494,2.8
Brazos County,2022-Apr,123478,120200,3278,2.7
Brazos County,2022-May,122646,119154,3492,2.8
Brazos County,2022-Jun,120413,116124,4289,3.6
Brazos County,2022-Jul,119884(P),115775(P),4109(P),3.4(P)
Brewster County,2012-Jan,4662,4402,260,5.6
Brewster County,2012-Feb,4629,4393,236,5.1
Brewster County,2012-Mar,4701,4482,219,4.7
Brewster County,2012-Apr,4701,4491,210,4.5
Brewster County,2012-May,4675,4457,218,4.7
Brewster County,2012-Jun,4761,4498,263,5.5
Brewster County,2012-Jul,4568,4297,271,5.9
Brewster County,2012-Aug,4497,4249,248,5.5
Brewster County,2012-Sep,4399,4186,213,4.8
Brewster County,2012-Oct,4370,4153,217,5
Brewster County,2012-Nov,4471,4273,198,4.4
Brewster County,2012-Dec,4194,3988,206,4.9
Brewster County,2013-Jan,4164,3909,255,6.1
Brewster County,2013-Feb,4174,3930,244,5.8
Brewster County,2013-Mar,4159,3929,230,5.5
Brewster County,2013-Apr,4218,4001,217,5.1
Brewster County,2013-May,4207,3964,243,5.8
Brewster County,2013-Jun,4160,3898,262,6.3
Brewster County,2013-Jul,4133,3883,250,6
Brewster County,2013-Aug,4116,3879,237,5.8
Brewster County,2013-Sep,4141,3910,231,5.6
Brewster County,2013-Oct,4088,3872,216,5.3
Brewster County,2013-Nov,4099,3897,202,4.9
Brewster County,2013-Dec,4097,3900,197,4.8
Brewster County,2014-Jan,4021,3826,195,4.8
Brewster County,2014-Feb,4077,3875,202,5
Brewster County,2014-Mar,4190,3986,204,4.9
Brewster County,2014-Apr,4176,4006,170,4.1
Brewster County,2014-May,4177,3976,201,4.8
Brewster County,2014-Jun,4150,3938,212,5.1
Brewster County,2014-Jul,4111,3887,224,5.4
Brewster County,2014-Aug,4048,3840,208,5.1
Brewster County,2014-Sep,3946,3762,184,4.7
Brewster County,2014-Oct,3953,3782,171,4.3
Brewster County,2014-Nov,4000,3831,169,4.2
Brewster County,2014-Dec,3889,3738,151,3.9
Brewster County,2015-Jan,3805,3628,177,4.7
Brewster County,2015-Feb,3857,3703,154,4
Brewster County,2015-Mar,3951,3789,162,4.1
Brewster County,2015-Apr,3936,3789,147,3.7
Brewster County,2015-May,3945,3789,156,4
Brewster County,2015-Jun,3920,3751,169,4.3
Brewster County,2015-Jul,3966,3788,178,4.5
Brewster County,2015-Aug,3920,3772,148,3.8
Brewster County,2015-Sep,3955,3811,144,3.6
Brewster County,2015-Oct,3880,3733,147,3.8
Brewster County,2015-Nov,3921,3778,143,3.6
Brewster County,2015-Dec,3881,3741,140,3.6
Brewster County,2016-Jan,3799,3647,152,4
Brewster County,2016-Feb,3899,3755,144,3.7
Brewster County,2016-Mar,3983,3839,144,3.6
Brewster County,2016-Apr,4023,3895,128,3.2
Brewster County,2016-May,4027,3892,135,3.4
Brewster County,2016-Jun,3985,3826,159,4
Brewster County,2016-Jul,4044,3873,171,4.2
Brewster County,2016-Aug,4086,3929,157,3.8
Brewster County,2016-Sep,4027,3867,160,4
Brewster County,2016-Oct,3884,3729,155,4
Brewster County,2016-Nov,3909,3765,144,3.7
Brewster County,2016-Dec,3891,3747,144,3.7
Brewster County,2017-Jan,3847,3667,180,4.7
Brewster County,2017-Feb,3922,3761,161,4.1
Brewster County,2017-Mar,4001,3850,151,3.8
Brewster County,2017-Apr,4051,3922,129,3.2
Brewster County,2017-May,4032,3899,133,3.3
Brewster County,2017-Jun,3942,3799,143,3.6
Brewster County,2017-Jul,3837,3695,142,3.7
Brewster County,2017-Aug,3899,3755,144,3.7
Brewster County,2017-Sep,3846,3725,121,3.1
Brewster County,2017-Oct,3941,3828,113,2.9
Brewster County,2017-Nov,3957,3832,125,3.2
Brewster County,2017-Dec,3978,3852,126,3.2
Brewster County,2018-Jan,3937,3783,154,3.9
Brewster County,2018-Feb,3988,3841,147,3.7
Brewster County,2018-Mar,4070,3930,140,3.4
Brewster County,2018-Apr,3970,3842,128,3.2
Brewster County,2018-May,3961,3838,123,3.1
Brewster County,2018-Jun,3956,3808,148,3.7
Brewster County,2018-Jul,4030,3893,137,3.4
Brewster County,2018-Aug,4090,3952,138,3.4
Brewster County,2018-Sep,4044,3908,136,3.4
Brewster County,2018-Oct,3990,3869,121,3
Brewster County,2018-Nov,4031,3908,123,3.1
Brewster County,2018-Dec,3999,3875,124,3.1
Brewster County,2019-Jan,4107,3955,152,3.7
Brewster County,2019-Feb,4117,3992,125,3
Brewster County,2019-Mar,4204,4081,123,2.9
Brewster County,2019-Apr,4184,4079,105,2.5
Brewster County,2019-May,4194,4090,104,2.5
Brewster County,2019-Jun,4106,3967,139,3.4
Brewster County,2019-Jul,4111,3969,142,3.5
Brewster County,2019-Aug,4133,4009,124,3
Brewster County,2019-Sep,4115,3995,120,2.9
Brewster County,2019-Oct,4114,4004,110,2.7
Brewster County,2019-Nov,4155,4048,107,2.6
Brewster County,2019-Dec,4147,4047,100,2.4
Brewster County,2020-Jan,4148,4038,110,2.7
Brewster County,2020-Feb,4170,4058,112,2.7
Brewster County,2020-Mar,4007,3828,179,4.5
Brewster County,2020-Apr,3807,3348,459,12.1
Brewster County,2020-May,3960,3524,436,11
Brewster County,2020-Jun,4017,3643,374,9.3
Brewster County,2020-Jul,4034,3681,353,8.8
Brewster County,2020-Aug,4106,3831,275,6.7
Brewster County,2020-Sep,4078,3826,252,6.2
Brewster County,2020-Oct,4151,3936,215,5.2
Brewster County,2020-Nov,4179,3956,223,5.3
Brewster County,2020-Dec,4163,3925,238,5.7
Brewster County,2021-Jan,4179,3944,235,5.6
Brewster County,2021-Feb,4224,3997,227,5.4
Brewster County,2021-Mar,4287,4066,221,5.2
Brewster County,2021-Apr,4311,4126,185,4.3
Brewster County,2021-May,4283,4095,188,4.4
Brewster County,2021-Jun,4240,4027,213,5
Brewster County,2021-Jul,4110,3916,194,4.7
Brewster County,2021-Aug,4104,3923,181,4.4
Brewster County,2021-Sep,4098,3925,173,4.2
Brewster County,2021-Oct,4104,3940,164,4
Brewster County,2021-Nov,4136,3979,157,3.8
Brewster County,2021-Dec,4087,3949,138,3.4
Brewster County,2022-Jan,4112,3952,160,3.9
Brewster County,2022-Feb,4206,4038,168,4
Brewster County,2022-Mar,4254,4118,136,3.2
Brewster County,2022-Apr,4149,4030,119,2.9
Brewster County,2022-May,4180,4043,137,3.3
Brewster County,2022-Jun,4143,3992,151,3.6
Brewster County,2022-Jul,4167(P),4026(P),141(P),3.4(P)
Briscoe County,2012-Jan,633,593,40,6.3
Briscoe County,2012-Feb,610,573,37,6.1
Briscoe County,2012-Mar,622,588,34,5.5
Briscoe County,2012-Apr,644,612,32,5
Briscoe County,2012-May,648,613,35,5.4
Briscoe County,2012-Jun,668,630,38,5.7
Briscoe County,2012-Jul,656,617,39,5.9
Briscoe County,2012-Aug,649,613,36,5.5
Briscoe County,2012-Sep,651,618,33,5.1
Briscoe County,2012-Oct,646,615,31,4.8
Briscoe County,2012-Nov,641,612,29,4.5
Briscoe County,2012-Dec,635,600,35,5.5
Briscoe County,2013-Jan,597,560,37,6.2
Briscoe County,2013-Feb,603,564,39,6.5
Briscoe County,2013-Mar,599,563,36,6
Briscoe County,2013-Apr,618,583,35,5.7
Briscoe County,2013-May,648,612,36,5.6
Briscoe County,2013-Jun,653,613,40,6.1
Briscoe County,2013-Jul,647,608,39,6
Briscoe County,2013-Aug,639,601,38,5.9
Briscoe County,2013-Sep,638,602,36,5.6
Briscoe County,2013-Oct,645,611,34,5.3
Briscoe County,2013-Nov,616,587,29,4.7
Briscoe County,2013-Dec,628,600,28,4.5
Briscoe County,2014-Jan,610,580,30,4.9
Briscoe County,2014-Feb,634,604,30,4.7
Briscoe County,2014-Mar,640,612,28,4.4
Briscoe County,2014-Apr,654,631,23,3.5
Briscoe County,2014-May,664,637,27,4.1
Briscoe County,2014-Jun,673,646,27,4
Briscoe County,2014-Jul,640,610,30,4.7
Briscoe County,2014-Aug,636,607,29,4.6
Briscoe County,2014-Sep,638,612,26,4.1
Briscoe County,2014-Oct,625,599,26,4.2
Briscoe County,2014-Nov,613,589,24,3.9
Briscoe County,2014-Dec,599,577,22,3.7
Briscoe County,2015-Jan,613,589,24,3.9
Briscoe County,2015-Feb,603,580,23,3.8
Briscoe County,2015-Mar,627,603,24,3.8
Briscoe County,2015-Apr,608,584,24,3.9
Briscoe County,2015-May,620,598,22,3.5
Briscoe County,2015-Jun,614,589,25,4.1
Briscoe County,2015-Jul,592,566,26,4.4
Briscoe County,2015-Aug,566,546,20,3.5
Briscoe County,2015-Sep,576,554,22,3.8
Briscoe County,2015-Oct,591,570,21,3.6
Briscoe County,2015-Nov,569,549,20,3.5
Briscoe County,2015-Dec,552,531,21,3.8
Briscoe County,2016-Jan,516,496,20,3.9
Briscoe County,2016-Feb,555,532,23,4.1
Briscoe County,2016-Mar,563,540,23,4.1
Briscoe County,2016-Apr,562,539,23,4.1
Briscoe County,2016-May,580,555,25,4.3
Briscoe County,2016-Jun,572,544,28,4.9
Briscoe County,2016-Jul,544,516,28,5.1
Briscoe County,2016-Aug,547,520,27,4.9
Briscoe County,2016-Sep,534,512,22,4.1
Briscoe County,2016-Oct,539,517,22,4.1
Briscoe County,2016-Nov,532,511,21,3.9
Briscoe County,2016-Dec,531,509,22,4.1
Briscoe County,2017-Jan,523,499,24,4.6
Briscoe County,2017-Feb,538,511,27,5
Briscoe County,2017-Mar,579,552,27,4.7
Briscoe County,2017-Apr,553,527,26,4.7
Briscoe County,2017-May,578,550,28,4.8
Briscoe County,2017-Jun,585,559,26,4.4
Briscoe County,2017-Jul,546,520,26,4.8
Briscoe County,2017-Aug,557,531,26,4.7
Briscoe County,2017-Sep,537,514,23,4.3
Briscoe County,2017-Oct,537,519,18,3.4
Briscoe County,2017-Nov,527,506,21,4
Briscoe County,2017-Dec,542,523,19,3.5
Briscoe County,2018-Jan,525,504,21,4
Briscoe County,2018-Feb,546,523,23,4.2
Briscoe County,2018-Mar,579,557,22,3.8
Briscoe County,2018-Apr,551,530,21,3.8
Briscoe County,2018-May,588,565,23,3.9
Briscoe County,2018-Jun,567,543,24,4.2
Briscoe County,2018-Jul,537,514,23,4.3
Briscoe County,2018-Aug,552,529,23,4.2
Briscoe County,2018-Sep,554,533,21,3.8
Briscoe County,2018-Oct,559,541,18,3.2
Briscoe County,2018-Nov,551,530,21,3.8
Briscoe County,2018-Dec,538,518,20,3.7
Briscoe County,2019-Jan,541,518,23,4.3
Briscoe County,2019-Feb,549,526,23,4.2
Briscoe County,2019-Mar,580,559,21,3.6
Briscoe County,2019-Apr,584,566,18,3.1
Briscoe County,2019-May,591,574,17,2.9
Briscoe County,2019-Jun,589,568,21,3.6
Briscoe County,2019-Jul,562,541,21,3.7
Briscoe County,2019-Aug,589,569,20,3.4
Briscoe County,2019-Sep,568,545,23,4
Briscoe County,2019-Oct,581,560,21,3.6
Briscoe County,2019-Nov,563,543,20,3.6
Briscoe County,2019-Dec,564,547,17,3
Briscoe County,2020-Jan,547,524,23,4.2
Briscoe County,2020-Feb,561,541,20,3.6
Briscoe County,2020-Mar,567,535,32,5.6
Briscoe County,2020-Apr,503,472,31,6.2
Briscoe County,2020-May,542,510,32,5.9
Briscoe County,2020-Jun,554,524,30,5.4
Briscoe County,2020-Jul,553,526,27,4.9
Briscoe County,2020-Aug,567,544,23,4.1
Briscoe County,2020-Sep,549,529,20,3.6
Briscoe County,2020-Oct,560,538,22,3.9
Briscoe County,2020-Nov,546,521,25,4.6
Briscoe County,2020-Dec,541,511,30,5.5
Briscoe County,2021-Jan,558,529,29,5.2
Briscoe County,2021-Feb,569,539,30,5.3
Briscoe County,2021-Mar,615,582,33,5.4
Briscoe County,2021-Apr,590,567,23,3.9
Briscoe County,2021-May,589,563,26,4.4
Briscoe County,2021-Jun,580,550,30,5.2
Briscoe County,2021-Jul,568,540,28,4.9
Briscoe County,2021-Aug,586,556,30,5.1
Briscoe County,2021-Sep,573,546,27,4.7
Briscoe County,2021-Oct,563,539,24,4.3
Briscoe County,2021-Nov,554,529,25,4.5
Briscoe County,2021-Dec,541,519,22,4.1
Briscoe County,2022-Jan,544,520,24,4.4
Briscoe County,2022-Feb,578,554,24,4.2
Briscoe County,2022-Mar,619,600,19,3.1
Briscoe County,2022-Apr,597,580,17,2.8
Briscoe County,2022-May,599,581,18,3
Briscoe County,2022-Jun,590,570,20,3.4
Briscoe County,2022-Jul,603(P),583(P),20(P),3.3(P)
Brooks County,2012-Jan,2701,2451,250,9.3
Brooks County,2012-Feb,2688,2450,238,8.9
Brooks County,2012-Mar,2694,2464,230,8.5
Brooks County,2012-Apr,2680,2467,213,7.9
Brooks County,2012-May,2690,2466,224,8.3
Brooks County,2012-Jun,2730,2463,267,9.8
Brooks County,2012-Jul,2726,2452,274,10.1
Brooks County,2012-Aug,2749,2484,265,9.6
Brooks County,2012-Sep,2744,2522,222,8.1
Brooks County,2012-Oct,2732,2515,217,7.9
Brooks County,2012-Nov,2704,2498,206,7.6
Brooks County,2012-Dec,2747,2516,231,8.4
Brooks County,2013-Jan,2779,2527,252,9.1
Brooks County,2013-Feb,2778,2534,244,8.8
Brooks County,2013-Mar,2827,2581,246,8.7
Brooks County,2013-Apr,2799,2570,229,8.2
Brooks County,2013-May,2813,2551,262,9.3
Brooks County,2013-Jun,2828,2524,304,10.7
Brooks County,2013-Jul,2734,2431,303,11.1
Brooks County,2013-Aug,2712,2455,257,9.5
Brooks County,2013-Sep,2719,2470,249,9.2
Brooks County,2013-Oct,2729,2495,234,8.6
Brooks County,2013-Nov,2704,2484,220,8.1
Brooks County,2013-Dec,2702,2494,208,7.7
Brooks County,2014-Jan,2708,2495,213,7.9
Brooks County,2014-Feb,2729,2498,231,8.5
Brooks County,2014-Mar,2720,2497,223,8.2
Brooks County,2014-Apr,2684,2503,181,6.7
Brooks County,2014-May,2702,2504,198,7.3
Brooks County,2014-Jun,2731,2483,248,9.1
Brooks County,2014-Jul,2750,2494,256,9.3
Brooks County,2014-Aug,2750,2494,256,9.3
Brooks County,2014-Sep,2696,2501,195,7.2
Brooks County,2014-Oct,2680,2494,186,6.9
Brooks County,2014-Nov,2656,2469,187,7
Brooks County,2014-Dec,2650,2476,174,6.6
Brooks County,2015-Jan,2650,2458,192,7.2
Brooks County,2015-Feb,2699,2489,210,7.8
Brooks County,2015-Mar,2675,2460,215,8
Brooks County,2015-Apr,2628,2400,228,8.7
Brooks County,2015-May,2631,2381,250,9.5
Brooks County,2015-Jun,2635,2346,289,11
Brooks County,2015-Jul,2599,2301,298,11.5
Brooks County,2015-Aug,2587,2260,327,12.6
Brooks County,2015-Sep,2554,2261,293,11.5
Brooks County,2015-Oct,2537,2260,277,10.9
Brooks County,2015-Nov,2523,2250,273,10.8
Brooks County,2015-Dec,2532,2266,266,10.5
Brooks County,2016-Jan,2460,2181,279,11.3
Brooks County,2016-Feb,2504,2225,279,11.1
Brooks County,2016-Mar,2533,2218,315,12.4
Brooks County,2016-Apr,2454,2144,310,12.6
Brooks County,2016-May,2429,2146,283,11.7
Brooks County,2016-Jun,2446,2113,333,13.6
Brooks County,2016-Jul,2446,2121,325,13.3
Brooks County,2016-Aug,2419,2119,300,12.4
Brooks County,2016-Sep,2412,2123,289,12
Brooks County,2016-Oct,2414,2154,260,10.8
Brooks County,2016-Nov,2386,2143,243,10.2
Brooks County,2016-Dec,2383,2137,246,10.3
Brooks County,2017-Jan,2458,2200,258,10.5
Brooks County,2017-Feb,2430,2183,247,10.2
Brooks County,2017-Mar,2474,2240,234,9.5
Brooks County,2017-Apr,2438,2233,205,8.4
Brooks County,2017-May,2418,2230,188,7.8
Brooks County,2017-Jun,2431,2211,220,9
Brooks County,2017-Jul,2425,2212,213,8.8
Brooks County,2017-Aug,2429,2217,212,8.7
Brooks County,2017-Sep,2385,2214,171,7.2
Brooks County,2017-Oct,2359,2208,151,6.4
Brooks County,2017-Nov,2357,2200,157,6.7
Brooks County,2017-Dec,2375,2222,153,6.4
Brooks County,2018-Jan,2403,2229,174,7.2
Brooks County,2018-Feb,2399,2225,174,7.3
Brooks County,2018-Mar,2416,2241,175,7.2
Brooks County,2018-Apr,2404,2254,150,6.2
Brooks County,2018-May,2400,2257,143,6
Brooks County,2018-Jun,2419,2237,182,7.5
Brooks County,2018-Jul,2445,2256,189,7.7
Brooks County,2018-Aug,2421,2281,140,5.8
Brooks County,2018-Sep,2451,2305,146,6
Brooks County,2018-Oct,2432,2297,135,5.6
Brooks County,2018-Nov,2437,2295,142,5.8
Brooks County,2018-Dec,2516,2386,130,5.2
Brooks County,2019-Jan,2611,2462,149,5.7
Brooks County,2019-Feb,2607,2478,129,4.9
Brooks County,2019-Mar,2601,2459,142,5.5
Brooks County,2019-Apr,2550,2445,105,4.1
Brooks County,2019-May,2544,2440,104,4.1
Brooks County,2019-Jun,2553,2404,149,5.8
Brooks County,2019-Jul,2615,2443,172,6.6
Brooks County,2019-Aug,2578,2449,129,5
Brooks County,2019-Sep,2569,2440,129,5
Brooks County,2019-Oct,2592,2468,124,4.8
Brooks County,2019-Nov,2656,2534,122,4.6
Brooks County,2019-Dec,2555,2431,124,4.9
Brooks County,2020-Jan,2694,2557,137,5.1
Brooks County,2020-Feb,2705,2570,135,5
Brooks County,2020-Mar,2709,2478,231,8.5
Brooks County,2020-Apr,2488,2192,296,11.9
Brooks County,2020-May,2554,2172,382,15
Brooks County,2020-Jun,2538,2170,368,14.5
Brooks County,2020-Jul,2556,2194,362,14.2
Brooks County,2020-Aug,2532,2242,290,11.5
Brooks County,2020-Sep,2487,2209,278,11.2
Brooks County,2020-Oct,2536,2275,261,10.3
Brooks County,2020-Nov,2534,2255,279,11
Brooks County,2020-Dec,2525,2253,272,10.8
Brooks County,2021-Jan,2534,2235,299,11.8
Brooks County,2021-Feb,2513,2242,271,10.8
Brooks County,2021-Mar,2502,2244,258,10.3
Brooks County,2021-Apr,2522,2286,236,9.4
Brooks County,2021-May,2491,2273,218,8.8
Brooks County,2021-Jun,2533,2278,255,10.1
Brooks County,2021-Jul,2522,2278,244,9.7
Brooks County,2021-Aug,2481,2255,226,9.1
Brooks County,2021-Sep,2473,2261,212,8.6
Brooks County,2021-Oct,2481,2286,195,7.9
Brooks County,2021-Nov,2484,2298,186,7.5
Brooks County,2021-Dec,2450,2279,171,7
Brooks County,2022-Jan,2541,2335,206,8.1
Brooks County,2022-Feb,2551,2350,201,7.9
Brooks County,2022-Mar,2530,2368,162,6.4
Brooks County,2022-Apr,2481,2331,150,6
Brooks County,2022-May,2469,2319,150,6.1
Brooks County,2022-Jun,2500,2317,183,7.3
Brooks County,2022-Jul,2504(P),2326(P),178(P),7.1(P)
Brown County,2012-Jan,16151,14949,1202,7.4
Brown County,2012-Feb,16122,14979,1143,7.1
Brown County,2012-Mar,16100,15037,1063,6.6
Brown County,2012-Apr,16039,15036,1003,6.3
Brown County,2012-May,16086,15019,1067,6.6
Brown County,2012-Jun,16246,15051,1195,7.4
Brown County,2012-Jul,16214,15032,1182,7.3
Brown County,2012-Aug,15928,14866,1062,6.7
Brown County,2012-Sep,16029,15032,997,6.2
Brown County,2012-Oct,15881,14824,1057,6.7
Brown County,2012-Nov,15758,14785,973,6.2
Brown County,2012-Dec,15837,14806,1031,6.5
Brown County,2013-Jan,15801,14657,1144,7.2
Brown County,2013-Feb,15820,14730,1090,6.9
Brown County,2013-Mar,15790,14757,1033,6.5
Brown County,2013-Apr,15842,14874,968,6.1
Brown County,2013-May,15939,14893,1046,6.6
Brown County,2013-Jun,16177,14991,1186,7.3
Brown County,2013-Jul,16114,14968,1146,7.1
Brown County,2013-Aug,15963,14908,1055,6.6
Brown County,2013-Sep,15949,14924,1025,6.4
Brown County,2013-Oct,15840,14870,970,6.1
Brown County,2013-Nov,15827,14906,921,5.8
Brown County,2013-Dec,15791,14939,852,5.4
Brown County,2014-Jan,15798,14926,872,5.5
Brown County,2014-Feb,15931,15038,893,5.6
Brown County,2014-Mar,15993,15132,861,5.4
Brown County,2014-Apr,15846,15132,714,4.5
Brown County,2014-May,15903,15116,787,4.9
Brown County,2014-Jun,15935,15047,888,5.6
Brown County,2014-Jul,16012,14827,1185,7.4
Brown County,2014-Aug,15724,14864,860,5.5
Brown County,2014-Sep,15777,14981,796,5
Brown County,2014-Oct,15714,14979,735,4.7
Brown County,2014-Nov,15757,15035,722,4.6
Brown County,2014-Dec,15546,14901,645,4.1
Brown County,2015-Jan,15667,14939,728,4.6
Brown County,2015-Feb,15711,15014,697,4.4
Brown County,2015-Mar,15823,15136,687,4.3
Brown County,2015-Apr,15717,15088,629,4
Brown County,2015-May,15835,15167,668,4.2
Brown County,2015-Jun,16047,15306,741,4.6
Brown County,2015-Jul,16069,15312,757,4.7
Brown County,2015-Aug,15993,15285,708,4.4
Brown County,2015-Sep,16041,15346,695,4.3
Brown County,2015-Oct,15905,15213,692,4.4
Brown County,2015-Nov,15983,15305,678,4.2
Brown County,2015-Dec,16005,15383,622,3.9
Brown County,2016-Jan,16055,15395,660,4.1
Brown County,2016-Feb,16253,15569,684,4.2
Brown County,2016-Mar,16340,15625,715,4.4
Brown County,2016-Apr,16154,15527,627,3.9
Brown County,2016-May,16144,15516,628,3.9
Brown County,2016-Jun,16302,15508,794,4.9
Brown County,2016-Jul,16166,15332,834,5.2
Brown County,2016-Aug,16159,15392,767,4.7
Brown County,2016-Sep,16196,15467,729,4.5
Brown County,2016-Oct,16002,15300,702,4.4
Brown County,2016-Nov,16199,15545,654,4
Brown County,2016-Dec,16151,15502,649,4
Brown County,2017-Jan,15959,15273,686,4.3
Brown County,2017-Feb,16101,15410,691,4.3
Brown County,2017-Mar,16273,15608,665,4.1
Brown County,2017-Apr,15973,15415,558,3.5
Brown County,2017-May,15986,15377,609,3.8
Brown County,2017-Jun,16099,15413,686,4.3
Brown County,2017-Jul,15944,15253,691,4.3
Brown County,2017-Aug,15965,15294,671,4.2
Brown County,2017-Sep,16028,15444,584,3.6
Brown County,2017-Oct,15749,15220,529,3.4
Brown County,2017-Nov,15794,15229,565,3.6
Brown County,2017-Dec,15779,15231,548,3.5
Brown County,2018-Jan,15905,15304,601,3.8
Brown County,2018-Feb,16112,15497,615,3.8
Brown County,2018-Mar,16165,15547,618,3.8
Brown County,2018-Apr,15902,15369,533,3.4
Brown County,2018-May,15927,15388,539,3.4
Brown County,2018-Jun,15926,15271,655,4.1
Brown County,2018-Jul,16075,15279,796,5
Brown County,2018-Aug,15821,15231,590,3.7
Brown County,2018-Sep,15798,15219,579,3.7
Brown County,2018-Oct,15585,15034,551,3.5
Brown County,2018-Nov,15580,15047,533,3.4
Brown County,2018-Dec,15617,15080,537,3.4
Brown County,2019-Jan,15789,15170,619,3.9
Brown County,2019-Feb,15773,15180,593,3.8
Brown County,2019-Mar,15724,15151,573,3.6
Brown County,2019-Apr,15419,14956,463,3
Brown County,2019-May,15335,14849,486,3.2
Brown County,2019-Jun,15327,14691,636,4.1
Brown County,2019-Jul,15460,14806,654,4.2
Brown County,2019-Aug,15605,14971,634,4.1
Brown County,2019-Sep,15429,14837,592,3.8
Brown County,2019-Oct,15313,14745,568,3.7
Brown County,2019-Nov,15278,14720,558,3.7
Brown County,2019-Dec,15302,14776,526,3.4
Brown County,2020-Jan,15204,14602,602,4
Brown County,2020-Feb,15226,14660,566,3.7
Brown County,2020-Mar,15093,14165,928,6.1
Brown County,2020-Apr,14282,13026,1256,8.8
Brown County,2020-May,14769,13442,1327,9
Brown County,2020-Jun,14880,13612,1268,8.5
Brown County,2020-Jul,15151,13969,1182,7.8
Brown County,2020-Aug,15220,14245,975,6.4
Brown County,2020-Sep,15378,14423,955,6.2
Brown County,2020-Oct,15415,14546,869,5.6
Brown County,2020-Nov,15508,14586,922,5.9
Brown County,2020-Dec,15342,14438,904,5.9
Brown County,2021-Jan,15348,14384,964,6.3
Brown County,2021-Feb,15486,14550,936,6
Brown County,2021-Mar,15490,14628,862,5.6
Brown County,2021-Apr,15361,14585,776,5.1
Brown County,2021-May,15221,14446,775,5.1
Brown County,2021-Jun,15341,14442,899,5.9
Brown County,2021-Jul,15187,14339,848,5.6
Brown County,2021-Aug,15191,14401,790,5.2
Brown County,2021-Sep,15256,14532,724,4.7
Brown County,2021-Oct,15134,14449,685,4.5
Brown County,2021-Nov,15158,14507,651,4.3
Brown County,2021-Dec,15026,14433,593,3.9
Brown County,2022-Jan,15020,14348,672,4.5
Brown County,2022-Feb,15187,14497,690,4.5
Brown County,2022-Mar,15272,14687,585,3.8
Brown County,2022-Apr,15143,14623,520,3.4
Brown County,2022-May,15035,14474,561,3.7
Brown County,2022-Jun,15127,14467,660,4.4
Brown County,2022-Jul,15031(P),14370(P),661(P),4.4(P)
Burleson County,2012-Jan,7345,6840,505,6.9
Burleson County,2012-Feb,7579,7103,476,6.3
Burleson County,2012-Mar,7580,7112,468,6.2
Burleson County,2012-Apr,7709,7258,451,5.9
Burleson County,2012-May,7767,7291,476,6.1
Burleson County,2012-Jun,7625,7097,528,6.9
Burleson County,2012-Jul,7523,7010,513,6.8
Burleson County,2012-Aug,7437,6946,491,6.6
Burleson County,2012-Sep,7755,7290,465,6
Burleson County,2012-Oct,7821,7367,454,5.8
Burleson County,2012-Nov,7839,7401,438,5.6
Burleson County,2012-Dec,7791,7321,470,6
Burleson County,2013-Jan,7433,6918,515,6.9
Burleson County,2013-Feb,7666,7170,496,6.5
Burleson County,2013-Mar,7642,7170,472,6.2
Burleson County,2013-Apr,7660,7202,458,6
Burleson County,2013-May,7726,7247,479,6.2
Burleson County,2013-Jun,7554,7024,530,7
Burleson County,2013-Jul,7475,6951,524,7
Burleson County,2013-Aug,7525,7045,480,6.4
Burleson County,2013-Sep,7879,7399,480,6.1
Burleson County,2013-Oct,7900,7443,457,5.8
Burleson County,2013-Nov,7906,7474,432,5.5
Burleson County,2013-Dec,7817,7406,411,5.3
Burleson County,2014-Jan,7384,6970,414,5.6
Burleson County,2014-Feb,7653,7233,420,5.5
Burleson County,2014-Mar,7649,7249,400,5.2
Burleson County,2014-Apr,7631,7298,333,4.4
Burleson County,2014-May,7685,7314,371,4.8
Burleson County,2014-Jun,7471,7077,394,5.3
Burleson County,2014-Jul,7437,7030,407,5.5
Burleson County,2014-Aug,7400,7020,380,5.1
Burleson County,2014-Sep,7642,7296,346,4.5
Burleson County,2014-Oct,7709,7388,321,4.2
Burleson County,2014-Nov,7724,7408,316,4.1
Burleson County,2014-Dec,7589,7307,282,3.7
Burleson County,2015-Jan,7751,7417,334,4.3
Burleson County,2015-Feb,7865,7543,322,4.1
Burleson County,2015-Mar,7887,7575,312,4
Burleson County,2015-Apr,7747,7445,302,3.9
Burleson County,2015-May,7844,7508,336,4.3
Burleson County,2015-Jun,7604,7215,389,5.1
Burleson County,2015-Jul,7503,7129,374,5
Burleson County,2015-Aug,7515,7169,346,4.6
Burleson County,2015-Sep,7801,7458,343,4.4
Burleson County,2015-Oct,7902,7558,344,4.4
Burleson County,2015-Nov,7909,7556,353,4.5
Burleson County,2015-Dec,7804,7469,335,4.3
Burleson County,2016-Jan,7737,7392,345,4.5
Burleson County,2016-Feb,7951,7602,349,4.4
Burleson County,2016-Mar,7975,7616,359,4.5
Burleson County,2016-Apr,7916,7583,333,4.2
Burleson County,2016-May,8016,7659,357,4.5
Burleson County,2016-Jun,7728,7322,406,5.3
Burleson County,2016-Jul,7667,7267,400,5.2
Burleson County,2016-Aug,7625,7228,397,5.2
Burleson County,2016-Sep,7957,7565,392,4.9
Burleson County,2016-Oct,8004,7642,362,4.5
Burleson County,2016-Nov,8026,7675,351,4.4
Burleson County,2016-Dec,7951,7599,352,4.4
Burleson County,2017-Jan,7777,7396,381,4.9
Burleson County,2017-Feb,8015,7634,381,4.8
Burleson County,2017-Mar,8088,7735,353,4.4
Burleson County,2017-Apr,8017,7706,311,3.9
Burleson County,2017-May,7954,7641,313,3.9
Burleson County,2017-Jun,7668,7314,354,4.6
Burleson County,2017-Jul,7702,7351,351,4.6
Burleson County,2017-Aug,7648,7301,347,4.5
Burleson County,2017-Sep,8011,7686,325,4.1
Burleson County,2017-Oct,8096,7806,290,3.6
Burleson County,2017-Nov,8156,7836,320,3.9
Burleson County,2017-Dec,8066,7759,307,3.8
Burleson County,2018-Jan,7985,7660,325,4.1
Burleson County,2018-Feb,8227,7900,327,4
Burleson County,2018-Mar,8291,7976,315,3.8
Burleson County,2018-Apr,8224,7937,287,3.5
Burleson County,2018-May,8192,7907,285,3.5
Burleson County,2018-Jun,7913,7581,332,4.2
Burleson County,2018-Jul,7909,7597,312,3.9
Burleson County,2018-Aug,7888,7590,298,3.8
Burleson County,2018-Sep,8226,7943,283,3.4
Burleson County,2018-Oct,8296,8035,261,3.1
Burleson County,2018-Nov,8379,8113,266,3.2
Burleson County,2018-Dec,8206,7946,260,3.2
Burleson County,2019-Jan,8006,7708,298,3.7
Burleson County,2019-Feb,8286,8015,271,3.3
Burleson County,2019-Mar,8327,8068,259,3.1
Burleson County,2019-Apr,8181,7961,220,2.7
Burleson County,2019-May,8146,7927,219,2.7
Burleson County,2019-Jun,7890,7626,264,3.3
Burleson County,2019-Jul,7894,7624,270,3.4
Burleson County,2019-Aug,7940,7681,259,3.3
Burleson County,2019-Sep,8259,8015,244,3
Burleson County,2019-Oct,8414,8170,244,2.9
Burleson County,2019-Nov,8498,8232,266,3.1
Burleson County,2019-Dec,8329,8080,249,3
Burleson County,2020-Jan,8183,7894,289,3.5
Burleson County,2020-Feb,8441,8153,288,3.4
Burleson County,2020-Mar,8269,7830,439,5.3
Burleson County,2020-Apr,7443,6789,654,8.8
Burleson County,2020-May,7824,7119,705,9
Burleson County,2020-Jun,7709,7048,661,8.6
Burleson County,2020-Jul,7773,7150,623,8
Burleson County,2020-Aug,7888,7362,526,6.7
Burleson County,2020-Sep,8197,7669,528,6.4
Burleson County,2020-Oct,8378,7912,466,5.6
Burleson County,2020-Nov,8411,7917,494,5.9
Burleson County,2020-Dec,8365,7872,493,5.9
Burleson County,2021-Jan,8251,7727,524,6.4
Burleson County,2021-Feb,8440,7937,503,6
Burleson County,2021-Mar,8513,8022,491,5.8
Burleson County,2021-Apr,8560,8132,428,5
Burleson County,2021-May,8398,7990,408,4.9
Burleson County,2021-Jun,8232,7757,475,5.8
Burleson County,2021-Jul,8229,7812,417,5.1
Burleson County,2021-Aug,8216,7813,403,4.9
Burleson County,2021-Sep,8410,8032,378,4.5
Burleson County,2021-Oct,8501,8145,356,4.2
Burleson County,2021-Nov,8549,8211,338,4
Burleson County,2021-Dec,8459,8148,311,3.7
Burleson County,2022-Jan,8415,8051,364,4.3
Burleson County,2022-Feb,8682,8321,361,4.2
Burleson County,2022-Mar,8741,8452,289,3.3
Burleson County,2022-Apr,8567,8294,273,3.2
Burleson County,2022-May,8485,8201,284,3.3
Burleson County,2022-Jun,8322,7997,325,3.9
Burleson County,2022-Jul,8354(P),8024(P),330(P),4.0(P)
Burnet County,2012-Jan,20158,18823,1335,6.6
Burnet County,2012-Feb,20084,18805,1279,6.4
Burnet County,2012-Mar,20172,18969,1203,6
Burnet County,2012-Apr,20240,19118,1122,5.5
Burnet County,2012-May,20393,19205,1188,5.8
Burnet County,2012-Jun,20641,19327,1314,6.4
Burnet County,2012-Jul,20646,19315,1331,6.4
Burnet County,2012-Aug,20446,19233,1213,5.9
Burnet County,2012-Sep,20483,19327,1156,5.6
Burnet County,2012-Oct,20371,19256,1115,5.5
Burnet County,2012-Nov,20512,19412,1100,5.4
Burnet County,2012-Dec,20378,19258,1120,5.5
Burnet County,2013-Jan,20389,19109,1280,6.3
Burnet County,2013-Feb,20372,19169,1203,5.9
Burnet County,2013-Mar,20474,19319,1155,5.6
Burnet County,2013-Apr,20690,19602,1088,5.3
Burnet County,2013-May,20902,19772,1130,5.4
Burnet County,2013-Jun,21141,19880,1261,6
Burnet County,2013-Jul,21146,19904,1242,5.9
Burnet County,2013-Aug,20911,19768,1143,5.5
Burnet County,2013-Sep,20912,19749,1163,5.6
Burnet County,2013-Oct,20712,19616,1096,5.3
Burnet County,2013-Nov,20796,19772,1024,4.9
Burnet County,2013-Dec,20659,19701,958,4.6
Burnet County,2014-Jan,20813,19811,1002,4.8
Burnet County,2014-Feb,21026,20011,1015,4.8
Burnet County,2014-Mar,21300,20319,981,4.6
Burnet County,2014-Apr,21465,20616,849,4
Burnet County,2014-May,21622,20674,948,4.4
Burnet County,2014-Jun,21797,20812,985,4.5
Burnet County,2014-Jul,21872,20837,1035,4.7
Burnet County,2014-Aug,21681,20700,981,4.5
Burnet County,2014-Sep,21575,20640,935,4.3
Burnet County,2014-Oct,21650,20779,871,4
Burnet County,2014-Nov,21576,20719,857,4
Burnet County,2014-Dec,21236,20456,780,3.7
Burnet County,2015-Jan,20944,20055,889,4.2
Burnet County,2015-Feb,21010,20178,832,4
Burnet County,2015-Mar,21086,20301,785,3.7
Burnet County,2015-Apr,21238,20509,729,3.4
Burnet County,2015-May,21348,20580,768,3.6
Burnet County,2015-Jun,21576,20762,814,3.8
Burnet County,2015-Jul,21532,20696,836,3.9
Burnet County,2015-Aug,21273,20517,756,3.6
Burnet County,2015-Sep,21063,20299,764,3.6
Burnet County,2015-Oct,21040,20305,735,3.5
Burnet County,2015-Nov,21058,20322,736,3.5
Burnet County,2015-Dec,21033,20343,690,3.3
Burnet County,2016-Jan,21355,20625,730,3.4
Burnet County,2016-Feb,21657,20908,749,3.5
Burnet County,2016-Mar,21816,21067,749,3.4
Burnet County,2016-Apr,21938,21264,674,3.1
Burnet County,2016-May,22106,21421,685,3.1
Burnet County,2016-Jun,22429,21623,806,3.6
Burnet County,2016-Jul,22431,21570,861,3.8
Burnet County,2016-Aug,22093,21292,801,3.6
Burnet County,2016-Sep,22029,21212,817,3.7
Burnet County,2016-Oct,21991,21223,768,3.5
Burnet County,2016-Nov,22107,21351,756,3.4
Burnet County,2016-Dec,22091,21335,756,3.4
Burnet County,2017-Jan,21540,20721,819,3.8
Burnet County,2017-Feb,21808,20990,818,3.8
Burnet County,2017-Mar,21898,21153,745,3.4
Burnet County,2017-Apr,22088,21443,645,2.9
Burnet County,2017-May,22245,21559,686,3.1
Burnet County,2017-Jun,22448,21713,735,3.3
Burnet County,2017-Jul,22293,21528,765,3.4
Burnet County,2017-Aug,22211,21469,742,3.3
Burnet County,2017-Sep,22049,21373,676,3.1
Burnet County,2017-Oct,22172,21564,608,2.7
Burnet County,2017-Nov,22272,21628,644,2.9
Burnet County,2017-Dec,22247,21638,609,2.7
Burnet County,2018-Jan,22384,21697,687,3.1
Burnet County,2018-Feb,22612,21921,691,3.1
Burnet County,2018-Mar,22793,22099,694,3
Burnet County,2018-Apr,22820,22207,613,2.7
Burnet County,2018-May,22843,22222,621,2.7
Burnet County,2018-Jun,22973,22263,710,3.1
Burnet County,2018-Jul,23054,22347,707,3.1
Burnet County,2018-Aug,22605,21942,663,2.9
Burnet County,2018-Sep,22582,21916,666,2.9
Burnet County,2018-Oct,22563,21946,617,2.7
Burnet County,2018-Nov,22584,21959,625,2.8
Burnet County,2018-Dec,22561,21931,630,2.8
Burnet County,2019-Jan,22952,22223,729,3.2
Burnet County,2019-Feb,23303,22633,670,2.9
Burnet County,2019-Mar,23284,22634,650,2.8
Burnet County,2019-Apr,23029,22490,539,2.3
Burnet County,2019-May,23111,22550,561,2.4
Burnet County,2019-Jun,23348,22674,674,2.9
Burnet County,2019-Jul,23791,23073,718,3
Burnet County,2019-Aug,23493,22814,679,2.9
Burnet County,2019-Sep,23307,22672,635,2.7
Burnet County,2019-Oct,23397,22787,610,2.6
Burnet County,2019-Nov,23388,22769,619,2.6
Burnet County,2019-Dec,23289,22730,559,2.4
Burnet County,2020-Jan,23558,22909,649,2.8
Burnet County,2020-Feb,23905,23272,633,2.6
Burnet County,2020-Mar,23441,22489,952,4.1
Burnet County,2020-Apr,21925,20229,1696,7.7
Burnet County,2020-May,22699,21154,1545,6.8
Burnet County,2020-Jun,23242,21823,1419,6.1
Burnet County,2020-Jul,23809,22479,1330,5.6
Burnet County,2020-Aug,23855,22782,1073,4.5
Burnet County,2020-Sep,23807,22730,1077,4.5
Burnet County,2020-Oct,23924,22958,966,4
Burnet County,2020-Nov,24003,22963,1040,4.3
Burnet County,2020-Dec,24045,23004,1041,4.3
Burnet County,2021-Jan,24263,23167,1096,4.5
Burnet County,2021-Feb,24328,23224,1104,4.5
Burnet County,2021-Mar,24610,23551,1059,4.3
Burnet County,2021-Apr,24556,23638,918,3.7
Burnet County,2021-May,24688,23778,910,3.7
Burnet County,2021-Jun,24809,23770,1039,4.2
Burnet County,2021-Jul,24940,24004,936,3.8
Burnet County,2021-Aug,24777,23894,883,3.6
Burnet County,2021-Sep,24531,23699,832,3.4
Burnet County,2021-Oct,24544,23744,800,3.3
Burnet County,2021-Nov,24574,23823,751,3.1
Burnet County,2021-Dec,24506,23815,691,2.8
Burnet County,2022-Jan,24683,23867,816,3.3
Burnet County,2022-Feb,24911,24073,838,3.4
Burnet County,2022-Mar,25242,24568,674,2.7
Burnet County,2022-Apr,24917,24292,625,2.5
Burnet County,2022-May,24892,24212,680,2.7
Burnet County,2022-Jun,25033,24260,773,3.1
Burnet County,2022-Jul,25228(P),24491(P),737(P),2.9(P)
Caldwell County,2012-Jan,16583,15268,1315,7.9
Caldwell County,2012-Feb,16625,15358,1267,7.6
Caldwell County,2012-Mar,16672,15440,1232,7.4
Caldwell County,2012-Apr,16663,15544,1119,6.7
Caldwell County,2012-May,16701,15540,1161,7
Caldwell County,2012-Jun,16886,15554,1332,7.9
Caldwell County,2012-Jul,16890,15570,1320,7.8
Caldwell County,2012-Aug,16774,15559,1215,7.2
Caldwell County,2012-Sep,16864,15737,1127,6.7
Caldwell County,2012-Oct,16977,15863,1114,6.6
Caldwell County,2012-Nov,17044,15965,1079,6.3
Caldwell County,2012-Dec,16954,15860,1094,6.5
Caldwell County,2013-Jan,16802,15585,1217,7.2
Caldwell County,2013-Feb,16854,15690,1164,6.9
Caldwell County,2013-Mar,16920,15733,1187,7
Caldwell County,2013-Apr,17011,15938,1073,6.3
Caldwell County,2013-May,17070,15956,1114,6.5
Caldwell County,2013-Jun,17238,15966,1272,7.4
Caldwell County,2013-Jul,17270,16008,1262,7.3
Caldwell County,2013-Aug,17130,15972,1158,6.8
Caldwell County,2013-Sep,17176,16076,1100,6.4
Caldwell County,2013-Oct,17188,16081,1107,6.4
Caldwell County,2013-Nov,17274,16273,1001,5.8
Caldwell County,2013-Dec,17172,16250,922,5.4
Caldwell County,2014-Jan,16927,15970,957,5.7
Caldwell County,2014-Feb,17096,16132,964,5.6
Caldwell County,2014-Mar,17224,16244,980,5.7
Caldwell County,2014-Apr,17156,16331,825,4.8
Caldwell County,2014-May,17191,16304,887,5.2
Caldwell County,2014-Jun,17357,16326,1031,5.9
Caldwell County,2014-Jul,17381,16321,1060,6.1
Caldwell County,2014-Aug,17225,16258,967,5.6
Caldwell County,2014-Sep,17244,16352,892,5.2
Caldwell County,2014-Oct,17291,16480,811,4.7
Caldwell County,2014-Nov,17337,16535,802,4.6
Caldwell County,2014-Dec,17179,16450,729,4.2
Caldwell County,2015-Jan,17113,16269,844,4.9
Caldwell County,2015-Feb,17184,16406,778,4.5
Caldwell County,2015-Mar,17230,16500,730,4.2
Caldwell County,2015-Apr,17319,16652,667,3.9
Caldwell County,2015-May,17430,16705,725,4.2
Caldwell County,2015-Jun,17541,16709,832,4.7
Caldwell County,2015-Jul,17496,16652,844,4.8
Caldwell County,2015-Aug,17394,16636,758,4.4
Caldwell County,2015-Sep,17477,16731,746,4.3
Caldwell County,2015-Oct,17617,16847,770,4.4
Caldwell County,2015-Nov,17695,16951,744,4.2
Caldwell County,2015-Dec,17676,16970,706,4
Caldwell County,2016-Jan,17536,16770,766,4.4
Caldwell County,2016-Feb,17774,17013,761,4.3
Caldwell County,2016-Mar,17870,17089,781,4.4
Caldwell County,2016-Apr,17881,17167,714,4
Caldwell County,2016-May,17887,17174,713,4
Caldwell County,2016-Jun,18045,17181,864,4.8
Caldwell County,2016-Jul,18079,17198,881,4.9
Caldwell County,2016-Aug,17985,17167,818,4.5
Caldwell County,2016-Sep,18055,17239,816,4.5
Caldwell County,2016-Oct,18084,17327,757,4.2
Caldwell County,2016-Nov,18139,17399,740,4.1
Caldwell County,2016-Dec,18079,17346,733,4.1
Caldwell County,2017-Jan,18027,17230,797,4.4
Caldwell County,2017-Feb,18224,17406,818,4.5
Caldwell County,2017-Mar,18331,17531,800,4.4
Caldwell County,2017-Apr,18334,17664,670,3.7
Caldwell County,2017-May,18316,17628,688,3.8
Caldwell County,2017-Jun,18439,17643,796,4.3
Caldwell County,2017-Jul,18451,17666,785,4.3
Caldwell County,2017-Aug,18389,17619,770,4.2
Caldwell County,2017-Sep,18452,17787,665,3.6
Caldwell County,2017-Oct,18462,17839,623,3.4
Caldwell County,2017-Nov,18534,17864,670,3.6
Caldwell County,2017-Dec,18491,17865,626,3.4
Caldwell County,2018-Jan,18509,17806,703,3.8
Caldwell County,2018-Feb,18756,18041,715,3.8
Caldwell County,2018-Mar,18841,18092,749,4
Caldwell County,2018-Apr,18829,18203,626,3.3
Caldwell County,2018-May,18827,18216,611,3.2
Caldwell County,2018-Jun,19014,18238,776,4.1
Caldwell County,2018-Jul,19027,18242,785,4.1
Caldwell County,2018-Aug,18867,18143,724,3.8
Caldwell County,2018-Sep,18932,18242,690,3.6
Caldwell County,2018-Oct,19077,18418,659,3.5
Caldwell County,2018-Nov,19111,18464,647,3.4
Caldwell County,2018-Dec,19100,18434,666,3.5
Caldwell County,2019-Jan,18859,18067,792,4.2
Caldwell County,2019-Feb,18977,18291,686,3.6
Caldwell County,2019-Mar,18985,18331,654,3.4
Caldwell County,2019-Apr,18969,18408,561,3
Caldwell County,2019-May,18961,18387,574,3
Caldwell County,2019-Jun,19168,18446,722,3.8
Caldwell County,2019-Jul,19254,18499,755,3.9
Caldwell County,2019-Aug,19175,18504,671,3.5
Caldwell County,2019-Sep,19246,18597,649,3.4
Caldwell County,2019-Oct,19360,18750,610,3.2
Caldwell County,2019-Nov,19408,18799,609,3.1
Caldwell County,2019-Dec,19374,18827,547,2.8
Caldwell County,2020-Jan,19050,18410,640,3.4
Caldwell County,2020-Feb,19204,18597,607,3.2
Caldwell County,2020-Mar,18874,17935,939,5
Caldwell County,2020-Apr,17398,15649,1749,10.1
Caldwell County,2020-May,18052,16271,1781,9.9
Caldwell County,2020-Jun,18566,16898,1668,9
Caldwell County,2020-Jul,18767,17215,1552,8.3
Caldwell County,2020-Aug,18939,17668,1271,6.7
Caldwell County,2020-Sep,18977,17784,1193,6.3
Caldwell County,2020-Oct,19236,18185,1051,5.5
Caldwell County,2020-Nov,19327,18223,1104,5.7
Caldwell County,2020-Dec,19373,18275,1098,5.7
Caldwell County,2021-Jan,19395,18209,1186,6.1
Caldwell County,2021-Feb,19553,18408,1145,5.9
Caldwell County,2021-Mar,19623,18535,1088,5.5
Caldwell County,2021-Apr,19763,18754,1009,5.1
Caldwell County,2021-May,19788,18819,969,4.9
Caldwell County,2021-Jun,20071,18918,1153,5.7
Caldwell County,2021-Jul,20176,19122,1054,5.2
Caldwell County,2021-Aug,20150,19184,966,4.8
Caldwell County,2021-Sep,20147,19286,861,4.3
Caldwell County,2021-Oct,20342,19511,831,4.1
Caldwell County,2021-Nov,20440,19658,782,3.8
Caldwell County,2021-Dec,20408,19690,718,3.5
Caldwell County,2022-Jan,20369,19542,827,4.1
Caldwell County,2022-Feb,20635,19820,815,3.9
Caldwell County,2022-Mar,20734,20068,666,3.2
Caldwell County,2022-Apr,20590,19957,633,3.1
Caldwell County,2022-May,20524,19855,669,3.3
Caldwell County,2022-Jun,20749,19926,823,4
Caldwell County,2022-Jul,20840(P),20027(P),813(P),3.9(P)
Calhoun County,2012-Jan,10126,9264,862,8.5
Calhoun County,2012-Feb,10122,9270,852,8.4
Calhoun County,2012-Mar,10181,9401,780,7.7
Calhoun County,2012-Apr,10211,9471,740,7.2
Calhoun County,2012-May,10444,9682,762,7.3
Calhoun County,2012-Jun,10442,9612,830,7.9
Calhoun County,2012-Jul,10474,9650,824,7.9
Calhoun County,2012-Aug,10404,9650,754,7.2
Calhoun County,2012-Sep,10472,9770,702,6.7
Calhoun County,2012-Oct,10532,9851,681,6.5
Calhoun County,2012-Nov,10657,9999,658,6.2
Calhoun County,2012-Dec,10701,10038,663,6.2
Calhoun County,2013-Jan,10927,10196,731,6.7
Calhoun County,2013-Feb,11100,10426,674,6.1
Calhoun County,2013-Mar,11036,10395,641,5.8
Calhoun County,2013-Apr,10562,9933,629,6
Calhoun County,2013-May,10688,10010,678,6.3
Calhoun County,2013-Jun,10771,10027,744,6.9
Calhoun County,2013-Jul,10783,10044,739,6.9
Calhoun County,2013-Aug,10828,10124,704,6.5
Calhoun County,2013-Sep,10873,10176,697,6.4
Calhoun County,2013-Oct,10736,10081,655,6.1
Calhoun County,2013-Nov,10807,10197,610,5.6
Calhoun County,2013-Dec,10756,10147,609,5.7
Calhoun County,2014-Jan,10789,10175,614,5.7
Calhoun County,2014-Feb,10854,10245,609,5.6
Calhoun County,2014-Mar,10988,10409,579,5.3
Calhoun County,2014-Apr,11014,10520,494,4.5
Calhoun County,2014-May,10972,10449,523,4.8
Calhoun County,2014-Jun,10953,10378,575,5.2
Calhoun County,2014-Jul,11100,10503,597,5.4
Calhoun County,2014-Aug,11090,10524,566,5.1
Calhoun County,2014-Sep,11122,10607,515,4.6
Calhoun County,2014-Oct,11203,10727,476,4.2
Calhoun County,2014-Nov,11402,10942,460,4
Calhoun County,2014-Dec,11394,10978,416,3.7
Calhoun County,2015-Jan,11310,10826,484,4.3
Calhoun County,2015-Feb,11411,10964,447,3.9
Calhoun County,2015-Mar,11438,11000,438,3.8
Calhoun County,2015-Apr,11435,11024,411,3.6
Calhoun County,2015-May,11537,11098,439,3.8
Calhoun County,2015-Jun,11592,11120,472,4.1
Calhoun County,2015-Jul,11456,10956,500,4.4
Calhoun County,2015-Aug,11430,10962,468,4.1
Calhoun County,2015-Sep,11275,10814,461,4.1
Calhoun County,2015-Oct,11190,10744,446,4
Calhoun County,2015-Nov,10999,10555,444,4
Calhoun County,2015-Dec,10921,10462,459,4.2
Calhoun County,2016-Jan,10792,10285,507,4.7
Calhoun County,2016-Feb,10840,10315,525,4.8
Calhoun County,2016-Mar,10839,10285,554,5.1
Calhoun County,2016-Apr,10869,10307,562,5.2
Calhoun County,2016-May,10909,10361,548,5
Calhoun County,2016-Jun,10966,10355,611,5.6
Calhoun County,2016-Jul,10988,10346,642,5.8
Calhoun County,2016-Aug,11036,10346,690,6.3
Calhoun County,2016-Sep,10854,10158,696,6.4
Calhoun County,2016-Oct,10510,9893,617,5.9
Calhoun County,2016-Nov,10421,9802,619,5.9
Calhoun County,2016-Dec,10336,9679,657,6.4
Calhoun County,2017-Jan,10243,9532,711,6.9
Calhoun County,2017-Feb,10402,9736,666,6.4
Calhoun County,2017-Mar,10421,9789,632,6.1
Calhoun County,2017-Apr,10520,9938,582,5.5
Calhoun County,2017-May,10410,9869,541,5.2
Calhoun County,2017-Jun,10459,9863,596,5.7
Calhoun County,2017-Jul,10392,9820,572,5.5
Calhoun County,2017-Aug,10327,9737,590,5.7
Calhoun County,2017-Sep,10463,9805,658,6.3
Calhoun County,2017-Oct,10509,9933,576,5.5
Calhoun County,2017-Nov,10509,9914,595,5.7
Calhoun County,2017-Dec,10382,9825,557,5.4
Calhoun County,2018-Jan,10644,10038,606,5.7
Calhoun County,2018-Feb,11019,10479,540,4.9
Calhoun County,2018-Mar,11150,10647,503,4.5
Calhoun County,2018-Apr,10986,10521,465,4.2
Calhoun County,2018-May,10958,10533,425,3.9
Calhoun County,2018-Jun,11113,10615,498,4.5
Calhoun County,2018-Jul,11066,10607,459,4.1
Calhoun County,2018-Aug,11152,10730,422,3.8
Calhoun County,2018-Sep,11116,10712,404,3.6
Calhoun County,2018-Oct,11220,10834,386,3.4
Calhoun County,2018-Nov,11397,11007,390,3.4
Calhoun County,2018-Dec,11408,11001,407,3.6
Calhoun County,2019-Jan,11712,11264,448,3.8
Calhoun County,2019-Feb,11982,11587,395,3.3
Calhoun County,2019-Mar,11981,11624,357,3
Calhoun County,2019-Apr,12020,11709,311,2.6
Calhoun County,2019-May,12125,11784,341,2.8
Calhoun County,2019-Jun,12121,11698,423,3.5
Calhoun County,2019-Jul,12039,11608,431,3.6
Calhoun County,2019-Aug,11932,11527,405,3.4
Calhoun County,2019-Sep,11881,11512,369,3.1
Calhoun County,2019-Oct,11978,11620,358,3
Calhoun County,2019-Nov,12032,11642,390,3.2
Calhoun County,2019-Dec,11992,11596,396,3.3
Calhoun County,2020-Jan,11989,11568,421,3.5
Calhoun County,2020-Feb,11997,11619,378,3.2
Calhoun County,2020-Mar,11765,11201,564,4.8
Calhoun County,2020-Apr,11013,10118,895,8.1
Calhoun County,2020-May,11096,10200,896,8.1
Calhoun County,2020-Jun,11367,10494,873,7.7
Calhoun County,2020-Jul,11866,11000,866,7.3
Calhoun County,2020-Aug,11997,11278,719,6
Calhoun County,2020-Sep,12174,11476,698,5.7
Calhoun County,2020-Oct,12280,11649,631,5.1
Calhoun County,2020-Nov,12357,11707,650,5.3
Calhoun County,2020-Dec,12232,11544,688,5.6
Calhoun County,2021-Jan,12089,11360,729,6
Calhoun County,2021-Feb,12254,11533,721,5.9
Calhoun County,2021-Mar,12505,11860,645,5.2
Calhoun County,2021-Apr,12515,11910,605,4.8
Calhoun County,2021-May,12172,11598,574,4.7
Calhoun County,2021-Jun,12176,11499,677,5.6
Calhoun County,2021-Jul,12214,11588,626,5.1
Calhoun County,2021-Aug,12176,11619,557,4.6
Calhoun County,2021-Sep,12091,11546,545,4.5
Calhoun County,2021-Oct,12132,11614,518,4.3
Calhoun County,2021-Nov,12243,11730,513,4.2
Calhoun County,2021-Dec,12121,11638,483,4
Calhoun County,2022-Jan,12145,11610,535,4.4
Calhoun County,2022-Feb,12321,11815,506,4.1
Calhoun County,2022-Mar,12551,12137,414,3.3
Calhoun County,2022-Apr,12496,12085,411,3.3
Calhoun County,2022-May,12117,11689,428,3.5
Calhoun County,2022-Jun,12078,11563,515,4.3
Calhoun County,2022-Jul,12212(P),11688(P),524(P),4.3(P)
Callahan County,2012-Jan,5935,5537,398,6.7
Callahan County,2012-Feb,5932,5557,375,6.3
Callahan County,2012-Mar,5923,5575,348,5.9
Callahan County,2012-Apr,5906,5576,330,5.6
Callahan County,2012-May,5879,5528,351,6
Callahan County,2012-Jun,5913,5514,399,6.7
Callahan County,2012-Jul,5934,5536,398,6.7
Callahan County,2012-Aug,5880,5513,367,6.2
Callahan County,2012-Sep,5926,5583,343,5.8
Callahan County,2012-Oct,5947,5612,335,5.6
Callahan County,2012-Nov,5944,5624,320,5.4
Callahan County,2012-Dec,5908,5581,327,5.5
Callahan County,2013-Jan,5886,5508,378,6.4
Callahan County,2013-Feb,5906,5541,365,6.2
Callahan County,2013-Mar,5853,5514,339,5.8
Callahan County,2013-Apr,5926,5609,317,5.3
Callahan County,2013-May,5928,5580,348,5.9
Callahan County,2013-Jun,5926,5543,383,6.5
Callahan County,2013-Jul,5922,5548,374,6.3
Callahan County,2013-Aug,5853,5511,342,5.8
Callahan County,2013-Sep,5910,5567,343,5.8
Callahan County,2013-Oct,5908,5588,320,5.4
Callahan County,2013-Nov,5951,5647,304,5.1
Callahan County,2013-Dec,5893,5614,279,4.7
Callahan County,2014-Jan,5797,5511,286,4.9
Callahan County,2014-Feb,5845,5555,290,5
Callahan County,2014-Mar,5841,5554,287,4.9
Callahan County,2014-Apr,5861,5619,242,4.1
Callahan County,2014-May,5861,5601,260,4.4
Callahan County,2014-Jun,5847,5565,282,4.8
Callahan County,2014-Jul,5836,5549,287,4.9
Callahan County,2014-Aug,5777,5503,274,4.7
Callahan County,2014-Sep,5815,5557,258,4.4
Callahan County,2014-Oct,5816,5580,236,4.1
Callahan County,2014-Nov,5820,5590,230,4
Callahan County,2014-Dec,5755,5542,213,3.7
Callahan County,2015-Jan,5713,5464,249,4.4
Callahan County,2015-Feb,5721,5474,247,4.3
Callahan County,2015-Mar,5721,5476,245,4.3
Callahan County,2015-Apr,5770,5549,221,3.8
Callahan County,2015-May,5788,5552,236,4.1
Callahan County,2015-Jun,5749,5501,248,4.3
Callahan County,2015-Jul,5735,5466,269,4.7
Callahan County,2015-Aug,5698,5444,254,4.5
Callahan County,2015-Sep,5712,5464,248,4.3
Callahan County,2015-Oct,5718,5476,242,4.2
Callahan County,2015-Nov,5750,5502,248,4.3
Callahan County,2015-Dec,5723,5476,247,4.3
Callahan County,2016-Jan,5776,5524,252,4.4
Callahan County,2016-Feb,5843,5589,254,4.3
Callahan County,2016-Mar,5844,5590,254,4.3
Callahan County,2016-Apr,5817,5588,229,3.9
Callahan County,2016-May,5792,5564,228,3.9
Callahan County,2016-Jun,5817,5555,262,4.5
Callahan County,2016-Jul,5815,5539,276,4.7
Callahan County,2016-Aug,5805,5542,263,4.5
Callahan County,2016-Sep,5800,5549,251,4.3
Callahan County,2016-Oct,5796,5554,242,4.2
Callahan County,2016-Nov,5799,5569,230,4
Callahan County,2016-Dec,5798,5562,236,4.1
Callahan County,2017-Jan,5800,5548,252,4.3
Callahan County,2017-Feb,5874,5629,245,4.2
Callahan County,2017-Mar,5887,5661,226,3.8
Callahan County,2017-Apr,5878,5680,198,3.4
Callahan County,2017-May,5873,5659,214,3.6
Callahan County,2017-Jun,5857,5638,219,3.7
Callahan County,2017-Jul,5825,5603,222,3.8
Callahan County,2017-Aug,5851,5631,220,3.8
Callahan County,2017-Sep,5894,5691,203,3.4
Callahan County,2017-Oct,5867,5681,186,3.2
Callahan County,2017-Nov,5895,5695,200,3.4
Callahan County,2017-Dec,5900,5709,191,3.2
Callahan County,2018-Jan,5840,5627,213,3.6
Callahan County,2018-Feb,5919,5704,215,3.6
Callahan County,2018-Mar,5951,5736,215,3.6
Callahan County,2018-Apr,5989,5792,197,3.3
Callahan County,2018-May,5963,5781,182,3.1
Callahan County,2018-Jun,5930,5722,208,3.5
Callahan County,2018-Jul,5925,5721,204,3.4
Callahan County,2018-Aug,5869,5667,202,3.4
Callahan County,2018-Sep,5906,5711,195,3.3
Callahan County,2018-Oct,5927,5737,190,3.2
Callahan County,2018-Nov,5944,5751,193,3.2
Callahan County,2018-Dec,5951,5755,196,3.3
Callahan County,2019-Jan,5894,5674,220,3.7
Callahan County,2019-Feb,5944,5748,196,3.3
Callahan County,2019-Mar,5960,5773,187,3.1
Callahan County,2019-Apr,5933,5783,150,2.5
Callahan County,2019-May,5933,5771,162,2.7
Callahan County,2019-Jun,5950,5749,201,3.4
Callahan County,2019-Jul,5994,5786,208,3.5
Callahan County,2019-Aug,6010,5807,203,3.4
Callahan County,2019-Sep,6045,5863,182,3
Callahan County,2019-Oct,6049,5880,169,2.8
Callahan County,2019-Nov,6074,5899,175,2.9
Callahan County,2019-Dec,6064,5893,171,2.8
Callahan County,2020-Jan,6064,5863,201,3.3
Callahan County,2020-Feb,6095,5916,179,2.9
Callahan County,2020-Mar,5976,5696,280,4.7
Callahan County,2020-Apr,5469,5066,403,7.4
Callahan County,2020-May,5709,5261,448,7.8
Callahan County,2020-Jun,5843,5400,443,7.6
Callahan County,2020-Jul,5922,5528,394,6.7
Callahan County,2020-Aug,5994,5674,320,5.3
Callahan County,2020-Sep,6014,5689,325,5.4
Callahan County,2020-Oct,6062,5774,288,4.8
Callahan County,2020-Nov,6077,5777,300,4.9
Callahan County,2020-Dec,6085,5785,300,4.9
Callahan County,2021-Jan,6082,5750,332,5.5
Callahan County,2021-Feb,6124,5779,345,5.6
Callahan County,2021-Mar,6129,5808,321,5.2
Callahan County,2021-Apr,6110,5831,279,4.6
Callahan County,2021-May,6096,5819,277,4.5
Callahan County,2021-Jun,6122,5804,318,5.2
Callahan County,2021-Jul,6135,5856,279,4.5
Callahan County,2021-Aug,6109,5840,269,4.4
Callahan County,2021-Sep,6171,5905,266,4.3
Callahan County,2021-Oct,6176,5915,261,4.2
Callahan County,2021-Nov,6186,5947,239,3.9
Callahan County,2021-Dec,6158,5941,217,3.5
Callahan County,2022-Jan,6129,5884,245,4
Callahan County,2022-Feb,6195,5950,245,4
Callahan County,2022-Mar,6222,6017,205,3.3
Callahan County,2022-Apr,6131,5946,185,3
Callahan County,2022-May,6128,5927,201,3.3
Callahan County,2022-Jun,6144,5916,228,3.7
Callahan County,2022-Jul,6194(P),5962(P),232(P),3.7(P)
Cameron County,2012-Jan,165908,147709,18199,11
Cameron County,2012-Feb,165991,148075,17916,10.8
Cameron County,2012-Mar,165797,149123,16674,10.1
Cameron County,2012-Apr,164978,149219,15759,9.6
Cameron County,2012-May,165003,148557,16446,10
Cameron County,2012-Jun,166793,148790,18003,10.8
Cameron County,2012-Jul,167364,149289,18075,10.8
Cameron County,2012-Aug,165802,148396,17406,10.5
Cameron County,2012-Sep,165375,148917,16458,10
Cameron County,2012-Oct,164870,148752,16118,9.8
Cameron County,2012-Nov,165783,149799,15984,9.6
Cameron County,2012-Dec,166652,149845,16807,10.1
Cameron County,2013-Jan,165876,147430,18446,11.1
Cameron County,2013-Feb,165502,147880,17622,10.6
Cameron County,2013-Mar,165416,148661,16755,10.1
Cameron County,2013-Apr,166793,150668,16125,9.7
Cameron County,2013-May,166985,150331,16654,10
Cameron County,2013-Jun,168604,150427,18177,10.8
Cameron County,2013-Jul,169196,151937,17259,10.2
Cameron County,2013-Aug,167204,150497,16707,10
Cameron County,2013-Sep,166928,150550,16378,9.8
Cameron County,2013-Oct,165504,149439,16065,9.7
Cameron County,2013-Nov,166895,151230,15665,9.4
Cameron County,2013-Dec,166816,151668,15148,9.1
Cameron County,2014-Jan,166956,150870,16086,9.6
Cameron County,2014-Feb,167686,151673,16013,9.5
Cameron County,2014-Mar,167761,152748,15013,8.9
Cameron County,2014-Apr,167208,153733,13475,8.1
Cameron County,2014-May,166913,153180,13733,8.2
Cameron County,2014-Jun,168043,153227,14816,8.8
Cameron County,2014-Jul,167580,152567,15013,9
Cameron County,2014-Aug,165730,151268,14462,8.7
Cameron County,2014-Sep,164700,151639,13061,7.9
Cameron County,2014-Oct,163681,151491,12190,7.4
Cameron County,2014-Nov,164580,152072,12508,7.6
Cameron County,2014-Dec,163616,151635,11981,7.3
Cameron County,2015-Jan,162797,149521,13276,8.2
Cameron County,2015-Feb,161834,149518,12316,7.6
Cameron County,2015-Mar,163142,151144,11998,7.4
Cameron County,2015-Apr,163428,152214,11214,6.9
Cameron County,2015-May,163789,152413,11376,6.9
Cameron County,2015-Jun,164184,151826,12358,7.5
Cameron County,2015-Jul,164424,152296,12128,7.4
Cameron County,2015-Aug,162767,151177,11590,7.1
Cameron County,2015-Sep,161876,150855,11021,6.8
Cameron County,2015-Oct,162356,151597,10759,6.6
Cameron County,2015-Nov,163853,152525,11328,6.9
Cameron County,2015-Dec,163831,152704,11127,6.8
Cameron County,2016-Jan,164268,152550,11718,7.1
Cameron County,2016-Feb,165172,153561,11611,7
Cameron County,2016-Mar,166355,154729,11626,7
Cameron County,2016-Apr,165801,154633,11168,6.7
Cameron County,2016-May,165618,154622,10996,6.6
Cameron County,2016-Jun,167636,154667,12969,7.7
Cameron County,2016-Jul,167759,154843,12916,7.7
Cameron County,2016-Aug,166727,154127,12600,7.6
Cameron County,2016-Sep,165524,153183,12341,7.5
Cameron County,2016-Oct,164947,153583,11364,6.9
Cameron County,2016-Nov,166411,154723,11688,7
Cameron County,2016-Dec,167116,154808,12308,7.4
Cameron County,2017-Jan,166042,152374,13668,8.2
Cameron County,2017-Feb,166173,152882,13291,8
Cameron County,2017-Mar,166594,154511,12083,7.3
Cameron County,2017-Apr,166524,155021,11503,6.9
Cameron County,2017-May,164896,153961,10935,6.6
Cameron County,2017-Jun,166512,153856,12656,7.6
Cameron County,2017-Jul,165515,153450,12065,7.3
Cameron County,2017-Aug,165151,153028,12123,7.3
Cameron County,2017-Sep,163609,152851,10758,6.6
Cameron County,2017-Oct,162391,152907,9484,5.8
Cameron County,2017-Nov,163370,153372,9998,6.1
Cameron County,2017-Dec,163833,153776,10057,6.1
Cameron County,2018-Jan,164995,153502,11493,7
Cameron County,2018-Feb,165314,154151,11163,6.8
Cameron County,2018-Mar,165412,154833,10579,6.4
Cameron County,2018-Apr,165334,155142,10192,6.2
Cameron County,2018-May,163730,154124,9606,5.9
Cameron County,2018-Jun,165806,154202,11604,7
Cameron County,2018-Jul,165631,154543,11088,6.7
Cameron County,2018-Aug,163294,153096,10198,6.2
Cameron County,2018-Sep,162203,152758,9445,5.8
Cameron County,2018-Oct,162614,153961,8653,5.3
Cameron County,2018-Nov,163568,154772,8796,5.4
Cameron County,2018-Dec,164371,154859,9512,5.8
Cameron County,2019-Jan,164494,153642,10852,6.6
Cameron County,2019-Feb,164443,154500,9943,6
Cameron County,2019-Mar,163936,155032,8904,5.4
Cameron County,2019-Apr,163088,155290,7798,4.8
Cameron County,2019-May,162847,154899,7948,4.9
Cameron County,2019-Jun,164944,155251,9693,5.9
Cameron County,2019-Jul,165588,155742,9846,5.9
Cameron County,2019-Aug,165285,155998,9287,5.6
Cameron County,2019-Sep,164590,155970,8620,5.2
Cameron County,2019-Oct,164367,156000,8367,5.1
Cameron County,2019-Nov,165684,156987,8697,5.2
Cameron County,2019-Dec,166646,157565,9081,5.4
Cameron County,2020-Jan,168577,158335,10242,6.1
Cameron County,2020-Feb,168201,158961,9240,5.5
Cameron County,2020-Mar,167923,154172,13751,8.2
Cameron County,2020-Apr,160247,135632,24615,15.4
Cameron County,2020-May,166445,142632,23813,14.3
Cameron County,2020-Jun,170081,148717,21364,12.6
Cameron County,2020-Jul,170108,148639,21469,12.6
Cameron County,2020-Aug,171398,153995,17403,10.2
Cameron County,2020-Sep,170071,153564,16507,9.7
Cameron County,2020-Oct,171102,156086,15016,8.8
Cameron County,2020-Nov,173171,157450,15721,9.1
Cameron County,2020-Dec,174411,158198,16213,9.3
Cameron County,2021-Jan,175229,157835,17394,9.9
Cameron County,2021-Feb,176128,159015,17113,9.7
Cameron County,2021-Mar,175211,159594,15617,8.9
Cameron County,2021-Apr,175700,160869,14831,8.4
Cameron County,2021-May,174723,160589,14134,8.1
Cameron County,2021-Jun,176446,160465,15981,9.1
Cameron County,2021-Jul,174948,160203,14745,8.4
Cameron County,2021-Aug,174932,161188,13744,7.9
Cameron County,2021-Sep,174751,162067,12684,7.3
Cameron County,2021-Oct,173622,161579,12043,6.9
Cameron County,2021-Nov,174021,162376,11645,6.7
Cameron County,2021-Dec,175175,163657,11518,6.6
Cameron County,2022-Jan,175953,162607,13346,7.6
Cameron County,2022-Feb,177711,164714,12997,7.3
Cameron County,2022-Mar,177539,166740,10799,6.1
Cameron County,2022-Apr,175745,165355,10390,5.9
Cameron County,2022-May,174917,164370,10547,6
Cameron County,2022-Jun,175459,163326,12133,6.9
Cameron County,2022-Jul,175609(P),163685(P),11924(P),6.8(P)
Camp County,2012-Jan,5478,5004,474,8.7
Camp County,2012-Feb,5507,5045,462,8.4
Camp County,2012-Mar,5503,5073,430,7.8
Camp County,2012-Apr,5519,5117,402,7.3
Camp County,2012-May,5557,5131,426,7.7
Camp County,2012-Jun,5587,5110,477,8.5
Camp County,2012-Jul,5530,5055,475,8.6
Camp County,2012-Aug,5418,4974,444,8.2
Camp County,2012-Sep,5435,5008,427,7.9
Camp County,2012-Oct,5448,5032,416,7.6
Camp County,2012-Nov,5447,5052,395,7.3
Camp County,2012-Dec,5460,5050,410,7.5
Camp County,2013-Jan,5531,5096,435,7.9
Camp County,2013-Feb,5508,5103,405,7.4
Camp County,2013-Mar,5488,5085,403,7.3
Camp County,2013-Apr,5478,5104,374,6.8
Camp County,2013-May,5512,5102,410,7.4
Camp County,2013-Jun,5590,5136,454,8.1
Camp County,2013-Jul,5558,5109,449,8.1
Camp County,2013-Aug,5507,5073,434,7.9
Camp County,2013-Sep,5554,5142,412,7.4
Camp County,2013-Oct,5452,5061,391,7.2
Camp County,2013-Nov,5450,5079,371,6.8
Camp County,2013-Dec,5443,5091,352,6.5
Camp County,2014-Jan,5314,4952,362,6.8
Camp County,2014-Feb,5282,4930,352,6.7
Camp County,2014-Mar,5237,4897,340,6.5
Camp County,2014-Apr,5180,4894,286,5.5
Camp County,2014-May,5196,4872,324,6.2
Camp County,2014-Jun,5210,4870,340,6.5
Camp County,2014-Jul,5230,4872,358,6.8
Camp County,2014-Aug,5231,4883,348,6.7
Camp County,2014-Sep,5243,4933,310,5.9
Camp County,2014-Oct,5162,4872,290,5.6
Camp County,2014-Nov,5150,4864,286,5.6
Camp County,2014-Dec,5107,4834,273,5.3
Camp County,2015-Jan,5097,4790,307,6
Camp County,2015-Feb,5168,4884,284,5.5
Camp County,2015-Mar,5178,4904,274,5.3
Camp County,2015-Apr,5072,4788,284,5.6
Camp County,2015-May,5095,4787,308,6
Camp County,2015-Jun,5097,4735,362,7.1
Camp County,2015-Jul,5069,4705,364,7.2
Camp County,2015-Aug,5058,4724,334,6.6
Camp County,2015-Sep,5051,4732,319,6.3
Camp County,2015-Oct,5102,4778,324,6.4
Camp County,2015-Nov,5094,4776,318,6.2
Camp County,2015-Dec,5065,4763,302,6
Camp County,2016-Jan,5023,4705,318,6.3
Camp County,2016-Feb,5112,4794,318,6.2
Camp County,2016-Mar,5137,4834,303,5.9
Camp County,2016-Apr,5087,4774,313,6.2
Camp County,2016-May,5091,4761,330,6.5
Camp County,2016-Jun,5131,4733,398,7.8
Camp County,2016-Jul,5049,4646,403,8
Camp County,2016-Aug,5073,4680,393,7.7
Camp County,2016-Sep,5063,4685,378,7.5
Camp County,2016-Oct,4990,4646,344,6.9
Camp County,2016-Nov,5011,4687,324,6.5
Camp County,2016-Dec,4999,4662,337,6.7
Camp County,2017-Jan,5002,4639,363,7.3
Camp County,2017-Feb,5039,4692,347,6.9
Camp County,2017-Mar,5093,4775,318,6.2
Camp County,2017-Apr,5028,4729,299,5.9
Camp County,2017-May,4999,4707,292,5.8
Camp County,2017-Jun,5023,4721,302,6
Camp County,2017-Jul,5007,4716,291,5.8
Camp County,2017-Aug,5010,4735,275,5.5
Camp County,2017-Sep,4993,4749,244,4.9
Camp County,2017-Oct,4892,4673,219,4.5
Camp County,2017-Nov,4887,4656,231,4.7
Camp County,2017-Dec,4914,4680,234,4.8
Camp County,2018-Jan,4963,4697,266,5.4
Camp County,2018-Feb,5012,4743,269,5.4
Camp County,2018-Mar,5037,4785,252,5
Camp County,2018-Apr,4988,4769,219,4.4
Camp County,2018-May,5011,4795,216,4.3
Camp County,2018-Jun,4966,4704,262,5.3
Camp County,2018-Jul,4953,4694,259,5.2
Camp County,2018-Aug,4895,4648,247,5
Camp County,2018-Sep,4915,4669,246,5
Camp County,2018-Oct,4906,4667,239,4.9
Camp County,2018-Nov,4904,4674,230,4.7
Camp County,2018-Dec,4874,4650,224,4.6
Camp County,2019-Jan,4848,4612,236,4.9
Camp County,2019-Feb,4872,4649,223,4.6
Camp County,2019-Mar,4881,4672,209,4.3
Camp County,2019-Apr,4873,4697,176,3.6
Camp County,2019-May,4891,4713,178,3.6
Camp County,2019-Jun,4948,4733,215,4.3
Camp County,2019-Jul,4956,4719,237,4.8
Camp County,2019-Aug,4960,4740,220,4.4
Camp County,2019-Sep,4962,4760,202,4.1
Camp County,2019-Oct,4963,4773,190,3.8
Camp County,2019-Nov,4881,4680,201,4.1
Camp County,2019-Dec,4895,4705,190,3.9
Camp County,2020-Jan,4867,4652,215,4.4
Camp County,2020-Feb,4921,4713,208,4.2
Camp County,2020-Mar,4874,4574,300,6.2
Camp County,2020-Apr,4659,4242,417,9
Camp County,2020-May,4826,4397,429,8.9
Camp County,2020-Jun,4974,4484,490,9.9
Camp County,2020-Jul,5006,4540,466,9.3
Camp County,2020-Aug,5055,4652,403,8
Camp County,2020-Sep,5046,4672,374,7.4
Camp County,2020-Oct,5083,4736,347,6.8
Camp County,2020-Nov,5045,4678,367,7.3
Camp County,2020-Dec,5068,4696,372,7.3
Camp County,2021-Jan,5122,4732,390,7.6
Camp County,2021-Feb,5121,4758,363,7.1
Camp County,2021-Mar,5208,4871,337,6.5
Camp County,2021-Apr,5064,4760,304,6
Camp County,2021-May,5033,4743,290,5.8
Camp County,2021-Jun,5063,4727,336,6.6
Camp County,2021-Jul,5072,4772,300,5.9
Camp County,2021-Aug,5114,4817,297,5.8
Camp County,2021-Sep,5191,4911,280,5.4
Camp County,2021-Oct,5164,4905,259,5
Camp County,2021-Nov,5117,4863,254,5
Camp County,2021-Dec,5122,4882,240,4.7
Camp County,2022-Jan,5151,4875,276,5.4
Camp County,2022-Feb,5212,4935,277,5.3
Camp County,2022-Mar,5288,5070,218,4.1
Camp County,2022-Apr,5160,4957,203,3.9
Camp County,2022-May,5159,4944,215,4.2
Camp County,2022-Jun,5183,4928,255,4.9
Camp County,2022-Jul,5245(P),5000(P),245(P),4.7(P)
Carson County,2012-Jan,3248,3093,155,4.8
Carson County,2012-Feb,3246,3090,156,4.8
Carson County,2012-Mar,3251,3110,141,4.3
Carson County,2012-Apr,3292,3158,134,4.1
Carson County,2012-May,3290,3146,144,4.4
Carson County,2012-Jun,3323,3161,162,4.9
Carson County,2012-Jul,3335,3165,170,5.1
Carson County,2012-Aug,3270,3112,158,4.8
Carson County,2012-Sep,3297,3155,142,4.3
Carson County,2012-Oct,3297,3160,137,4.2
Carson County,2012-Nov,3293,3155,138,4.2
Carson County,2012-Dec,3256,3114,142,4.4
Carson County,2013-Jan,3125,2974,151,4.8
Carson County,2013-Feb,3125,2981,144,4.6
Carson County,2013-Mar,3106,2964,142,4.6
Carson County,2013-Apr,3182,3048,134,4.2
Carson County,2013-May,3207,3063,144,4.5
Carson County,2013-Jun,3224,3065,159,4.9
Carson County,2013-Jul,3228,3073,155,4.8
Carson County,2013-Aug,3166,3021,145,4.6
Carson County,2013-Sep,3191,3048,143,4.5
Carson County,2013-Oct,3189,3053,136,4.3
Carson County,2013-Nov,3144,3017,127,4
Carson County,2013-Dec,3166,3042,124,3.9
Carson County,2014-Jan,3110,2986,124,4
Carson County,2014-Feb,3164,3040,124,3.9
Carson County,2014-Mar,3158,3041,117,3.7
Carson County,2014-Apr,3184,3085,99,3.1
Carson County,2014-May,3195,3090,105,3.3
Carson County,2014-Jun,3193,3075,118,3.7
Carson County,2014-Jul,3170,3054,116,3.7
Carson County,2014-Aug,3109,3004,105,3.4
Carson County,2014-Sep,3127,3027,100,3.2
Carson County,2014-Oct,3144,3047,97,3.1
Carson County,2014-Nov,3112,3019,93,3
Carson County,2014-Dec,3077,2993,84,2.7
Carson County,2015-Jan,3032,2930,102,3.4
Carson County,2015-Feb,3080,2984,96,3.1
Carson County,2015-Mar,3100,3008,92,3
Carson County,2015-Apr,3093,3003,90,2.9
Carson County,2015-May,3125,3024,101,3.2
Carson County,2015-Jun,3106,2996,110,3.5
Carson County,2015-Jul,3070,2960,110,3.6
Carson County,2015-Aug,3026,2924,102,3.4
Carson County,2015-Sep,3049,2949,100,3.3
Carson County,2015-Oct,3058,2963,95,3.1
Carson County,2015-Nov,3038,2940,98,3.2
Carson County,2015-Dec,3050,2959,91,3
Carson County,2016-Jan,3034,2931,103,3.4
Carson County,2016-Feb,3131,3030,101,3.2
Carson County,2016-Mar,3160,3055,105,3.3
Carson County,2016-Apr,3163,3067,96,3
Carson County,2016-May,3188,3090,98,3.1
Carson County,2016-Jun,3134,3024,110,3.5
Carson County,2016-Jul,3087,2967,120,3.9
Carson County,2016-Aug,3086,2982,104,3.4
Carson County,2016-Sep,3055,2957,98,3.2
Carson County,2016-Oct,3052,2957,95,3.1
Carson County,2016-Nov,3045,2956,89,2.9
Carson County,2016-Dec,3043,2948,95,3.1
Carson County,2017-Jan,2955,2850,105,3.6
Carson County,2017-Feb,3017,2903,114,3.8
Carson County,2017-Mar,3074,2965,109,3.5
Carson County,2017-Apr,3079,2978,101,3.3
Carson County,2017-May,3072,2965,107,3.5
Carson County,2017-Jun,3034,2927,107,3.5
Carson County,2017-Jul,2961,2861,100,3.4
Carson County,2017-Aug,2983,2884,99,3.3
Carson County,2017-Sep,2966,2880,86,2.9
Carson County,2017-Oct,2995,2916,79,2.6
Carson County,2017-Nov,2976,2890,86,2.9
Carson County,2017-Dec,2973,2892,81,2.7
Carson County,2018-Jan,2919,2827,92,3.2
Carson County,2018-Feb,2978,2883,95,3.2
Carson County,2018-Mar,3022,2934,88,2.9
Carson County,2018-Apr,2990,2907,83,2.8
Carson County,2018-May,3021,2943,78,2.6
Carson County,2018-Jun,2985,2890,95,3.2
Carson County,2018-Jul,2958,2870,88,3
Carson County,2018-Aug,2975,2889,86,2.9
Carson County,2018-Sep,2957,2876,81,2.7
Carson County,2018-Oct,2940,2865,75,2.6
Carson County,2018-Nov,2939,2865,74,2.5
Carson County,2018-Dec,2908,2835,73,2.5
Carson County,2019-Jan,2873,2784,89,3.1
Carson County,2019-Feb,2938,2845,93,3.2
Carson County,2019-Mar,2961,2878,83,2.8
Carson County,2019-Apr,2950,2880,70,2.4
Carson County,2019-May,2967,2900,67,2.3
Carson County,2019-Jun,2945,2865,80,2.7
Carson County,2019-Jul,2936,2855,81,2.8
Carson County,2019-Aug,2968,2896,72,2.4
Carson County,2019-Sep,2933,2865,68,2.3
Carson County,2019-Oct,2973,2903,70,2.4
Carson County,2019-Nov,2944,2871,73,2.5
Carson County,2019-Dec,2947,2882,65,2.2
Carson County,2020-Jan,2902,2818,84,2.9
Carson County,2020-Feb,2923,2843,80,2.7
Carson County,2020-Mar,2880,2764,116,4
Carson County,2020-Apr,2622,2467,155,5.9
Carson County,2020-May,2758,2606,152,5.5
Carson County,2020-Jun,2826,2662,164,5.8
Carson County,2020-Jul,2839,2700,139,4.9
Carson County,2020-Aug,2899,2787,112,3.9
Carson County,2020-Sep,2880,2770,110,3.8
Carson County,2020-Oct,2932,2828,104,3.5
Carson County,2020-Nov,2895,2784,111,3.8
Carson County,2020-Dec,2897,2780,117,4
Carson County,2021-Jan,2931,2800,131,4.5
Carson County,2021-Feb,2990,2850,140,4.7
Carson County,2021-Mar,3023,2897,126,4.2
Carson County,2021-Apr,2982,2876,106,3.6
Carson County,2021-May,2957,2847,110,3.7
Carson County,2021-Jun,2948,2821,127,4.3
Carson County,2021-Jul,2936,2817,119,4.1
Carson County,2021-Aug,2957,2843,114,3.9
Carson County,2021-Sep,2955,2844,111,3.8
Carson County,2021-Oct,2960,2856,104,3.5
Carson County,2021-Nov,2931,2836,95,3.2
Carson County,2021-Dec,2923,2836,87,3
Carson County,2022-Jan,2935,2831,104,3.5
Carson County,2022-Feb,3038,2930,108,3.6
Carson County,2022-Mar,3088,3004,84,2.7
Carson County,2022-Apr,3045,2969,76,2.5
Carson County,2022-May,2997,2917,80,2.7
Carson County,2022-Jun,2969,2880,89,3
Carson County,2022-Jul,3030(P),2941(P),89(P),2.9(P)
Cass County,2012-Jan,12894,11625,1269,9.8
Cass County,2012-Feb,12888,11640,1248,9.7
Cass County,2012-Mar,12824,11665,1159,9
Cass County,2012-Apr,12879,11794,1085,8.4
Cass County,2012-May,12885,11743,1142,8.9
Cass County,2012-Jun,12983,11745,1238,9.5
Cass County,2012-Jul,12849,11579,1270,9.9
Cass County,2012-Aug,12675,11475,1200,9.5
Cass County,2012-Sep,12730,11595,1135,8.9
Cass County,2012-Oct,12726,11638,1088,8.5
Cass County,2012-Nov,12629,11555,1074,8.5
Cass County,2012-Dec,12574,11465,1109,8.8
Cass County,2013-Jan,12654,11413,1241,9.8
Cass County,2013-Feb,12578,11382,1196,9.5
Cass County,2013-Mar,12585,11414,1171,9.3
Cass County,2013-Apr,12530,11415,1115,8.9
Cass County,2013-May,12652,11506,1146,9.1
Cass County,2013-Jun,12683,11439,1244,9.8
Cass County,2013-Jul,12557,11343,1214,9.7
Cass County,2013-Aug,12523,11334,1189,9.5
Cass County,2013-Sep,12524,11342,1182,9.4
Cass County,2013-Oct,12634,11487,1147,9.1
Cass County,2013-Nov,12511,11413,1098,8.8
Cass County,2013-Dec,12459,11413,1046,8.4
Cass County,2014-Jan,12418,11351,1067,8.6
Cass County,2014-Feb,12444,11383,1061,8.5
Cass County,2014-Mar,12405,11401,1004,8.1
Cass County,2014-Apr,12380,11505,875,7.1
Cass County,2014-May,12482,11509,973,7.8
Cass County,2014-Jun,12436,11429,1007,8.1
Cass County,2014-Jul,12222,11222,1000,8.2
Cass County,2014-Aug,12132,11144,988,8.1
Cass County,2014-Sep,12183,11263,920,7.6
Cass County,2014-Oct,12097,11258,839,6.9
Cass County,2014-Nov,12084,11220,864,7.1
Cass County,2014-Dec,11961,11166,795,6.6
Cass County,2015-Jan,12044,11160,884,7.3
Cass County,2015-Feb,11992,11174,818,6.8
Cass County,2015-Mar,12073,11277,796,6.6
Cass County,2015-Apr,12155,11344,811,6.7
Cass County,2015-May,12248,11419,829,6.8
Cass County,2015-Jun,12256,11373,883,7.2
Cass County,2015-Jul,12317,11387,930,7.6
Cass County,2015-Aug,12183,11334,849,7
Cass County,2015-Sep,12163,11328,835,6.9
Cass County,2015-Oct,12192,11396,796,6.5
Cass County,2015-Nov,12209,11412,797,6.5
Cass County,2015-Dec,12264,11502,762,6.2
Cass County,2016-Jan,12044,11263,781,6.5
Cass County,2016-Feb,12110,11337,773,6.4
Cass County,2016-Mar,12454,11662,792,6.4
Cass County,2016-Apr,12311,11437,874,7.1
Cass County,2016-May,12274,11408,866,7.1
Cass County,2016-Jun,12365,11383,982,7.9
Cass County,2016-Jul,12400,11380,1020,8.2
Cass County,2016-Aug,12399,11408,991,8
Cass County,2016-Sep,12301,11341,960,7.8
Cass County,2016-Oct,12232,11376,856,7
Cass County,2016-Nov,12196,11336,860,7.1
Cass County,2016-Dec,12225,11362,863,7.1
Cass County,2017-Jan,12201,11262,939,7.7
Cass County,2017-Feb,12245,11340,905,7.4
Cass County,2017-Mar,12400,11574,826,6.7
Cass County,2017-Apr,12301,11536,765,6.2
Cass County,2017-May,12137,11422,715,5.9
Cass County,2017-Jun,12169,11441,728,6
Cass County,2017-Jul,11968,11276,692,5.8
Cass County,2017-Aug,11981,11281,700,5.8
Cass County,2017-Sep,11976,11360,616,5.1
Cass County,2017-Oct,11935,11351,584,4.9
Cass County,2017-Nov,11966,11335,631,5.3
Cass County,2017-Dec,11975,11348,627,5.2
Cass County,2018-Jan,11944,11251,693,5.8
Cass County,2018-Feb,12061,11395,666,5.5
Cass County,2018-Mar,12229,11600,629,5.1
Cass County,2018-Apr,12143,11562,581,4.8
Cass County,2018-May,12276,11679,597,4.9
Cass County,2018-Jun,12373,11701,672,5.4
Cass County,2018-Jul,12213,11567,646,5.3
Cass County,2018-Aug,12242,11613,629,5.1
Cass County,2018-Sep,12213,11604,609,5
Cass County,2018-Oct,12223,11643,580,4.7
Cass County,2018-Nov,12135,11577,558,4.6
Cass County,2018-Dec,12103,11536,567,4.7
Cass County,2019-Jan,12138,11516,622,5.1
Cass County,2019-Feb,12154,11568,586,4.8
Cass County,2019-Mar,12441,11902,539,4.3
Cass County,2019-Apr,12231,11770,461,3.8
Cass County,2019-May,12201,11723,478,3.9
Cass County,2019-Jun,12257,11694,563,4.6
Cass County,2019-Jul,12281,11708,573,4.7
Cass County,2019-Aug,12334,11785,549,4.5
Cass County,2019-Sep,12254,11733,521,4.3
Cass County,2019-Oct,12261,11772,489,4
Cass County,2019-Nov,12102,11604,498,4.1
Cass County,2019-Dec,12100,11630,470,3.9
Cass County,2020-Jan,12016,11468,548,4.6
Cass County,2020-Feb,12066,11555,511,4.2
Cass County,2020-Mar,12030,11229,801,6.7
Cass County,2020-Apr,11564,10327,1237,10.7
Cass County,2020-May,11836,10688,1148,9.7
Cass County,2020-Jun,12068,10836,1232,10.2
Cass County,2020-Jul,12173,11032,1141,9.4
Cass County,2020-Aug,12388,11384,1004,8.1
Cass County,2020-Sep,12301,11321,980,8
Cass County,2020-Oct,12418,11493,925,7.4
Cass County,2020-Nov,12368,11378,990,8
Cass County,2020-Dec,12353,11349,1004,8.1
Cass County,2021-Jan,12469,11450,1019,8.2
Cass County,2021-Feb,12535,11544,991,7.9
Cass County,2021-Mar,12564,11618,946,7.5
Cass County,2021-Apr,12494,11636,858,6.9
Cass County,2021-May,12372,11544,828,6.7
Cass County,2021-Jun,12428,11483,945,7.6
Cass County,2021-Jul,12328,11481,847,6.9
Cass County,2021-Aug,12286,11491,795,6.5
Cass County,2021-Sep,12351,11621,730,5.9
Cass County,2021-Oct,12350,11648,702,5.7
Cass County,2021-Nov,12256,11577,679,5.5
Cass County,2021-Dec,12199,11580,619,5.1
Cass County,2022-Jan,12311,11579,732,5.9
Cass County,2022-Feb,12422,11711,711,5.7
Cass County,2022-Mar,12489,11913,576,4.6
Cass County,2022-Apr,12255,11714,541,4.4
Cass County,2022-May,12217,11653,564,4.6
Cass County,2022-Jun,12235,11585,650,5.3
Cass County,2022-Jul,12270(P),11614(P),656(P),5.3(P)
Castro County,2012-Jan,3983,3789,194,4.9
Castro County,2012-Feb,3914,3727,187,4.8
Castro County,2012-Mar,3956,3783,173,4.4
Castro County,2012-Apr,4040,3873,167,4.1
Castro County,2012-May,4056,3880,176,4.3
Castro County,2012-Jun,4192,3991,201,4.8
Castro County,2012-Jul,4123,3920,203,4.9
Castro County,2012-Aug,4075,3889,186,4.6
Castro County,2012-Sep,4120,3953,167,4.1
Castro County,2012-Oct,4107,3949,158,3.8
Castro County,2012-Nov,4052,3902,150,3.7
Castro County,2012-Dec,3987,3833,154,3.9
Castro County,2013-Jan,3684,3503,181,4.9
Castro County,2013-Feb,3699,3522,177,4.8
Castro County,2013-Mar,3652,3487,165,4.5
Castro County,2013-Apr,3766,3602,164,4.4
Castro County,2013-May,3843,3659,184,4.8
Castro County,2013-Jun,3961,3758,203,5.1
Castro County,2013-Jul,3893,3697,196,5
Castro County,2013-Aug,3739,3551,188,5
Castro County,2013-Sep,3833,3650,183,4.8
Castro County,2013-Oct,3830,3653,177,4.6
Castro County,2013-Nov,3675,3507,168,4.6
Castro County,2013-Dec,3743,3584,159,4.2
Castro County,2014-Jan,3689,3536,153,4.1
Castro County,2014-Feb,3795,3634,161,4.2
Castro County,2014-Mar,3818,3662,156,4.1
Castro County,2014-Apr,3852,3704,148,3.8
Castro County,2014-May,3902,3745,157,4
Castro County,2014-Jun,3919,3750,169,4.3
Castro County,2014-Jul,3857,3678,179,4.6
Castro County,2014-Aug,3737,3571,166,4.4
Castro County,2014-Sep,3813,3660,153,4
Castro County,2014-Oct,3800,3662,138,3.6
Castro County,2014-Nov,3683,3544,139,3.8
Castro County,2014-Dec,3622,3501,121,3.3
Castro County,2015-Jan,3527,3387,140,4
Castro County,2015-Feb,3647,3509,138,3.8
Castro County,2015-Mar,3735,3604,131,3.5
Castro County,2015-Apr,3704,3587,117,3.2
Castro County,2015-May,3788,3662,126,3.3
Castro County,2015-Jun,3781,3644,137,3.6
Castro County,2015-Jul,3631,3497,134,3.7
Castro County,2015-Aug,3541,3423,118,3.3
Castro County,2015-Sep,3577,3458,119,3.3
Castro County,2015-Oct,3574,3459,115,3.2
Castro County,2015-Nov,3448,3339,109,3.2
Castro County,2015-Dec,3455,3356,99,2.9
Castro County,2016-Jan,3321,3215,106,3.2
Castro County,2016-Feb,3536,3429,107,3
Castro County,2016-Mar,3596,3494,102,2.8
Castro County,2016-Apr,3628,3540,88,2.4
Castro County,2016-May,3707,3611,96,2.6
Castro County,2016-Jun,3632,3512,120,3.3
Castro County,2016-Jul,3431,3311,120,3.5
Castro County,2016-Aug,3497,3381,116,3.3
Castro County,2016-Sep,3498,3390,108,3.1
Castro County,2016-Oct,3421,3312,109,3.2
Castro County,2016-Nov,3352,3245,107,3.2
Castro County,2016-Dec,3336,3222,114,3.4
Castro County,2017-Jan,3273,3144,129,3.9
Castro County,2017-Feb,3337,3206,131,3.9
Castro County,2017-Mar,3533,3412,121,3.4
Castro County,2017-Apr,3491,3386,105,3
Castro County,2017-May,3509,3398,111,3.2
Castro County,2017-Jun,3438,3313,125,3.6
Castro County,2017-Jul,3212,3091,121,3.8
Castro County,2017-Aug,3312,3197,115,3.5
Castro County,2017-Sep,3285,3181,104,3.2
Castro County,2017-Oct,3419,3324,95,2.8
Castro County,2017-Nov,3304,3209,95,2.9
Castro County,2017-Dec,3309,3214,95,2.9
Castro County,2018-Jan,3297,3200,97,2.9
Castro County,2018-Feb,3429,3322,107,3.1
Castro County,2018-Mar,3578,3475,103,2.9
Castro County,2018-Apr,3526,3433,93,2.6
Castro County,2018-May,3619,3529,90,2.5
Castro County,2018-Jun,3594,3484,110,3.1
Castro County,2018-Jul,3363,3255,108,3.2
Castro County,2018-Aug,3400,3298,102,3
Castro County,2018-Sep,3404,3310,94,2.8
Castro County,2018-Oct,3371,3277,94,2.8
Castro County,2018-Nov,3335,3243,92,2.8
Castro County,2018-Dec,3246,3149,97,3
Castro County,2019-Jan,3203,3094,109,3.4
Castro County,2019-Feb,3338,3233,105,3.1
Castro County,2019-Mar,3469,3369,100,2.9
Castro County,2019-Apr,3376,3286,90,2.7
Castro County,2019-May,3422,3335,87,2.5
Castro County,2019-Jun,3416,3309,107,3.1
Castro County,2019-Jul,3308,3205,103,3.1
Castro County,2019-Aug,3437,3342,95,2.8
Castro County,2019-Sep,3370,3284,86,2.6
Castro County,2019-Oct,3492,3410,82,2.3
Castro County,2019-Nov,3317,3237,80,2.4
Castro County,2019-Dec,3381,3310,71,2.1
Castro County,2020-Jan,3239,3151,88,2.7
Castro County,2020-Feb,3293,3207,86,2.6
Castro County,2020-Mar,3300,3171,129,3.9
Castro County,2020-Apr,3149,3036,113,3.6
Castro County,2020-May,3186,3045,141,4.4
Castro County,2020-Jun,3218,3069,149,4.6
Castro County,2020-Jul,3200,3065,135,4.2
Castro County,2020-Aug,3293,3177,116,3.5
Castro County,2020-Sep,3277,3162,115,3.5
Castro County,2020-Oct,3356,3250,106,3.2
Castro County,2020-Nov,3231,3113,118,3.7
Castro County,2020-Dec,3248,3126,122,3.8
Castro County,2021-Jan,3413,3276,137,4
Castro County,2021-Feb,3502,3363,139,4
Castro County,2021-Mar,3612,3482,130,3.6
Castro County,2021-Apr,3540,3427,113,3.2
Castro County,2021-May,3416,3300,116,3.4
Castro County,2021-Jun,3364,3225,139,4.1
Castro County,2021-Jul,3306,3182,124,3.8
Castro County,2021-Aug,3351,3233,118,3.5
Castro County,2021-Sep,3346,3238,108,3.2
Castro County,2021-Oct,3315,3211,104,3.1
Castro County,2021-Nov,3196,3100,96,3
Castro County,2021-Dec,3197,3114,83,2.6
Castro County,2022-Jan,3250,3146,104,3.2
Castro County,2022-Feb,3472,3364,108,3.1
Castro County,2022-Mar,3635,3544,91,2.5
Castro County,2022-Apr,3583,3496,87,2.4
Castro County,2022-May,3446,3352,94,2.7
Castro County,2022-Jun,3391,3281,110,3.2
Castro County,2022-Jul,3491(P),3388(P),103(P),3.0(P)
Chambers County,2012-Jan,16852,15367,1485,8.8
Chambers County,2012-Feb,16907,15517,1390,8.2
Chambers County,2012-Mar,16901,15605,1296,7.7
Chambers County,2012-Apr,16943,15665,1278,7.5
Chambers County,2012-May,17098,15716,1382,8.1
Chambers County,2012-Jun,17232,15695,1537,8.9
Chambers County,2012-Jul,17300,15765,1535,8.9
Chambers County,2012-Aug,17182,15734,1448,8.4
Chambers County,2012-Sep,17169,15875,1294,7.5
Chambers County,2012-Oct,17222,15965,1257,7.3
Chambers County,2012-Nov,17224,15979,1245,7.2
Chambers County,2012-Dec,17289,15993,1296,7.5
Chambers County,2013-Jan,17316,15874,1442,8.3
Chambers County,2013-Feb,17336,16020,1316,7.6
Chambers County,2013-Mar,17340,16067,1273,7.3
Chambers County,2013-Apr,17378,16144,1234,7.1
Chambers County,2013-May,17415,16160,1255,7.2
Chambers County,2013-Jun,17518,16126,1392,7.9
Chambers County,2013-Jul,17564,16206,1358,7.7
Chambers County,2013-Aug,17498,16172,1326,7.6
Chambers County,2013-Sep,17521,16228,1293,7.4
Chambers County,2013-Oct,17455,16202,1253,7.2
Chambers County,2013-Nov,17558,16351,1207,6.9
Chambers County,2013-Dec,17517,16386,1131,6.5
Chambers County,2014-Jan,17653,16475,1178,6.7
Chambers County,2014-Feb,17723,16585,1138,6.4
Chambers County,2014-Mar,17769,16681,1088,6.1
Chambers County,2014-Apr,17704,16746,958,5.4
Chambers County,2014-May,17764,16748,1016,5.7
Chambers County,2014-Jun,17861,16731,1130,6.3
Chambers County,2014-Jul,17975,16811,1164,6.5
Chambers County,2014-Aug,17883,16772,1111,6.2
Chambers County,2014-Sep,17852,16848,1004,5.6
Chambers County,2014-Oct,17870,16954,916,5.1
Chambers County,2014-Nov,17902,16987,915,5.1
Chambers County,2014-Dec,17873,17004,869,4.9
Chambers County,2015-Jan,17802,16815,987,5.5
Chambers County,2015-Feb,17813,16880,933,5.2
Chambers County,2015-Mar,17752,16848,904,5.1
Chambers County,2015-Apr,17771,16915,856,4.8
Chambers County,2015-May,17776,16877,899,5.1
Chambers County,2015-Jun,17810,16818,992,5.6
Chambers County,2015-Jul,17886,16843,1043,5.8
Chambers County,2015-Aug,17841,16819,1022,5.7
Chambers County,2015-Sep,17773,16789,984,5.5
Chambers County,2015-Oct,17786,16852,934,5.3
Chambers County,2015-Nov,17875,16901,974,5.4
Chambers County,2015-Dec,17892,16936,956,5.3
Chambers County,2016-Jan,18083,17059,1024,5.7
Chambers County,2016-Feb,18172,17175,997,5.5
Chambers County,2016-Mar,18152,17147,1005,5.5
Chambers County,2016-Apr,18096,17150,946,5.2
Chambers County,2016-May,18075,17097,978,5.4
Chambers County,2016-Jun,18241,17055,1186,6.5
Chambers County,2016-Jul,18351,17122,1229,6.7
Chambers County,2016-Aug,18270,17048,1222,6.7
Chambers County,2016-Sep,18285,17087,1198,6.6
Chambers County,2016-Oct,18223,17111,1112,6.1
Chambers County,2016-Nov,18303,17157,1146,6.3
Chambers County,2016-Dec,18392,17109,1283,7
Chambers County,2017-Jan,18692,17270,1422,7.6
Chambers County,2017-Feb,18793,17413,1380,7.3
Chambers County,2017-Mar,18764,17494,1270,6.8
Chambers County,2017-Apr,18781,17587,1194,6.4
Chambers County,2017-May,18682,17530,1152,6.2
Chambers County,2017-Jun,18798,17539,1259,6.7
Chambers County,2017-Jul,18847,17607,1240,6.6
Chambers County,2017-Aug,18816,17540,1276,6.8
Chambers County,2017-Sep,18867,17627,1240,6.6
Chambers County,2017-Oct,18701,17631,1070,5.7
Chambers County,2017-Nov,18829,17712,1117,5.9
Chambers County,2017-Dec,18845,17697,1148,6.1
Chambers County,2018-Jan,18990,17730,1260,6.6
Chambers County,2018-Feb,19197,17991,1206,6.3
Chambers County,2018-Mar,19054,17971,1083,5.7
Chambers County,2018-Apr,19052,18040,1012,5.3
Chambers County,2018-May,18989,18017,972,5.1
Chambers County,2018-Jun,19158,18039,1119,5.8
Chambers County,2018-Jul,19189,18107,1082,5.6
Chambers County,2018-Aug,19011,17974,1037,5.5
Chambers County,2018-Sep,19044,18055,989,5.2
Chambers County,2018-Oct,19058,18198,860,4.5
Chambers County,2018-Nov,19119,18249,870,4.6
Chambers County,2018-Dec,19197,18254,943,4.9
Chambers County,2019-Jan,19591,18525,1066,5.4
Chambers County,2019-Feb,19683,18728,955,4.9
Chambers County,2019-Mar,19539,18693,846,4.3
Chambers County,2019-Apr,19473,18726,747,3.8
Chambers County,2019-May,19501,18716,785,4
Chambers County,2019-Jun,19723,18752,971,4.9
Chambers County,2019-Jul,19798,18796,1002,5.1
Chambers County,2019-Aug,19685,18736,949,4.8
Chambers County,2019-Sep,19704,18872,832,4.2
Chambers County,2019-Oct,19747,18940,807,4.1
Chambers County,2019-Nov,19828,18992,836,4.2
Chambers County,2019-Dec,19824,18961,863,4.4
Chambers County,2020-Jan,20383,19403,980,4.8
Chambers County,2020-Feb,20506,19619,887,4.3
Chambers County,2020-Mar,20259,18885,1374,6.8
Chambers County,2020-Apr,19175,16640,2535,13.2
Chambers County,2020-May,19841,17259,2582,13
Chambers County,2020-Jun,20165,17731,2434,12.1
Chambers County,2020-Jul,20201,17825,2376,11.8
Chambers County,2020-Aug,20180,18177,2003,9.9
Chambers County,2020-Sep,20282,18299,1983,9.8
Chambers County,2020-Oct,20326,18608,1718,8.5
Chambers County,2020-Nov,20555,18697,1858,9
Chambers County,2020-Dec,20612,18651,1961,9.5
Chambers County,2021-Jan,20552,18493,2059,10
Chambers County,2021-Feb,20628,18671,1957,9.5
Chambers County,2021-Mar,20527,18698,1829,8.9
Chambers County,2021-Apr,20564,18802,1762,8.6
Chambers County,2021-May,20544,18826,1718,8.4
Chambers County,2021-Jun,20780,18827,1953,9.4
Chambers County,2021-Jul,20776,18986,1790,8.6
Chambers County,2021-Aug,20709,19004,1705,8.2
Chambers County,2021-Sep,20690,19132,1558,7.5
Chambers County,2021-Oct,20702,19244,1458,7
Chambers County,2021-Nov,20823,19422,1401,6.7
Chambers County,2021-Dec,20882,19500,1382,6.6
Chambers County,2022-Jan,20940,19373,1567,7.5
Chambers County,2022-Feb,21039,19561,1478,7
Chambers County,2022-Mar,20882,19660,1222,5.9
Chambers County,2022-Apr,20840,19675,1165,5.6
Chambers County,2022-May,20930,19770,1160,5.5
Chambers County,2022-Jun,21207,19849,1358,6.4
Chambers County,2022-Jul,21217(P),19855(P),1362(P),6.4(P)
Cherokee County,2012-Jan,22058,20382,1676,7.6
Cherokee County,2012-Feb,21934,20313,1621,7.4
Cherokee County,2012-Mar,21899,20394,1505,6.9
Cherokee County,2012-Apr,21874,20449,1425,6.5
Cherokee County,2012-May,21935,20397,1538,7
Cherokee County,2012-Jun,22274,20529,1745,7.8
Cherokee County,2012-Jul,22078,20340,1738,7.9
Cherokee County,2012-Aug,21795,20138,1657,7.6
Cherokee County,2012-Sep,21863,20341,1522,7
Cherokee County,2012-Oct,21826,20327,1499,6.9
Cherokee County,2012-Nov,21809,20323,1486,6.8
Cherokee County,2012-Dec,21751,20233,1518,7
Cherokee County,2013-Jan,21555,19893,1662,7.7
Cherokee County,2013-Feb,21484,19927,1557,7.2
Cherokee County,2013-Mar,21470,19997,1473,6.9
Cherokee County,2013-Apr,21623,20232,1391,6.4
Cherokee County,2013-May,21688,20235,1453,6.7
Cherokee County,2013-Jun,21826,20205,1621,7.4
Cherokee County,2013-Jul,21603,20012,1591,7.4
Cherokee County,2013-Aug,21328,19770,1558,7.3
Cherokee County,2013-Sep,21502,19978,1524,7.1
Cherokee County,2013-Oct,21372,19919,1453,6.8
Cherokee County,2013-Nov,21258,19853,1405,6.6
Cherokee County,2013-Dec,21205,19866,1339,6.3
Cherokee County,2014-Jan,21266,19880,1386,6.5
Cherokee County,2014-Feb,21300,19930,1370,6.4
Cherokee County,2014-Mar,21291,19989,1302,6.1
Cherokee County,2014-Apr,21257,20090,1167,5.5
Cherokee County,2014-May,21272,20055,1217,5.7
Cherokee County,2014-Jun,21394,20083,1311,6.1
Cherokee County,2014-Jul,21239,19884,1355,6.4
Cherokee County,2014-Aug,21079,19787,1292,6.1
Cherokee County,2014-Sep,21073,19843,1230,5.8
Cherokee County,2014-Oct,21040,19905,1135,5.4
Cherokee County,2014-Nov,20923,19781,1142,5.5
Cherokee County,2014-Dec,20710,19696,1014,4.9
Cherokee County,2015-Jan,20733,19585,1148,5.5
Cherokee County,2015-Feb,20850,19740,1110,5.3
Cherokee County,2015-Mar,20885,19820,1065,5.1
Cherokee County,2015-Apr,20998,19960,1038,4.9
Cherokee County,2015-May,21035,19928,1107,5.3
Cherokee County,2015-Jun,21038,19855,1183,5.6
Cherokee County,2015-Jul,20923,19765,1158,5.5
Cherokee County,2015-Aug,20873,19798,1075,5.2
Cherokee County,2015-Sep,20866,19789,1077,5.2
Cherokee County,2015-Oct,20829,19796,1033,5
Cherokee County,2015-Nov,20898,19857,1041,5
Cherokee County,2015-Dec,20965,19948,1017,4.9
Cherokee County,2016-Jan,20832,19747,1085,5.2
Cherokee County,2016-Feb,21236,20184,1052,5
Cherokee County,2016-Mar,21326,20252,1074,5
Cherokee County,2016-Apr,21451,20424,1027,4.8
Cherokee County,2016-May,21467,20465,1002,4.7
Cherokee County,2016-Jun,21420,20288,1132,5.3
Cherokee County,2016-Jul,21315,20130,1185,5.6
Cherokee County,2016-Aug,21266,20130,1136,5.3
Cherokee County,2016-Sep,21135,20015,1120,5.3
Cherokee County,2016-Oct,20998,19953,1045,5
Cherokee County,2016-Nov,21047,20019,1028,4.9
Cherokee County,2016-Dec,21001,19931,1070,5.1
Cherokee County,2017-Jan,20826,19675,1151,5.5
Cherokee County,2017-Feb,20940,19828,1112,5.3
Cherokee County,2017-Mar,21103,20105,998,4.7
Cherokee County,2017-Apr,20718,19818,900,4.3
Cherokee County,2017-May,20632,19740,892,4.3
Cherokee County,2017-Jun,20546,19569,977,4.8
Cherokee County,2017-Jul,20348,19384,964,4.7
Cherokee County,2017-Aug,20516,19546,970,4.7
Cherokee County,2017-Sep,20296,19428,868,4.3
Cherokee County,2017-Oct,20443,19641,802,3.9
Cherokee County,2017-Nov,20529,19676,853,4.2
Cherokee County,2017-Dec,20615,19772,843,4.1
Cherokee County,2018-Jan,20556,19599,957,4.7
Cherokee County,2018-Feb,20765,19819,946,4.6
Cherokee County,2018-Mar,20884,20002,882,4.2
Cherokee County,2018-Apr,20753,19945,808,3.9
Cherokee County,2018-May,20780,19973,807,3.9
Cherokee County,2018-Jun,20782,19851,931,4.5
Cherokee County,2018-Jul,20626,19721,905,4.4
Cherokee County,2018-Aug,20625,19761,864,4.2
Cherokee County,2018-Sep,20548,19726,822,4
Cherokee County,2018-Oct,20532,19751,781,3.8
Cherokee County,2018-Nov,20763,19985,778,3.7
Cherokee County,2018-Dec,20770,19939,831,4
Cherokee County,2019-Jan,20610,19687,923,4.5
Cherokee County,2019-Feb,20776,19946,830,4
Cherokee County,2019-Mar,20822,20022,800,3.8
Cherokee County,2019-Apr,20694,20019,675,3.3
Cherokee County,2019-May,20639,19972,667,3.2
Cherokee County,2019-Jun,20652,19837,815,3.9
Cherokee County,2019-Jul,20747,19919,828,4
Cherokee County,2019-Aug,20794,19964,830,4
Cherokee County,2019-Sep,20599,19832,767,3.7
Cherokee County,2019-Oct,20894,20134,760,3.6
Cherokee County,2019-Nov,20911,20127,784,3.7
Cherokee County,2019-Dec,20985,20245,740,3.5
Cherokee County,2020-Jan,20807,19947,860,4.1
Cherokee County,2020-Feb,20945,20137,808,3.9
Cherokee County,2020-Mar,20753,19553,1200,5.8
Cherokee County,2020-Apr,20256,18010,2246,11.1
Cherokee County,2020-May,21004,18696,2308,11
Cherokee County,2020-Jun,21208,19018,2190,10.3
Cherokee County,2020-Jul,21072,19054,2018,9.6
Cherokee County,2020-Aug,21244,19471,1773,8.3
Cherokee County,2020-Sep,21348,19554,1794,8.4
Cherokee County,2020-Oct,21158,19571,1587,7.5
Cherokee County,2020-Nov,21006,19380,1626,7.7
Cherokee County,2020-Dec,20960,19398,1562,7.5
Cherokee County,2021-Jan,20880,19232,1648,7.9
Cherokee County,2021-Feb,21037,19384,1653,7.9
Cherokee County,2021-Mar,21221,19732,1489,7
Cherokee County,2021-Apr,21174,19812,1362,6.4
Cherokee County,2021-May,20900,19590,1310,6.3
Cherokee County,2021-Jun,20890,19414,1476,7.1
Cherokee County,2021-Jul,20756,19408,1348,6.5
Cherokee County,2021-Aug,20798,19529,1269,6.1
Cherokee County,2021-Sep,20806,19613,1193,5.7
Cherokee County,2021-Oct,20662,19519,1143,5.5
Cherokee County,2021-Nov,20628,19516,1112,5.4
Cherokee County,2021-Dec,20616,19578,1038,5
Cherokee County,2022-Jan,20542,19343,1199,5.8
Cherokee County,2022-Feb,20827,19671,1156,5.6
Cherokee County,2022-Mar,21076,20145,931,4.4
Cherokee County,2022-Apr,20646,19795,851,4.1
Cherokee County,2022-May,20544,19655,889,4.3
Cherokee County,2022-Jun,20503,19476,1027,5
Cherokee County,2022-Jul,20579(P),19590(P),989(P),4.8(P)
Childress County,2012-Jan,2993,2850,143,4.8
Childress County,2012-Feb,2967,2832,135,4.6
Childress County,2012-Mar,2985,2857,128,4.3
Childress County,2012-Apr,3013,2887,126,4.2
Childress County,2012-May,2995,2861,134,4.5
Childress County,2012-Jun,3020,2878,142,4.7
Childress County,2012-Jul,2969,2828,141,4.7
Childress County,2012-Aug,2949,2817,132,4.5
Childress County,2012-Sep,2909,2788,121,4.2
Childress County,2012-Oct,2932,2812,120,4.1
Childress County,2012-Nov,2917,2799,118,4
Childress County,2012-Dec,2892,2776,116,4
Childress County,2013-Jan,2904,2766,138,4.8
Childress County,2013-Feb,2885,2756,129,4.5
Childress County,2013-Mar,2866,2738,128,4.5
Childress County,2013-Apr,2939,2816,123,4.2
Childress County,2013-May,2955,2823,132,4.5
Childress County,2013-Jun,3005,2863,142,4.7
Childress County,2013-Jul,3007,2871,136,4.5
Childress County,2013-Aug,2971,2843,128,4.3
Childress County,2013-Sep,2949,2824,125,4.2
Childress County,2013-Oct,2893,2779,114,3.9
Childress County,2013-Nov,2880,2771,109,3.8
Childress County,2013-Dec,2905,2796,109,3.8
Childress County,2014-Jan,2834,2727,107,3.8
Childress County,2014-Feb,2844,2734,110,3.9
Childress County,2014-Mar,2859,2755,104,3.6
Childress County,2014-Apr,2888,2795,93,3.2
Childress County,2014-May,2882,2774,108,3.7
Childress County,2014-Jun,2929,2812,117,4
Childress County,2014-Jul,2933,2813,120,4.1
Childress County,2014-Aug,2881,2768,113,3.9
Childress County,2014-Sep,2853,2746,107,3.8
Childress County,2014-Oct,2825,2723,102,3.6
Childress County,2014-Nov,2785,2684,101,3.6
Childress County,2014-Dec,2790,2705,85,3
Childress County,2015-Jan,2792,2697,95,3.4
Childress County,2015-Feb,2804,2709,95,3.4
Childress County,2015-Mar,2850,2759,91,3.2
Childress County,2015-Apr,2877,2800,77,2.7
Childress County,2015-May,2920,2829,91,3.1
Childress County,2015-Jun,2923,2826,97,3.3
Childress County,2015-Jul,2948,2848,100,3.4
Childress County,2015-Aug,2903,2813,90,3.1
Childress County,2015-Sep,2890,2799,91,3.1
Childress County,2015-Oct,2865,2775,90,3.1
Childress County,2015-Nov,2835,2746,89,3.1
Childress County,2015-Dec,2831,2758,73,2.6
Childress County,2016-Jan,2841,2761,80,2.8
Childress County,2016-Feb,2888,2803,85,2.9
Childress County,2016-Mar,2912,2822,90,3.1
Childress County,2016-Apr,2969,2889,80,2.7
Childress County,2016-May,3008,2917,91,3
Childress County,2016-Jun,3070,2976,94,3.1
Childress County,2016-Jul,3045,2950,95,3.1
Childress County,2016-Aug,3037,2940,97,3.2
Childress County,2016-Sep,2989,2890,99,3.3
Childress County,2016-Oct,2935,2848,87,3
Childress County,2016-Nov,2921,2835,86,2.9
Childress County,2016-Dec,2916,2837,79,2.7
Childress County,2017-Jan,2851,2765,86,3
Childress County,2017-Feb,2864,2769,95,3.3
Childress County,2017-Mar,2896,2810,86,3
Childress County,2017-Apr,2930,2855,75,2.6
Childress County,2017-May,2922,2837,85,2.9
Childress County,2017-Jun,2932,2841,91,3.1
Childress County,2017-Jul,2955,2867,88,3
Childress County,2017-Aug,2950,2864,86,2.9
Childress County,2017-Sep,2877,2792,85,3
Childress County,2017-Oct,2853,2769,84,2.9
Childress County,2017-Nov,2817,2725,92,3.3
Childress County,2017-Dec,2802,2725,77,2.7
Childress County,2018-Jan,2865,2779,86,3
Childress County,2018-Feb,2871,2783,88,3.1
Childress County,2018-Mar,2915,2830,85,2.9
Childress County,2018-Apr,2928,2856,72,2.5
Childress County,2018-May,2985,2913,72,2.4
Childress County,2018-Jun,2989,2906,83,2.8
Childress County,2018-Jul,2999,2918,81,2.7
Childress County,2018-Aug,2990,2909,81,2.7
Childress County,2018-Sep,2951,2874,77,2.6
Childress County,2018-Oct,2882,2810,72,2.5
Childress County,2018-Nov,2862,2795,67,2.3
Childress County,2018-Dec,2833,2766,67,2.4
Childress County,2019-Jan,2858,2775,83,2.9
Childress County,2019-Feb,2864,2790,74,2.6
Childress County,2019-Mar,2891,2813,78,2.7
Childress County,2019-Apr,2901,2838,63,2.2
Childress County,2019-May,2937,2870,67,2.3
Childress County,2019-Jun,2948,2865,83,2.8
Childress County,2019-Jul,2984,2899,85,2.8
Childress County,2019-Aug,3001,2920,81,2.7
Childress County,2019-Sep,2917,2838,79,2.7
Childress County,2019-Oct,2942,2854,88,3
Childress County,2019-Nov,2927,2837,90,3.1
Childress County,2019-Dec,2907,2826,81,2.8
Childress County,2020-Jan,2815,2726,89,3.2
Childress County,2020-Feb,3001,2920,81,2.7
Childress County,2020-Mar,3024,2905,119,3.9
Childress County,2020-Apr,2897,2775,122,4.2
Childress County,2020-May,2987,2846,141,4.7
Childress County,2020-Jun,2760,2619,141,5.1
Childress County,2020-Jul,3104,2982,122,3.9
Childress County,2020-Aug,3146,3040,106,3.4
Childress County,2020-Sep,3095,2989,106,3.4
Childress County,2020-Oct,3061,2967,94,3.1
Childress County,2020-Nov,3044,2943,101,3.3
Childress County,2020-Dec,3005,2894,111,3.7
Childress County,2021-Jan,3026,2891,135,4.5
Childress County,2021-Feb,3022,2899,123,4.1
Childress County,2021-Mar,3027,2905,122,4
Childress County,2021-Apr,3075,2969,106,3.4
Childress County,2021-May,3043,2944,99,3.3
Childress County,2021-Jun,2990,2874,116,3.9
Childress County,2021-Jul,3051,2937,114,3.7
Childress County,2021-Aug,3036,2928,108,3.6
Childress County,2021-Sep,3017,2916,101,3.3
Childress County,2021-Oct,2973,2878,95,3.2
Childress County,2021-Nov,2956,2865,91,3.1
Childress County,2021-Dec,2911,2829,82,2.8
Childress County,2022-Jan,2888,2799,89,3.1
Childress County,2022-Feb,2984,2888,96,3.2
Childress County,2022-Mar,3031,2943,88,2.9
Childress County,2022-Apr,3017,2941,76,2.5
Childress County,2022-May,3011,2926,85,2.8
Childress County,2022-Jun,2898,2804,94,3.2
Childress County,2022-Jul,3072(P),2983(P),89(P),2.9(P)
Clay County,2012-Jan,5353,5028,325,6.1
Clay County,2012-Feb,5321,5012,309,5.8
Clay County,2012-Mar,5333,5044,289,5.4
Clay County,2012-Apr,5334,5067,267,5
Clay County,2012-May,5342,5062,280,5.2
Clay County,2012-Jun,5394,5060,334,6.2
Clay County,2012-Jul,5369,5035,334,6.2
Clay County,2012-Aug,5275,4974,301,5.7
Clay County,2012-Sep,5285,4998,287,5.4
Clay County,2012-Oct,5239,4961,278,5.3
Clay County,2012-Nov,5230,4963,267,5.1
Clay County,2012-Dec,5203,4927,276,5.3
Clay County,2013-Jan,5118,4802,316,6.2
Clay County,2013-Feb,5096,4801,295,5.8
Clay County,2013-Mar,5069,4790,279,5.5
Clay County,2013-Apr,5131,4861,270,5.3
Clay County,2013-May,5169,4888,281,5.4
Clay County,2013-Jun,5219,4906,313,6
Clay County,2013-Jul,5214,4906,308,5.9
Clay County,2013-Aug,5110,4830,280,5.5
Clay County,2013-Sep,5133,4845,288,5.6
Clay County,2013-Oct,5120,4846,274,5.4
Clay County,2013-Nov,5084,4814,270,5.3
Clay County,2013-Dec,5102,4850,252,4.9
Clay County,2014-Jan,5003,4741,262,5.2
Clay County,2014-Feb,5047,4783,264,5.2
Clay County,2014-Mar,5067,4812,255,5
Clay County,2014-Apr,5031,4819,212,4.2
Clay County,2014-May,5055,4825,230,4.5
Clay County,2014-Jun,5083,4833,250,4.9
Clay County,2014-Jul,5064,4813,251,5
Clay County,2014-Aug,5010,4765,245,4.9
Clay County,2014-Sep,5010,4776,234,4.7
Clay County,2014-Oct,4967,4766,201,4
Clay County,2014-Nov,4924,4725,199,4
Clay County,2014-Dec,4880,4699,181,3.7
Clay County,2015-Jan,4877,4670,207,4.2
Clay County,2015-Feb,4930,4719,211,4.3
Clay County,2015-Mar,4944,4736,208,4.2
Clay County,2015-Apr,4933,4735,198,4
Clay County,2015-May,4963,4750,213,4.3
Clay County,2015-Jun,4987,4745,242,4.9
Clay County,2015-Jul,4942,4705,237,4.8
Clay County,2015-Aug,4875,4659,216,4.4
Clay County,2015-Sep,4873,4654,219,4.5
Clay County,2015-Oct,4895,4674,221,4.5
Clay County,2015-Nov,4866,4650,216,4.4
Clay County,2015-Dec,4875,4663,212,4.3
Clay County,2016-Jan,4740,4509,231,4.9
Clay County,2016-Feb,4842,4613,229,4.7
Clay County,2016-Mar,4871,4648,223,4.6
Clay County,2016-Apr,4845,4647,198,4.1
Clay County,2016-May,4859,4658,201,4.1
Clay County,2016-Jun,4843,4623,220,4.5
Clay County,2016-Jul,4801,4573,228,4.7
Clay County,2016-Aug,4777,4570,207,4.3
Clay County,2016-Sep,4735,4522,213,4.5
Clay County,2016-Oct,4742,4553,189,4
Clay County,2016-Nov,4749,4560,189,4
Clay County,2016-Dec,4766,4572,194,4.1
Clay County,2017-Jan,4811,4602,209,4.3
Clay County,2017-Feb,4873,4666,207,4.2
Clay County,2017-Mar,4944,4751,193,3.9
Clay County,2017-Apr,4932,4764,168,3.4
Clay County,2017-May,4915,4747,168,3.4
Clay County,2017-Jun,4893,4717,176,3.6
Clay County,2017-Jul,4840,4664,176,3.6
Clay County,2017-Aug,4846,4667,179,3.7
Clay County,2017-Sep,4804,4652,152,3.2
Clay County,2017-Oct,4833,4695,138,2.9
Clay County,2017-Nov,4858,4698,160,3.3
Clay County,2017-Dec,4856,4708,148,3
Clay County,2018-Jan,4834,4663,171,3.5
Clay County,2018-Feb,4891,4723,168,3.4
Clay County,2018-Mar,4934,4763,171,3.5
Clay County,2018-Apr,4902,4760,142,2.9
Clay County,2018-May,4929,4784,145,2.9
Clay County,2018-Jun,4925,4750,175,3.6
Clay County,2018-Jul,4872,4704,168,3.4
Clay County,2018-Aug,4873,4717,156,3.2
Clay County,2018-Sep,4835,4694,141,2.9
Clay County,2018-Oct,4841,4707,134,2.8
Clay County,2018-Nov,4857,4715,142,2.9
Clay County,2018-Dec,4839,4688,151,3.1
Clay County,2019-Jan,4826,4646,180,3.7
Clay County,2019-Feb,4841,4688,153,3.2
Clay County,2019-Mar,4862,4717,145,3
Clay County,2019-Apr,4824,4699,125,2.6
Clay County,2019-May,4841,4707,134,2.8
Clay County,2019-Jun,4874,4707,167,3.4
Clay County,2019-Jul,4880,4708,172,3.5
Clay County,2019-Aug,4899,4744,155,3.2
Clay County,2019-Sep,4863,4715,148,3
Clay County,2019-Oct,4858,4720,138,2.8
Clay County,2019-Nov,4824,4687,137,2.8
Clay County,2019-Dec,4845,4713,132,2.7
Clay County,2020-Jan,4858,4711,147,3
Clay County,2020-Feb,4875,4739,136,2.8
Clay County,2020-Mar,4827,4609,218,4.5
Clay County,2020-Apr,4498,4153,345,7.7
Clay County,2020-May,4626,4273,353,7.6
Clay County,2020-Jun,4752,4414,338,7.1
Clay County,2020-Jul,4759,4440,319,6.7
Clay County,2020-Aug,4807,4548,259,5.4
Clay County,2020-Sep,4770,4507,263,5.5
Clay County,2020-Oct,4835,4594,241,5
Clay County,2020-Nov,4812,4557,255,5.3
Clay County,2020-Dec,4838,4550,288,6
Clay County,2021-Jan,4854,4552,302,6.2
Clay County,2021-Feb,4917,4619,298,6.1
Clay County,2021-Mar,4932,4663,269,5.5
Clay County,2021-Apr,4879,4643,236,4.8
Clay County,2021-May,4826,4591,235,4.9
Clay County,2021-Jun,4847,4578,269,5.5
Clay County,2021-Jul,4818,4579,239,5
Clay County,2021-Aug,4824,4593,231,4.8
Clay County,2021-Sep,4814,4604,210,4.4
Clay County,2021-Oct,4779,4573,206,4.3
Clay County,2021-Nov,4741,4552,189,4
Clay County,2021-Dec,4747,4570,177,3.7
Clay County,2022-Jan,4782,4569,213,4.5
Clay County,2022-Feb,4899,4692,207,4.2
Clay County,2022-Mar,4943,4777,166,3.4
Clay County,2022-Apr,4906,4743,163,3.3
Clay County,2022-May,4866,4697,169,3.5
Clay County,2022-Jun,4886,4690,196,4
Clay County,2022-Jul,4940(P),4745(P),195(P),3.9(P)
Cochran County,2012-Jan,1421,1301,120,8.4
Cochran County,2012-Feb,1392,1276,116,8.3
Cochran County,2012-Mar,1427,1309,118,8.3
Cochran County,2012-Apr,1444,1340,104,7.2
Cochran County,2012-May,1448,1343,105,7.3
Cochran County,2012-Jun,1527,1415,112,7.3
Cochran County,2012-Jul,1496,1375,121,8.1
Cochran County,2012-Aug,1465,1352,113,7.7
Cochran County,2012-Sep,1464,1363,101,6.9
Cochran County,2012-Oct,1432,1331,101,7.1
Cochran County,2012-Nov,1418,1326,92,6.5
Cochran County,2012-Dec,1381,1289,92,6.7
Cochran County,2013-Jan,1351,1250,101,7.5
Cochran County,2013-Feb,1360,1259,101,7.4
Cochran County,2013-Mar,1356,1256,100,7.4
Cochran County,2013-Apr,1403,1309,94,6.7
Cochran County,2013-May,1449,1353,96,6.6
Cochran County,2013-Jun,1488,1380,108,7.3
Cochran County,2013-Jul,1481,1378,103,7
Cochran County,2013-Aug,1402,1305,97,6.9
Cochran County,2013-Sep,1411,1321,90,6.4
Cochran County,2013-Oct,1406,1323,83,5.9
Cochran County,2013-Nov,1331,1250,81,6.1
Cochran County,2013-Dec,1361,1292,69,5.1
Cochran County,2014-Jan,1341,1261,80,6
Cochran County,2014-Feb,1394,1308,86,6.2
Cochran County,2014-Mar,1394,1308,86,6.2
Cochran County,2014-Apr,1435,1361,74,5.2
Cochran County,2014-May,1440,1367,73,5.1
Cochran County,2014-Jun,1466,1383,83,5.7
Cochran County,2014-Jul,1443,1360,83,5.8
Cochran County,2014-Aug,1391,1322,69,5
Cochran County,2014-Sep,1420,1354,66,4.6
Cochran County,2014-Oct,1387,1329,58,4.2
Cochran County,2014-Nov,1331,1278,53,4
Cochran County,2014-Dec,1311,1259,52,4
Cochran County,2015-Jan,1341,1280,61,4.5
Cochran County,2015-Feb,1372,1313,59,4.3
Cochran County,2015-Mar,1421,1356,65,4.6
Cochran County,2015-Apr,1343,1291,52,3.9
Cochran County,2015-May,1385,1320,65,4.7
Cochran County,2015-Jun,1389,1304,85,6.1
Cochran County,2015-Jul,1327,1244,83,6.3
Cochran County,2015-Aug,1281,1201,80,6.2
Cochran County,2015-Sep,1289,1217,72,5.6
Cochran County,2015-Oct,1272,1206,66,5.2
Cochran County,2015-Nov,1196,1133,63,5.3
Cochran County,2015-Dec,1196,1136,60,5
Cochran County,2016-Jan,1126,1069,57,5.1
Cochran County,2016-Feb,1206,1152,54,4.5
Cochran County,2016-Mar,1237,1180,57,4.6
Cochran County,2016-Apr,1235,1179,56,4.5
Cochran County,2016-May,1272,1217,55,4.3
Cochran County,2016-Jun,1230,1165,65,5.3
Cochran County,2016-Jul,1132,1067,65,5.7
Cochran County,2016-Aug,1163,1098,65,5.6
Cochran County,2016-Sep,1136,1076,60,5.3
Cochran County,2016-Oct,1127,1068,59,5.2
Cochran County,2016-Nov,1120,1064,56,5
Cochran County,2016-Dec,1107,1049,58,5.2
Cochran County,2017-Jan,1086,1027,59,5.4
Cochran County,2017-Feb,1117,1058,59,5.3
Cochran County,2017-Mar,1202,1144,58,4.8
Cochran County,2017-Apr,1181,1136,45,3.8
Cochran County,2017-May,1195,1151,44,3.7
Cochran County,2017-Jun,1165,1117,48,4.1
Cochran County,2017-Jul,1091,1036,55,5
Cochran County,2017-Aug,1119,1064,55,4.9
Cochran County,2017-Sep,1061,1009,52,4.9
Cochran County,2017-Oct,1118,1068,50,4.5
Cochran County,2017-Nov,1069,1020,49,4.6
Cochran County,2017-Dec,1085,1040,45,4.1
Cochran County,2018-Jan,1031,981,50,4.8
Cochran County,2018-Feb,1069,1018,51,4.8
Cochran County,2018-Mar,1148,1092,56,4.9
Cochran County,2018-Apr,1113,1067,46,4.1
Cochran County,2018-May,1159,1111,48,4.1
Cochran County,2018-Jun,1139,1081,58,5.1
Cochran County,2018-Jul,1083,1027,56,5.2
Cochran County,2018-Aug,1111,1063,48,4.3
Cochran County,2018-Sep,1107,1063,44,4
Cochran County,2018-Oct,1065,1025,40,3.8
Cochran County,2018-Nov,1034,997,37,3.6
Cochran County,2018-Dec,1006,969,37,3.7
Cochran County,2019-Jan,1026,981,45,4.4
Cochran County,2019-Feb,1099,1059,40,3.6
Cochran County,2019-Mar,1162,1121,41,3.5
Cochran County,2019-Apr,1104,1072,32,2.9
Cochran County,2019-May,1125,1093,32,2.8
Cochran County,2019-Jun,1120,1077,43,3.8
Cochran County,2019-Jul,1126,1079,47,4.2
Cochran County,2019-Aug,1168,1128,40,3.4
Cochran County,2019-Sep,1119,1085,34,3
Cochran County,2019-Oct,1143,1109,34,3
Cochran County,2019-Nov,1080,1046,34,3.1
Cochran County,2019-Dec,1091,1053,38,3.5
Cochran County,2020-Jan,1096,1055,41,3.7
Cochran County,2020-Feb,1124,1083,41,3.6
Cochran County,2020-Mar,1127,1067,60,5.3
Cochran County,2020-Apr,1090,996,94,8.6
Cochran County,2020-May,1090,981,109,10
Cochran County,2020-Jun,1105,992,113,10.2
Cochran County,2020-Jul,1108,1006,102,9.2
Cochran County,2020-Aug,1140,1052,88,7.7
Cochran County,2020-Sep,1111,1026,85,7.7
Cochran County,2020-Oct,1134,1058,76,6.7
Cochran County,2020-Nov,1075,1000,75,7
Cochran County,2020-Dec,1065,997,68,6.4
Cochran County,2021-Jan,1063,991,72,6.8
Cochran County,2021-Feb,1123,1044,79,7
Cochran County,2021-Mar,1179,1102,77,6.5
Cochran County,2021-Apr,1137,1078,59,5.2
Cochran County,2021-May,1082,1022,60,5.5
Cochran County,2021-Jun,1064,993,71,6.7
Cochran County,2021-Jul,1046,973,73,7
Cochran County,2021-Aug,1075,1003,72,6.7
Cochran County,2021-Sep,1076,1007,69,6.4
Cochran County,2021-Oct,1041,979,62,6
Cochran County,2021-Nov,992,932,60,6
Cochran County,2021-Dec,980,923,57,5.8
Cochran County,2022-Jan,992,929,63,6.4
Cochran County,2022-Feb,1112,1045,67,6
Cochran County,2022-Mar,1184,1127,57,4.8
Cochran County,2022-Apr,1170,1114,56,4.8
Cochran County,2022-May,1098,1041,57,5.2
Cochran County,2022-Jun,1076,1015,61,5.7
Cochran County,2022-Jul,1141(P),1081(P),60(P),5.3(P)
Coke County,2012-Jan,1507,1428,79,5.2
Coke County,2012-Feb,1471,1400,71,4.8
Coke County,2012-Mar,1486,1421,65,4.4
Coke County,2012-Apr,1482,1417,65,4.4
Coke County,2012-May,1463,1392,71,4.9
Coke County,2012-Jun,1497,1414,83,5.5
Coke County,2012-Jul,1520,1434,86,5.7
Coke County,2012-Aug,1493,1412,81,5.4
Coke County,2012-Sep,1445,1373,72,5
Coke County,2012-Oct,1417,1345,72,5.1
Coke County,2012-Nov,1425,1353,72,5.1
Coke County,2012-Dec,1421,1349,72,5.1
Coke County,2013-Jan,1413,1333,80,5.7
Coke County,2013-Feb,1444,1375,69,4.8
Coke County,2013-Mar,1429,1365,64,4.5
Coke County,2013-Apr,1440,1373,67,4.7
Coke County,2013-May,1469,1394,75,5.1
Coke County,2013-Jun,1482,1394,88,5.9
Coke County,2013-Jul,1494,1411,83,5.6
Coke County,2013-Aug,1489,1410,79,5.3
Coke County,2013-Sep,1473,1394,79,5.4
Coke County,2013-Oct,1448,1378,70,4.8
Coke County,2013-Nov,1444,1376,68,4.7
Coke County,2013-Dec,1443,1378,65,4.5
Coke County,2014-Jan,1433,1364,69,4.8
Coke County,2014-Feb,1443,1370,73,5.1
Coke County,2014-Mar,1450,1383,67,4.6
Coke County,2014-Apr,1453,1397,56,3.9
Coke County,2014-May,1493,1429,64,4.3
Coke County,2014-Jun,1488,1425,63,4.2
Coke County,2014-Jul,1423,1356,67,4.7
Coke County,2014-Aug,1416,1351,65,4.6
Coke County,2014-Sep,1404,1343,61,4.3
Coke County,2014-Oct,1415,1359,56,4
Coke County,2014-Nov,1408,1353,55,3.9
Coke County,2014-Dec,1400,1346,54,3.9
Coke County,2015-Jan,1403,1345,58,4.1
Coke County,2015-Feb,1376,1321,55,4
Coke County,2015-Mar,1378,1322,56,4.1
Coke County,2015-Apr,1365,1314,51,3.7
Coke County,2015-May,1414,1354,60,4.2
Coke County,2015-Jun,1425,1365,60,4.2
Coke County,2015-Jul,1417,1356,61,4.3
Coke County,2015-Aug,1418,1359,59,4.2
Coke County,2015-Sep,1397,1339,58,4.2
Coke County,2015-Oct,1412,1354,58,4.1
Coke County,2015-Nov,1387,1330,57,4.1
Coke County,2015-Dec,1393,1340,53,3.8
Coke County,2016-Jan,1397,1340,57,4.1
Coke County,2016-Feb,1424,1365,59,4.1
Coke County,2016-Mar,1443,1381,62,4.3
Coke County,2016-Apr,1433,1374,59,4.1
Coke County,2016-May,1441,1380,61,4.2
Coke County,2016-Jun,1447,1382,65,4.5
Coke County,2016-Jul,1426,1366,60,4.2
Coke County,2016-Aug,1431,1374,57,4
Coke County,2016-Sep,1441,1378,63,4.4
Coke County,2016-Oct,1398,1342,56,4
Coke County,2016-Nov,1387,1332,55,4
Coke County,2016-Dec,1393,1337,56,4
Coke County,2017-Jan,1352,1289,63,4.7
Coke County,2017-Feb,1383,1319,64,4.6
Coke County,2017-Mar,1383,1327,56,4
Coke County,2017-Apr,1374,1326,48,3.5
Coke County,2017-May,1396,1347,49,3.5
Coke County,2017-Jun,1423,1370,53,3.7
Coke County,2017-Jul,1391,1337,54,3.9
Coke County,2017-Aug,1409,1356,53,3.8
Coke County,2017-Sep,1402,1353,49,3.5
Coke County,2017-Oct,1376,1333,43,3.1
Coke County,2017-Nov,1386,1338,48,3.5
Coke County,2017-Dec,1403,1359,44,3.1
Coke County,2018-Jan,1400,1345,55,3.9
Coke County,2018-Feb,1403,1348,55,3.9
Coke County,2018-Mar,1432,1385,47,3.3
Coke County,2018-Apr,1438,1392,46,3.2
Coke County,2018-May,1452,1404,48,3.3
Coke County,2018-Jun,1469,1413,56,3.8
Coke County,2018-Jul,1471,1419,52,3.5
Coke County,2018-Aug,1474,1421,53,3.6
Coke County,2018-Sep,1463,1414,49,3.3
Coke County,2018-Oct,1438,1393,45,3.1
Coke County,2018-Nov,1425,1380,45,3.2
Coke County,2018-Dec,1420,1377,43,3
Coke County,2019-Jan,1401,1349,52,3.7
Coke County,2019-Feb,1395,1342,53,3.8
Coke County,2019-Mar,1403,1354,49,3.5
Coke County,2019-Apr,1427,1388,39,2.7
Coke County,2019-May,1416,1371,45,3.2
Coke County,2019-Jun,1453,1401,52,3.6
Coke County,2019-Jul,1455,1404,51,3.5
Coke County,2019-Aug,1493,1443,50,3.3
Coke County,2019-Sep,1465,1421,44,3
Coke County,2019-Oct,1443,1398,45,3.1
Coke County,2019-Nov,1419,1375,44,3.1
Coke County,2019-Dec,1428,1394,34,2.4
Coke County,2020-Jan,1366,1329,37,2.7
Coke County,2020-Feb,1392,1354,38,2.7
Coke County,2020-Mar,1380,1322,58,4.2
Coke County,2020-Apr,1303,1217,86,6.6
Coke County,2020-May,1318,1220,98,7.4
Coke County,2020-Jun,1324,1223,101,7.6
Coke County,2020-Jul,1364,1269,95,7
Coke County,2020-Aug,1367,1288,79,5.8
Coke County,2020-Sep,1370,1289,81,5.9
Coke County,2020-Oct,1354,1284,70,5.2
Coke County,2020-Nov,1348,1277,71,5.3
Coke County,2020-Dec,1350,1277,73,5.4
Coke County,2021-Jan,1351,1272,79,5.8
Coke County,2021-Feb,1373,1290,83,6
Coke County,2021-Mar,1366,1289,77,5.6
Coke County,2021-Apr,1359,1294,65,4.8
Coke County,2021-May,1344,1282,62,4.6
Coke County,2021-Jun,1377,1303,74,5.4
Coke County,2021-Jul,1396,1327,69,4.9
Coke County,2021-Aug,1401,1339,62,4.4
Coke County,2021-Sep,1377,1318,59,4.3
Coke County,2021-Oct,1346,1292,54,4
Coke County,2021-Nov,1345,1295,50,3.7
Coke County,2021-Dec,1340,1294,46,3.4
Coke County,2022-Jan,1334,1276,58,4.3
Coke County,2022-Feb,1366,1306,60,4.4
Coke County,2022-Mar,1366,1318,48,3.5
Coke County,2022-Apr,1359,1313,46,3.4
Coke County,2022-May,1350,1299,51,3.8
Coke County,2022-Jun,1379,1322,57,4.1
Coke County,2022-Jul,1416(P),1358(P),58(P),4.1(P)
Coleman County,2012-Jan,3286,3022,264,8
Coleman County,2012-Feb,3284,3017,267,8.1
Coleman County,2012-Mar,3310,3064,246,7.4
Coleman County,2012-Apr,3285,3056,229,7
Coleman County,2012-May,3324,3075,249,7.5
Coleman County,2012-Jun,3370,3090,280,8.3
Coleman County,2012-Jul,3351,3077,274,8.2
Coleman County,2012-Aug,3292,3044,248,7.5
Coleman County,2012-Sep,3376,3139,237,7
Coleman County,2012-Oct,3323,3080,243,7.3
Coleman County,2012-Nov,3260,3047,213,6.5
Coleman County,2012-Dec,3234,3019,215,6.6
Coleman County,2013-Jan,3157,2888,269,8.5
Coleman County,2013-Feb,3149,2894,255,8.1
Coleman County,2013-Mar,3104,2863,241,7.8
Coleman County,2013-Apr,3136,2903,233,7.4
Coleman County,2013-May,3166,2922,244,7.7
Coleman County,2013-Jun,3174,2915,259,8.2
Coleman County,2013-Jul,3230,2966,264,8.2
Coleman County,2013-Aug,3116,2884,232,7.4
Coleman County,2013-Sep,3164,2933,231,7.3
Coleman County,2013-Oct,3131,2919,212,6.8
Coleman County,2013-Nov,3142,2926,216,6.9
Coleman County,2013-Dec,3133,2935,198,6.3
Coleman County,2014-Jan,3049,2846,203,6.7
Coleman County,2014-Feb,3116,2913,203,6.5
Coleman County,2014-Mar,3135,2938,197,6.3
Coleman County,2014-Apr,3122,2947,175,5.6
Coleman County,2014-May,3159,2969,190,6
Coleman County,2014-Jun,3179,2969,210,6.6
Coleman County,2014-Jul,3141,2912,229,7.3
Coleman County,2014-Aug,3081,2881,200,6.5
Coleman County,2014-Sep,3140,2945,195,6.2
Coleman County,2014-Oct,3112,2933,179,5.8
Coleman County,2014-Nov,3114,2945,169,5.4
Coleman County,2014-Dec,3051,2896,155,5.1
Coleman County,2015-Jan,3034,2851,183,6
Coleman County,2015-Feb,3043,2867,176,5.8
Coleman County,2015-Mar,3079,2915,164,5.3
Coleman County,2015-Apr,3082,2927,155,5
Coleman County,2015-May,3127,2945,182,5.8
Coleman County,2015-Jun,3118,2945,173,5.5
Coleman County,2015-Jul,3050,2870,180,5.9
Coleman County,2015-Aug,3009,2847,162,5.4
Coleman County,2015-Sep,3049,2866,183,6
Coleman County,2015-Oct,3050,2885,165,5.4
Coleman County,2015-Nov,2983,2815,168,5.6
Coleman County,2015-Dec,2992,2838,154,5.1
Coleman County,2016-Jan,2973,2807,166,5.6
Coleman County,2016-Feb,3086,2910,176,5.7
Coleman County,2016-Mar,3103,2921,182,5.9
Coleman County,2016-Apr,3143,2958,185,5.9
Coleman County,2016-May,3145,2960,185,5.9
Coleman County,2016-Jun,3122,2926,196,6.3
Coleman County,2016-Jul,3076,2879,197,6.4
Coleman County,2016-Aug,3054,2869,185,6.1
Coleman County,2016-Sep,3072,2893,179,5.8
Coleman County,2016-Oct,3013,2849,164,5.4
Coleman County,2016-Nov,2990,2824,166,5.6
Coleman County,2016-Dec,3023,2859,164,5.4
Coleman County,2017-Jan,3008,2844,164,5.5
Coleman County,2017-Feb,3055,2893,162,5.3
Coleman County,2017-Mar,3089,2939,150,4.9
Coleman County,2017-Apr,3074,2947,127,4.1
Coleman County,2017-May,3098,2962,136,4.4
Coleman County,2017-Jun,3089,2945,144,4.7
Coleman County,2017-Jul,3031,2886,145,4.8
Coleman County,2017-Aug,3067,2926,141,4.6
Coleman County,2017-Sep,3023,2901,122,4
Coleman County,2017-Oct,3020,2908,112,3.7
Coleman County,2017-Nov,2989,2865,124,4.1
Coleman County,2017-Dec,2994,2876,118,3.9
Coleman County,2018-Jan,2927,2806,121,4.1
Coleman County,2018-Feb,2931,2807,124,4.2
Coleman County,2018-Mar,3006,2888,118,3.9
Coleman County,2018-Apr,2968,2861,107,3.6
Coleman County,2018-May,2959,2855,104,3.5
Coleman County,2018-Jun,2964,2842,122,4.1
Coleman County,2018-Jul,2888,2769,119,4.1
Coleman County,2018-Aug,2879,2762,117,4.1
Coleman County,2018-Sep,2875,2759,116,4
Coleman County,2018-Oct,2857,2748,109,3.8
Coleman County,2018-Nov,2832,2722,110,3.9
Coleman County,2018-Dec,2841,2727,114,4
Coleman County,2019-Jan,2838,2709,129,4.5
Coleman County,2019-Feb,2835,2710,125,4.4
Coleman County,2019-Mar,2830,2718,112,4
Coleman County,2019-Apr,2808,2712,96,3.4
Coleman County,2019-May,2813,2718,95,3.4
Coleman County,2019-Jun,2843,2722,121,4.3
Coleman County,2019-Jul,2832,2708,124,4.4
Coleman County,2019-Aug,2861,2736,125,4.4
Coleman County,2019-Sep,2825,2712,113,4
Coleman County,2019-Oct,2798,2692,106,3.8
Coleman County,2019-Nov,2807,2692,115,4.1
Coleman County,2019-Dec,2823,2701,122,4.3
Coleman County,2020-Jan,2820,2691,129,4.6
Coleman County,2020-Feb,2830,2711,119,4.2
Coleman County,2020-Mar,2811,2615,196,7
Coleman County,2020-Apr,2668,2396,272,10.2
Coleman County,2020-May,2777,2513,264,9.5
Coleman County,2020-Jun,2839,2572,267,9.4
Coleman County,2020-Jul,2887,2629,258,8.9
Coleman County,2020-Aug,2934,2724,210,7.2
Coleman County,2020-Sep,2910,2698,212,7.3
Coleman County,2020-Oct,2909,2724,185,6.4
Coleman County,2020-Nov,2866,2672,194,6.8
Coleman County,2020-Dec,2876,2674,202,7
Coleman County,2021-Jan,2897,2678,219,7.6
Coleman County,2021-Feb,2940,2727,213,7.2
Coleman County,2021-Mar,2995,2792,203,6.8
Coleman County,2021-Apr,2971,2797,174,5.9
Coleman County,2021-May,2919,2744,175,6
Coleman County,2021-Jun,2970,2773,197,6.6
Coleman County,2021-Jul,2967,2790,177,6
Coleman County,2021-Aug,2957,2790,167,5.6
Coleman County,2021-Sep,2948,2793,155,5.3
Coleman County,2021-Oct,2914,2762,152,5.2
Coleman County,2021-Nov,2886,2743,143,5
Coleman County,2021-Dec,2874,2738,136,4.7
Coleman County,2022-Jan,2868,2717,151,5.3
Coleman County,2022-Feb,2942,2785,157,5.3
Coleman County,2022-Mar,2985,2864,121,4.1
Coleman County,2022-Apr,2942,2829,113,3.8
Coleman County,2022-May,2917,2792,125,4.3
Coleman County,2022-Jun,2949,2813,136,4.6
Coleman County,2022-Jul,2996(P),2855(P),141(P),4.7(P)
Collin County,2012-Jan,440253,412602,27651,6.3
Collin County,2012-Feb,442889,415639,27250,6.2
Collin County,2012-Mar,442955,417038,25917,5.9
Collin County,2012-Apr,443634,419285,24349,5.5
Collin County,2012-May,445562,419686,25876,5.8
Collin County,2012-Jun,447547,418853,28694,6.4
Collin County,2012-Jul,447947,419167,28780,6.4
Collin County,2012-Aug,445772,418772,27000,6.1
Collin County,2012-Sep,446891,421808,25083,5.6
Collin County,2012-Oct,448355,423707,24648,5.5
Collin County,2012-Nov,448333,424495,23838,5.3
Collin County,2012-Dec,448228,423865,24363,5.4
Collin County,2013-Jan,450394,422837,27557,6.1
Collin County,2013-Feb,451193,424710,26483,5.9
Collin County,2013-Mar,451551,425909,25642,5.7
Collin County,2013-Apr,453486,429166,24320,5.4
Collin County,2013-May,455257,429937,25320,5.6
Collin County,2013-Jun,458326,430380,27946,6.1
Collin County,2013-Jul,459905,432830,27075,5.9
Collin County,2013-Aug,459776,433896,25880,5.6
Collin County,2013-Sep,460614,435181,25433,5.5
Collin County,2013-Oct,458339,433948,24391,5.3
Collin County,2013-Nov,462803,439408,23395,5.1
Collin County,2013-Dec,461356,439344,22012,4.8
Collin County,2014-Jan,466686,442980,23706,5.1
Collin County,2014-Feb,468525,444503,24022,5.1
Collin County,2014-Mar,470436,446928,23508,5
Collin County,2014-Apr,470443,450001,20442,4.3
Collin County,2014-May,471346,449709,21637,4.6
Collin County,2014-Jun,473961,450645,23316,4.9
Collin County,2014-Jul,476489,452582,23907,5
Collin County,2014-Aug,475941,452797,23144,4.9
Collin County,2014-Sep,475540,454224,21316,4.5
Collin County,2014-Oct,476601,456687,19914,4.2
Collin County,2014-Nov,478328,458863,19465,4.1
Collin County,2014-Dec,476522,458909,17613,3.7
Collin County,2015-Jan,481743,461709,20034,4.2
Collin County,2015-Feb,482573,463762,18811,3.9
Collin County,2015-Mar,481592,463460,18132,3.8
Collin County,2015-Apr,485495,469116,16379,3.4
Collin County,2015-May,486979,469594,17385,3.6
Collin County,2015-Jun,489188,470173,19015,3.9
Collin County,2015-Jul,491580,472416,19164,3.9
Collin County,2015-Aug,491508,473490,18018,3.7
Collin County,2015-Sep,490244,472697,17547,3.6
Collin County,2015-Oct,492799,475608,17191,3.5
Collin County,2015-Nov,495874,478795,17079,3.4
Collin County,2015-Dec,496150,480213,15937,3.2
Collin County,2016-Jan,502378,485009,17369,3.5
Collin County,2016-Feb,506915,489509,17406,3.4
Collin County,2016-Mar,507494,489709,17785,3.5
Collin County,2016-Apr,508685,492436,16249,3.2
Collin County,2016-May,509024,492611,16413,3.2
Collin County,2016-Jun,512470,493203,19267,3.8
Collin County,2016-Jul,516379,496366,20013,3.9
Collin County,2016-Aug,516548,497015,19533,3.8
Collin County,2016-Sep,517902,498394,19508,3.8
Collin County,2016-Oct,518691,500264,18427,3.6
Collin County,2016-Nov,521396,503445,17951,3.4
Collin County,2016-Dec,520812,502771,18041,3.5
Collin County,2017-Jan,520686,500800,19886,3.8
Collin County,2017-Feb,524308,503834,20474,3.9
Collin County,2017-Mar,523812,504652,19160,3.7
Collin County,2017-Apr,526142,508648,17494,3.3
Collin County,2017-May,524436,506641,17795,3.4
Collin County,2017-Jun,527584,507937,19647,3.7
Collin County,2017-Jul,530647,511339,19308,3.6
Collin County,2017-Aug,530355,510904,19451,3.7
Collin County,2017-Sep,532564,515069,17495,3.3
Collin County,2017-Oct,530401,514168,16233,3.1
Collin County,2017-Nov,534374,517164,17210,3.2
Collin County,2017-Dec,532514,515847,16667,3.1
Collin County,2018-Jan,539621,520661,18960,3.5
Collin County,2018-Feb,544453,525071,19382,3.6
Collin County,2018-Mar,542498,523396,19102,3.5
Collin County,2018-Apr,543510,526205,17305,3.2
Collin County,2018-May,542911,525780,17131,3.2
Collin County,2018-Jun,547180,527106,20074,3.7
Collin County,2018-Jul,549082,529832,19250,3.5
Collin County,2018-Aug,545588,526795,18793,3.4
Collin County,2018-Sep,546593,528471,18122,3.3
Collin County,2018-Oct,549154,531900,17254,3.1
Collin County,2018-Nov,551509,534433,17076,3.1
Collin County,2018-Dec,551522,534156,17366,3.1
Collin County,2019-Jan,557568,537676,19892,3.6
Collin County,2019-Feb,560093,541310,18783,3.4
Collin County,2019-Mar,558453,540682,17771,3.2
Collin County,2019-Apr,558799,543419,15380,2.8
Collin County,2019-May,558701,543083,15618,2.8
Collin County,2019-Jun,563821,545101,18720,3.3
Collin County,2019-Jul,567650,548508,19142,3.4
Collin County,2019-Aug,566898,548558,18340,3.2
Collin County,2019-Sep,568694,551446,17248,3
Collin County,2019-Oct,572400,555775,16625,2.9
Collin County,2019-Nov,574502,558070,16432,2.9
Collin County,2019-Dec,573187,557922,15265,2.7
Collin County,2020-Jan,581805,564337,17468,3
Collin County,2020-Feb,585166,568484,16682,2.9
Collin County,2020-Mar,573096,546889,26207,4.6
Collin County,2020-Apr,543302,483496,59806,11
Collin County,2020-May,560249,502489,57760,10.3
Collin County,2020-Jun,568850,518493,50357,8.9
Collin County,2020-Jul,572494,528049,44445,7.8
Collin County,2020-Aug,578412,543006,35406,6.1
Collin County,2020-Sep,580304,546459,33845,5.8
Collin County,2020-Oct,586695,557218,29477,5
Collin County,2020-Nov,589888,559432,30456,5.2
Collin County,2020-Dec,590291,560100,30191,5.1
Collin County,2021-Jan,588729,556712,32017,5.4
Collin County,2021-Feb,592146,560870,31276,5.3
Collin County,2021-Mar,591175,561496,29679,5
Collin County,2021-Apr,593430,566648,26782,4.5
Collin County,2021-May,593527,567909,25618,4.3
Collin County,2021-Jun,596487,567446,29041,4.9
Collin County,2021-Jul,599999,573534,26465,4.4
Collin County,2021-Aug,600818,576217,24601,4.1
Collin County,2021-Sep,602250,579106,23144,3.8
Collin County,2021-Oct,606343,584318,22025,3.6
Collin County,2021-Nov,613292,592573,20719,3.4
Collin County,2021-Dec,611774,592799,18975,3.1
Collin County,2022-Jan,614022,592330,21692,3.5
Collin County,2022-Feb,620354,598500,21854,3.5
Collin County,2022-Mar,621649,603432,18217,2.9
Collin County,2022-Apr,622502,605586,16916,2.7
Collin County,2022-May,626675,608856,17819,2.8
Collin County,2022-Jun,628876,607803,21073,3.4
Collin County,2022-Jul,628593(P),607913(P),20680(P),3.3(P)
Collingsworth County,2012-Jan,1237,1171,66,5.3
Collingsworth County,2012-Feb,1214,1152,62,5.1
Collingsworth County,2012-Mar,1238,1180,58,4.7
Collingsworth County,2012-Apr,1259,1202,57,4.5
Collingsworth County,2012-May,1274,1212,62,4.9
Collingsworth County,2012-Jun,1286,1217,69,5.4
Collingsworth County,2012-Jul,1270,1199,71,5.6
Collingsworth County,2012-Aug,1245,1179,66,5.3
Collingsworth County,2012-Sep,1250,1190,60,4.8
Collingsworth County,2012-Oct,1238,1184,54,4.4
Collingsworth County,2012-Nov,1215,1162,53,4.4
Collingsworth County,2012-Dec,1209,1152,57,4.7
Collingsworth County,2013-Jan,1158,1094,64,5.5
Collingsworth County,2013-Feb,1161,1099,62,5.3
Collingsworth County,2013-Mar,1156,1098,58,5
Collingsworth County,2013-Apr,1189,1131,58,4.9
Collingsworth County,2013-May,1219,1156,63,5.2
Collingsworth County,2013-Jun,1249,1178,71,5.7
Collingsworth County,2013-Jul,1262,1188,74,5.9
Collingsworth County,2013-Aug,1226,1163,63,5.1
Collingsworth County,2013-Sep,1254,1189,65,5.2
Collingsworth County,2013-Oct,1277,1212,65,5.1
Collingsworth County,2013-Nov,1205,1148,57,4.7
Collingsworth County,2013-Dec,1213,1161,52,4.3
Collingsworth County,2014-Jan,1189,1135,54,4.5
Collingsworth County,2014-Feb,1262,1206,56,4.4
Collingsworth County,2014-Mar,1272,1214,58,4.6
Collingsworth County,2014-Apr,1283,1232,51,4
Collingsworth County,2014-May,1288,1237,51,4
Collingsworth County,2014-Jun,1296,1240,56,4.3
Collingsworth County,2014-Jul,1301,1243,58,4.5
Collingsworth County,2014-Aug,1226,1170,56,4.6
Collingsworth County,2014-Sep,1254,1203,51,4.1
Collingsworth County,2014-Oct,1282,1236,46,3.6
Collingsworth County,2014-Nov,1223,1177,46,3.8
Collingsworth County,2014-Dec,1216,1178,38,3.1
Collingsworth County,2015-Jan,1265,1216,49,3.9
Collingsworth County,2015-Feb,1291,1244,47,3.6
Collingsworth County,2015-Mar,1302,1260,42,3.2
Collingsworth County,2015-Apr,1279,1235,44,3.4
Collingsworth County,2015-May,1298,1244,54,4.2
Collingsworth County,2015-Jun,1310,1255,55,4.2
Collingsworth County,2015-Jul,1302,1247,55,4.2
Collingsworth County,2015-Aug,1246,1199,47,3.8
Collingsworth County,2015-Sep,1244,1198,46,3.7
Collingsworth County,2015-Oct,1264,1223,41,3.2
Collingsworth County,2015-Nov,1226,1183,43,3.5
Collingsworth County,2015-Dec,1219,1179,40,3.3
Collingsworth County,2016-Jan,1160,1117,43,3.7
Collingsworth County,2016-Feb,1226,1183,43,3.5
Collingsworth County,2016-Mar,1236,1197,39,3.2
Collingsworth County,2016-Apr,1250,1215,35,2.8
Collingsworth County,2016-May,1263,1226,37,2.9
Collingsworth County,2016-Jun,1258,1207,51,4.1
Collingsworth County,2016-Jul,1228,1179,49,4
Collingsworth County,2016-Aug,1218,1175,43,3.5
Collingsworth County,2016-Sep,1186,1143,43,3.6
Collingsworth County,2016-Oct,1209,1169,40,3.3
Collingsworth County,2016-Nov,1186,1147,39,3.3
Collingsworth County,2016-Dec,1163,1124,39,3.4
Collingsworth County,2017-Jan,1120,1075,45,4
Collingsworth County,2017-Feb,1131,1090,41,3.6
Collingsworth County,2017-Mar,1184,1144,40,3.4
Collingsworth County,2017-Apr,1162,1127,35,3
Collingsworth County,2017-May,1177,1136,41,3.5
Collingsworth County,2017-Jun,1175,1132,43,3.7
Collingsworth County,2017-Jul,1154,1111,43,3.7
Collingsworth County,2017-Aug,1170,1125,45,3.8
Collingsworth County,2017-Sep,1132,1089,43,3.8
Collingsworth County,2017-Oct,1181,1142,39,3.3
Collingsworth County,2017-Nov,1154,1111,43,3.7
Collingsworth County,2017-Dec,1152,1114,38,3.3
Collingsworth County,2018-Jan,1133,1089,44,3.9
Collingsworth County,2018-Feb,1149,1111,38,3.3
Collingsworth County,2018-Mar,1186,1150,36,3
Collingsworth County,2018-Apr,1143,1112,31,2.7
Collingsworth County,2018-May,1201,1168,33,2.7
Collingsworth County,2018-Jun,1192,1154,38,3.2
Collingsworth County,2018-Jul,1186,1150,36,3
Collingsworth County,2018-Aug,1181,1142,39,3.3
Collingsworth County,2018-Sep,1183,1143,40,3.4
Collingsworth County,2018-Oct,1195,1158,37,3.1
Collingsworth County,2018-Nov,1162,1125,37,3.2
Collingsworth County,2018-Dec,1134,1100,34,3
Collingsworth County,2019-Jan,1096,1061,35,3.2
Collingsworth County,2019-Feb,1113,1079,34,3.1
Collingsworth County,2019-Mar,1129,1095,34,3
Collingsworth County,2019-Apr,1119,1091,28,2.5
Collingsworth County,2019-May,1129,1100,29,2.6
Collingsworth County,2019-Jun,1183,1147,36,3
Collingsworth County,2019-Jul,1140,1103,37,3.2
Collingsworth County,2019-Aug,1161,1124,37,3.2
Collingsworth County,2019-Sep,1130,1092,38,3.4
Collingsworth County,2019-Oct,1168,1132,36,3.1
Collingsworth County,2019-Nov,1110,1073,37,3.3
Collingsworth County,2019-Dec,1118,1081,37,3.3
Collingsworth County,2020-Jan,1060,1022,38,3.6
Collingsworth County,2020-Feb,1066,1031,35,3.3
Collingsworth County,2020-Mar,1057,1003,54,5.1
Collingsworth County,2020-Apr,1009,966,43,4.3
Collingsworth County,2020-May,1036,988,48,4.6
Collingsworth County,2020-Jun,1069,1018,51,4.8
Collingsworth County,2020-Jul,1066,1017,49,4.6
Collingsworth County,2020-Aug,1073,1032,41,3.8
Collingsworth County,2020-Sep,1061,1018,43,4.1
Collingsworth County,2020-Oct,1101,1060,41,3.7
Collingsworth County,2020-Nov,1064,1016,48,4.5
Collingsworth County,2020-Dec,1067,1021,46,4.3
Collingsworth County,2021-Jan,1083,1029,54,5
Collingsworth County,2021-Feb,1119,1064,55,4.9
Collingsworth County,2021-Mar,1148,1089,59,5.1
Collingsworth County,2021-Apr,1120,1070,50,4.5
Collingsworth County,2021-May,1087,1038,49,4.5
Collingsworth County,2021-Jun,1103,1048,55,5
Collingsworth County,2021-Jul,1085,1035,50,4.6
Collingsworth County,2021-Aug,1095,1049,46,4.2
Collingsworth County,2021-Sep,1079,1037,42,3.9
Collingsworth County,2021-Oct,1081,1041,40,3.7
Collingsworth County,2021-Nov,1044,1007,37,3.5
Collingsworth County,2021-Dec,1043,1011,32,3.1
Collingsworth County,2022-Jan,1044,1007,37,3.5
Collingsworth County,2022-Feb,1109,1071,38,3.4
Collingsworth County,2022-Mar,1144,1113,31,2.7
Collingsworth County,2022-Apr,1127,1097,30,2.7
Collingsworth County,2022-May,1093,1060,33,3
Collingsworth County,2022-Jun,1109,1070,39,3.5
Collingsworth County,2022-Jul,1132(P),1094(P),38(P),3.4(P)
Colorado County,2012-Jan,10101,9390,711,7
Colorado County,2012-Feb,10003,9329,674,6.7
Colorado County,2012-Mar,10018,9382,636,6.3
Colorado County,2012-Apr,10086,9471,615,6.1
Colorado County,2012-May,10120,9474,646,6.4
Colorado County,2012-Jun,10505,9818,687,6.5
Colorado County,2012-Jul,10393,9707,686,6.6
Colorado County,2012-Aug,10341,9704,637,6.2
Colorado County,2012-Sep,10240,9602,638,6.2
Colorado County,2012-Oct,10103,9489,614,6.1
Colorado County,2012-Nov,10021,9433,588,5.9
Colorado County,2012-Dec,9989,9406,583,5.8
Colorado County,2013-Jan,9930,9295,635,6.4
Colorado County,2013-Feb,9940,9322,618,6.2
Colorado County,2013-Mar,9942,9342,600,6
Colorado County,2013-Apr,9953,9383,570,5.7
Colorado County,2013-May,10046,9451,595,5.9
Colorado County,2013-Jun,10455,9792,663,6.3
Colorado County,2013-Jul,10411,9780,631,6.1
Colorado County,2013-Aug,10302,9707,595,5.8
Colorado County,2013-Sep,10141,9554,587,5.8
Colorado County,2013-Oct,9984,9445,539,5.4
Colorado County,2013-Nov,9872,9361,511,5.2
Colorado County,2013-Dec,10005,9522,483,4.8
Colorado County,2014-Jan,10099,9579,520,5.1
Colorado County,2014-Feb,10241,9725,516,5
Colorado County,2014-Mar,10267,9762,505,4.9
Colorado County,2014-Apr,10163,9729,434,4.3
Colorado County,2014-May,10552,10085,467,4.4
Colorado County,2014-Jun,10649,10153,496,4.7
Colorado County,2014-Jul,10526,10022,504,4.8
Colorado County,2014-Aug,10399,9916,483,4.6
Colorado County,2014-Sep,10127,9673,454,4.5
Colorado County,2014-Oct,10112,9698,414,4.1
Colorado County,2014-Nov,10027,9625,402,4
Colorado County,2014-Dec,9976,9619,357,3.6
Colorado County,2015-Jan,9823,9426,397,4
Colorado County,2015-Feb,9820,9448,372,3.8
Colorado County,2015-Mar,9862,9505,357,3.6
Colorado County,2015-Apr,9788,9428,360,3.7
Colorado County,2015-May,9820,9441,379,3.9
Colorado County,2015-Jun,10257,9826,431,4.2
Colorado County,2015-Jul,10253,9830,423,4.1
Colorado County,2015-Aug,10157,9741,416,4.1
Colorado County,2015-Sep,9862,9462,400,4.1
Colorado County,2015-Oct,9799,9398,401,4.1
Colorado County,2015-Nov,9724,9319,405,4.2
Colorado County,2015-Dec,9758,9376,382,3.9
Colorado County,2016-Jan,9548,9151,397,4.2
Colorado County,2016-Feb,9731,9316,415,4.3
Colorado County,2016-Mar,9784,9368,416,4.3
Colorado County,2016-Apr,9671,9278,393,4.1
Colorado County,2016-May,10021,9603,418,4.2
Colorado County,2016-Jun,10220,9693,527,5.2
Colorado County,2016-Jul,10143,9602,541,5.3
Colorado County,2016-Aug,10055,9534,521,5.2
Colorado County,2016-Sep,9714,9187,527,5.4
Colorado County,2016-Oct,9593,9112,481,5
Colorado County,2016-Nov,9536,9086,450,4.7
Colorado County,2016-Dec,9559,9096,463,4.8
Colorado County,2017-Jan,9540,9061,479,5
Colorado County,2017-Feb,9631,9149,482,5
Colorado County,2017-Mar,9755,9323,432,4.4
Colorado County,2017-Apr,9660,9281,379,3.9
Colorado County,2017-May,9627,9258,369,3.8
Colorado County,2017-Jun,9889,9495,394,4
Colorado County,2017-Jul,9828,9445,383,3.9
Colorado County,2017-Aug,9813,9439,374,3.8
Colorado County,2017-Sep,9673,9318,355,3.7
Colorado County,2017-Oct,9622,9295,327,3.4
Colorado County,2017-Nov,9539,9183,356,3.7
Colorado County,2017-Dec,9517,9177,340,3.6
Colorado County,2018-Jan,9417,9057,360,3.8
Colorado County,2018-Feb,9533,9177,356,3.7
Colorado County,2018-Mar,9594,9252,342,3.6
Colorado County,2018-Apr,9509,9202,307,3.2
Colorado County,2018-May,9529,9228,301,3.2
Colorado County,2018-Jun,9777,9438,339,3.5
Colorado County,2018-Jul,9783,9463,320,3.3
Colorado County,2018-Aug,9677,9370,307,3.2
Colorado County,2018-Sep,9557,9247,310,3.2
Colorado County,2018-Oct,9543,9249,294,3.1
Colorado County,2018-Nov,9540,9249,291,3.1
Colorado County,2018-Dec,9532,9236,296,3.1
Colorado County,2019-Jan,9601,9257,344,3.6
Colorado County,2019-Feb,9650,9326,324,3.4
Colorado County,2019-Mar,9675,9372,303,3.1
Colorado County,2019-Apr,9596,9327,269,2.8
Colorado County,2019-May,9645,9366,279,2.9
Colorado County,2019-Jun,9889,9565,324,3.3
Colorado County,2019-Jul,9941,9610,331,3.3
Colorado County,2019-Aug,9933,9615,318,3.2
Colorado County,2019-Sep,9745,9451,294,3
Colorado County,2019-Oct,9758,9473,285,2.9
Colorado County,2019-Nov,9650,9367,283,2.9
Colorado County,2019-Dec,9672,9398,274,2.8
Colorado County,2020-Jan,9699,9375,324,3.3
Colorado County,2020-Feb,9784,9470,314,3.2
Colorado County,2020-Mar,9703,9221,482,5
Colorado County,2020-Apr,8933,8357,576,6.4
Colorado County,2020-May,9264,8580,684,7.4
Colorado County,2020-Jun,9722,9042,680,7
Colorado County,2020-Jul,9716,9044,672,6.9
Colorado County,2020-Aug,9803,9247,556,5.7
Colorado County,2020-Sep,9640,9091,549,5.7
Colorado County,2020-Oct,9711,9217,494,5.1
Colorado County,2020-Nov,9633,9101,532,5.5
Colorado County,2020-Dec,9644,9100,544,5.6
Colorado County,2021-Jan,9738,9171,567,5.8
Colorado County,2021-Feb,9856,9292,564,5.7
Colorado County,2021-Mar,9961,9427,534,5.4
Colorado County,2021-Apr,9797,9337,460,4.7
Colorado County,2021-May,9858,9393,465,4.7
Colorado County,2021-Jun,10028,9504,524,5.2
Colorado County,2021-Jul,10107,9617,490,4.8
Colorado County,2021-Aug,10078,9621,457,4.5
Colorado County,2021-Sep,9936,9505,431,4.3
Colorado County,2021-Oct,9895,9483,412,4.2
Colorado County,2021-Nov,9818,9428,390,4
Colorado County,2021-Dec,9806,9450,356,3.6
Colorado County,2022-Jan,9878,9474,404,4.1
Colorado County,2022-Feb,10067,9649,418,4.2
Colorado County,2022-Mar,10199,9855,344,3.4
Colorado County,2022-Apr,10065,9749,316,3.1
Colorado County,2022-May,10135,9806,329,3.2
Colorado County,2022-Jun,10304,9931,373,3.6
Colorado County,2022-Jul,10457(P),10095(P),362(P),3.5(P)
Comal County,2012-Jan,55034,51453,3581,6.5
Comal County,2012-Feb,55321,51835,3486,6.3
Comal County,2012-Mar,55349,52058,3291,5.9
Comal County,2012-Apr,55413,52310,3103,5.6
Comal County,2012-May,55594,52286,3308,6
Comal County,2012-Jun,56073,52383,3690,6.6
Comal County,2012-Jul,56130,52447,3683,6.6
Comal County,2012-Aug,55883,52445,3438,6.2
Comal County,2012-Sep,56038,52837,3201,5.7
Comal County,2012-Oct,56174,52968,3206,5.7
Comal County,2012-Nov,56213,53098,3115,5.5
Comal County,2012-Dec,56184,53030,3154,5.6
Comal County,2013-Jan,56961,53358,3603,6.3
Comal County,2013-Feb,57193,53759,3434,6
Comal County,2013-Mar,57669,53821,3848,6.7
Comal County,2013-Apr,57936,54366,3570,6.2
Comal County,2013-May,57923,54333,3590,6.2
Comal County,2013-Jun,58305,54401,3904,6.7
Comal County,2013-Jul,58387,54630,3757,6.4
Comal County,2013-Aug,57934,54467,3467,6
Comal County,2013-Sep,58000,54622,3378,5.8
Comal County,2013-Oct,57591,54354,3237,5.6
Comal County,2013-Nov,58000,54957,3043,5.2
Comal County,2013-Dec,57786,54948,2838,4.9
Comal County,2014-Jan,58878,55831,3047,5.2
Comal County,2014-Feb,59310,56269,3041,5.1
Comal County,2014-Mar,59606,56639,2967,5
Comal County,2014-Apr,59481,57002,2479,4.2
Comal County,2014-May,59665,56987,2678,4.5
Comal County,2014-Jun,60073,57128,2945,4.9
Comal County,2014-Jul,60263,57212,3051,5.1
Comal County,2014-Aug,59898,56990,2908,4.9
Comal County,2014-Sep,59893,57202,2691,4.5
Comal County,2014-Oct,60102,57600,2502,4.2
Comal County,2014-Nov,60228,57790,2438,4
Comal County,2014-Dec,59715,57498,2217,3.7
Comal County,2015-Jan,61017,58503,2514,4.1
Comal County,2015-Feb,61154,58804,2350,3.8
Comal County,2015-Mar,61246,59001,2245,3.7
Comal County,2015-Apr,61739,59664,2075,3.4
Comal County,2015-May,62026,59809,2217,3.6
Comal County,2015-Jun,62008,59586,2422,3.9
Comal County,2015-Jul,62189,59704,2485,4
Comal County,2015-Aug,61957,59658,2299,3.7
Comal County,2015-Sep,62043,59771,2272,3.7
Comal County,2015-Oct,62284,60039,2245,3.6
Comal County,2015-Nov,62743,60490,2253,3.6
Comal County,2015-Dec,62559,60449,2110,3.4
Comal County,2016-Jan,64194,61897,2297,3.6
Comal County,2016-Feb,64808,62544,2264,3.5
Comal County,2016-Mar,65113,62808,2305,3.5
Comal County,2016-Apr,65168,63079,2089,3.2
Comal County,2016-May,65220,63078,2142,3.3
Comal County,2016-Jun,65623,63062,2561,3.9
Comal County,2016-Jul,66042,63383,2659,4
Comal County,2016-Aug,65902,63327,2575,3.9
Comal County,2016-Sep,65916,63390,2526,3.8
Comal County,2016-Oct,65878,63494,2384,3.6
Comal County,2016-Nov,66206,63870,2336,3.5
Comal County,2016-Dec,66173,63818,2355,3.6
Comal County,2017-Jan,67559,64945,2614,3.9
Comal County,2017-Feb,67992,65360,2632,3.9
Comal County,2017-Mar,68148,65626,2522,3.7
Comal County,2017-Apr,68100,65955,2145,3.1
Comal County,2017-May,67903,65687,2216,3.3
Comal County,2017-Jun,68371,65949,2422,3.5
Comal County,2017-Jul,68685,66236,2449,3.6
Comal County,2017-Aug,68491,66053,2438,3.6
Comal County,2017-Sep,68777,66622,2155,3.1
Comal County,2017-Oct,68180,66204,1976,2.9
Comal County,2017-Nov,68563,66429,2134,3.1
Comal County,2017-Dec,68567,66491,2076,3
Comal County,2018-Jan,70715,68350,2365,3.3
Comal County,2018-Feb,71420,69030,2390,3.3
Comal County,2018-Mar,71591,69166,2425,3.4
Comal County,2018-Apr,71810,69698,2112,2.9
Comal County,2018-May,71501,69405,2096,2.9
Comal County,2018-Jun,72003,69459,2544,3.5
Comal County,2018-Jul,72148,69669,2479,3.4
Comal County,2018-Aug,71645,69200,2445,3.4
Comal County,2018-Sep,71650,69373,2277,3.2
Comal County,2018-Oct,71697,69536,2161,3
Comal County,2018-Nov,71920,69747,2173,3
Comal County,2018-Dec,72031,69835,2196,3
Comal County,2019-Jan,74503,71934,2569,3.4
Comal County,2019-Feb,74811,72446,2365,3.2
Comal County,2019-Mar,74796,72484,2312,3.1
Comal County,2019-Apr,74554,72661,1893,2.5
Comal County,2019-May,74419,72490,1929,2.6
Comal County,2019-Jun,75211,72791,2420,3.2
Comal County,2019-Jul,75440,72963,2477,3.3
Comal County,2019-Aug,75377,72956,2421,3.2
Comal County,2019-Sep,75468,73270,2198,2.9
Comal County,2019-Oct,75448,73337,2111,2.8
Comal County,2019-Nov,75728,73604,2124,2.8
Comal County,2019-Dec,75725,73742,1983,2.6
Comal County,2020-Jan,78339,76014,2325,3
Comal County,2020-Feb,78863,76639,2224,2.8
Comal County,2020-Mar,77402,73778,3624,4.7
Comal County,2020-Apr,71738,64206,7532,10.5
Comal County,2020-May,74482,67080,7402,9.9
Comal County,2020-Jun,76187,69837,6350,8.3
Comal County,2020-Jul,76279,70499,5780,7.6
Comal County,2020-Aug,77000,72433,4567,5.9
Comal County,2020-Sep,77269,72876,4393,5.7
Comal County,2020-Oct,77774,73922,3852,5
Comal County,2020-Nov,78147,74102,4045,5.2
Comal County,2020-Dec,78231,74243,3988,5.1
Comal County,2021-Jan,77728,73437,4291,5.5
Comal County,2021-Feb,78216,73979,4237,5.4
Comal County,2021-Mar,78409,74364,4045,5.2
Comal County,2021-Apr,78500,74917,3583,4.6
Comal County,2021-May,78668,75190,3478,4.4
Comal County,2021-Jun,79503,75376,4127,5.2
Comal County,2021-Jul,79666,75911,3755,4.7
Comal County,2021-Aug,79363,75861,3502,4.4
Comal County,2021-Sep,79563,76330,3233,4.1
Comal County,2021-Oct,79749,76648,3101,3.9
Comal County,2021-Nov,80036,77139,2897,3.6
Comal County,2021-Dec,79856,77193,2663,3.3
Comal County,2022-Jan,79987,76925,3062,3.8
Comal County,2022-Feb,80938,77836,3102,3.8
Comal County,2022-Mar,80662,78130,2532,3.1
Comal County,2022-Apr,80120,77771,2349,2.9
Comal County,2022-May,80496,77954,2542,3.2
Comal County,2022-Jun,81207,78144,3063,3.8
Comal County,2022-Jul,81178(P),78165(P),3013(P),3.7(P)
Comanche County,2012-Jan,5711,5308,403,7.1
Comanche County,2012-Feb,5699,5309,390,6.8
Comanche County,2012-Mar,5717,5342,375,6.6
Comanche County,2012-Apr,5795,5453,342,5.9
Comanche County,2012-May,5810,5435,375,6.5
Comanche County,2012-Jun,5881,5467,414,7
Comanche County,2012-Jul,5884,5465,419,7.1
Comanche County,2012-Aug,5786,5419,367,6.3
Comanche County,2012-Sep,5804,5474,330,5.7
Comanche County,2012-Oct,5756,5434,322,5.6
Comanche County,2012-Nov,5740,5428,312,5.4
Comanche County,2012-Dec,5719,5384,335,5.9
Comanche County,2013-Jan,5659,5285,374,6.6
Comanche County,2013-Feb,5646,5301,345,6.1
Comanche County,2013-Mar,5605,5279,326,5.8
Comanche County,2013-Apr,5685,5367,318,5.6
Comanche County,2013-May,5729,5400,329,5.7
Comanche County,2013-Jun,5800,5417,383,6.6
Comanche County,2013-Jul,5694,5317,377,6.6
Comanche County,2013-Aug,5584,5252,332,5.9
Comanche County,2013-Sep,5651,5322,329,5.8
Comanche County,2013-Oct,5578,5271,307,5.5
Comanche County,2013-Nov,5527,5231,296,5.4
Comanche County,2013-Dec,5554,5275,279,5
Comanche County,2014-Jan,5388,5096,292,5.4
Comanche County,2014-Feb,5492,5203,289,5.3
Comanche County,2014-Mar,5513,5235,278,5
Comanche County,2014-Apr,5657,5412,245,4.3
Comanche County,2014-May,5702,5438,264,4.6
Comanche County,2014-Jun,5694,5407,287,5
Comanche County,2014-Jul,5632,5310,322,5.7
Comanche County,2014-Aug,5526,5246,280,5.1
Comanche County,2014-Sep,5496,5224,272,4.9
Comanche County,2014-Oct,5482,5232,250,4.6
Comanche County,2014-Nov,5417,5175,242,4.5
Comanche County,2014-Dec,5340,5121,219,4.1
Comanche County,2015-Jan,5300,5049,251,4.7
Comanche County,2015-Feb,5398,5165,233,4.3
Comanche County,2015-Mar,5431,5187,244,4.5
Comanche County,2015-Apr,5433,5211,222,4.1
Comanche County,2015-May,5455,5223,232,4.3
Comanche County,2015-Jun,5452,5197,255,4.7
Comanche County,2015-Jul,5345,5109,236,4.4
Comanche County,2015-Aug,5281,5062,219,4.1
Comanche County,2015-Sep,5364,5138,226,4.2
Comanche County,2015-Oct,5333,5119,214,4
Comanche County,2015-Nov,5253,5034,219,4.2
Comanche County,2015-Dec,5282,5084,198,3.7
Comanche County,2016-Jan,5210,4986,224,4.3
Comanche County,2016-Feb,5378,5152,226,4.2
Comanche County,2016-Mar,5433,5209,224,4.1
Comanche County,2016-Apr,5437,5222,215,4
Comanche County,2016-May,5508,5291,217,3.9
Comanche County,2016-Jun,5444,5190,254,4.7
Comanche County,2016-Jul,5350,5087,263,4.9
Comanche County,2016-Aug,5366,5126,240,4.5
Comanche County,2016-Sep,5357,5113,244,4.6
Comanche County,2016-Oct,5284,5060,224,4.2
Comanche County,2016-Nov,5260,5045,215,4.1
Comanche County,2016-Dec,5297,5068,229,4.3
Comanche County,2017-Jan,5203,4960,243,4.7
Comanche County,2017-Feb,5301,5060,241,4.5
Comanche County,2017-Mar,5388,5172,216,4
Comanche County,2017-Apr,5354,5177,177,3.3
Comanche County,2017-May,5348,5163,185,3.5
Comanche County,2017-Jun,5332,5135,197,3.7
Comanche County,2017-Jul,5197,4998,199,3.8
Comanche County,2017-Aug,5230,5028,202,3.9
Comanche County,2017-Sep,5191,5006,185,3.6
Comanche County,2017-Oct,5226,5064,162,3.1
Comanche County,2017-Nov,5204,5030,174,3.3
Comanche County,2017-Dec,5208,5041,167,3.2
Comanche County,2018-Jan,5148,4949,199,3.9
Comanche County,2018-Feb,5254,5039,215,4.1
Comanche County,2018-Mar,5401,5197,204,3.8
Comanche County,2018-Apr,5363,5187,176,3.3
Comanche County,2018-May,5409,5231,178,3.3
Comanche County,2018-Jun,5398,5189,209,3.9
Comanche County,2018-Jul,5345,5125,220,4.1
Comanche County,2018-Aug,5344,5158,186,3.5
Comanche County,2018-Sep,5311,5128,183,3.4
Comanche County,2018-Oct,5326,5155,171,3.2
Comanche County,2018-Nov,5297,5118,179,3.4
Comanche County,2018-Dec,5249,5068,181,3.4
Comanche County,2019-Jan,5326,5120,206,3.9
Comanche County,2019-Feb,5460,5272,188,3.4
Comanche County,2019-Mar,5511,5334,177,3.2
Comanche County,2019-Apr,5459,5316,143,2.6
Comanche County,2019-May,5478,5325,153,2.8
Comanche County,2019-Jun,5535,5350,185,3.3
Comanche County,2019-Jul,5513,5321,192,3.5
Comanche County,2019-Aug,5629,5441,188,3.3
Comanche County,2019-Sep,5574,5403,171,3.1
Comanche County,2019-Oct,5597,5420,177,3.2
Comanche County,2019-Nov,5513,5327,186,3.4
Comanche County,2019-Dec,5597,5419,178,3.2
Comanche County,2020-Jan,5526,5323,203,3.7
Comanche County,2020-Feb,5581,5391,190,3.4
Comanche County,2020-Mar,5563,5253,310,5.6
Comanche County,2020-Apr,5101,4786,315,6.2
Comanche County,2020-May,5425,5029,396,7.3
Comanche County,2020-Jun,5513,5116,397,7.2
Comanche County,2020-Jul,5519,5151,368,6.7
Comanche County,2020-Aug,5670,5372,298,5.3
Comanche County,2020-Sep,5662,5359,303,5.4
Comanche County,2020-Oct,5838,5552,286,4.9
Comanche County,2020-Nov,5787,5482,305,5.3
Comanche County,2020-Dec,5820,5507,313,5.4
Comanche County,2021-Jan,5904,5580,324,5.5
Comanche County,2021-Feb,6021,5701,320,5.3
Comanche County,2021-Mar,6126,5814,312,5.1
Comanche County,2021-Apr,6059,5788,271,4.5
Comanche County,2021-May,6001,5733,268,4.5
Comanche County,2021-Jun,5979,5674,305,5.1
Comanche County,2021-Jul,5998,5713,285,4.8
Comanche County,2021-Aug,6076,5808,268,4.4
Comanche County,2021-Sep,6048,5795,253,4.2
Comanche County,2021-Oct,6087,5841,246,4
Comanche County,2021-Nov,6037,5797,240,4
Comanche County,2021-Dec,6052,5831,221,3.7
Comanche County,2022-Jan,6078,5841,237,3.9
Comanche County,2022-Feb,6269,6034,235,3.7
Comanche County,2022-Mar,6403,6209,194,3
Comanche County,2022-Apr,6279,6096,183,2.9
Comanche County,2022-May,6287,6085,202,3.2
Comanche County,2022-Jun,6249,6018,231,3.7
Comanche County,2022-Jul,6336(P),6112(P),224(P),3.5(P)
Concho County,2012-Jan,1459,1393,66,4.5
Concho County,2012-Feb,1433,1367,66,4.6
Concho County,2012-Mar,1462,1402,60,4.1
Concho County,2012-Apr,1519,1459,60,3.9
Concho County,2012-May,1531,1464,67,4.4
Concho County,2012-Jun,1581,1507,74,4.7
Concho County,2012-Jul,1576,1503,73,4.6
Concho County,2012-Aug,1542,1475,67,4.3
Concho County,2012-Sep,1529,1469,60,3.9
Concho County,2012-Oct,1507,1450,57,3.8
Concho County,2012-Nov,1494,1441,53,3.5
Concho County,2012-Dec,1461,1408,53,3.6
Concho County,2013-Jan,1398,1334,64,4.6
Concho County,2013-Feb,1402,1337,65,4.6
Concho County,2013-Mar,1405,1345,60,4.3
Concho County,2013-Apr,1454,1401,53,3.6
Concho County,2013-May,1498,1444,54,3.6
Concho County,2013-Jun,1543,1481,62,4
Concho County,2013-Jul,1555,1492,63,4.1
Concho County,2013-Aug,1484,1430,54,3.6
Concho County,2013-Sep,1461,1401,60,4.1
Concho County,2013-Oct,1438,1386,52,3.6
Concho County,2013-Nov,1371,1316,55,4
Concho County,2013-Dec,1407,1355,52,3.7
Concho County,2014-Jan,1378,1330,48,3.5
Concho County,2014-Feb,1431,1382,49,3.4
Concho County,2014-Mar,1440,1393,47,3.3
Concho County,2014-Apr,1446,1411,35,2.4
Concho County,2014-May,1462,1421,41,2.8
Concho County,2014-Jun,1461,1417,44,3
Concho County,2014-Jul,1445,1400,45,3.1
Concho County,2014-Aug,1414,1371,43,3
Concho County,2014-Sep,1402,1359,43,3.1
Concho County,2014-Oct,1389,1346,43,3.1
Concho County,2014-Nov,1345,1306,39,2.9
Concho County,2014-Dec,1326,1290,36,2.7
Concho County,2015-Jan,1329,1285,44,3.3
Concho County,2015-Feb,1388,1343,45,3.2
Concho County,2015-Mar,1435,1393,42,2.9
Concho County,2015-Apr,1392,1355,37,2.7
Concho County,2015-May,1431,1389,42,2.9
Concho County,2015-Jun,1425,1377,48,3.4
Concho County,2015-Jul,1383,1341,42,3
Concho County,2015-Aug,1332,1289,43,3.2
Concho County,2015-Sep,1356,1308,48,3.5
Concho County,2015-Oct,1367,1320,47,3.4
Concho County,2015-Nov,1309,1259,50,3.8
Concho County,2015-Dec,1335,1286,49,3.7
Concho County,2016-Jan,1262,1213,49,3.9
Concho County,2016-Feb,1392,1343,49,3.5
Concho County,2016-Mar,1434,1381,53,3.7
Concho County,2016-Apr,1407,1358,49,3.5
Concho County,2016-May,1456,1410,46,3.2
Concho County,2016-Jun,1392,1340,52,3.7
Concho County,2016-Jul,1288,1239,49,3.8
Concho County,2016-Aug,1312,1270,42,3.2
Concho County,2016-Sep,1266,1225,41,3.2
Concho County,2016-Oct,1274,1237,37,2.9
Concho County,2016-Nov,1252,1215,37,3
Concho County,2016-Dec,1245,1211,34,2.7
Concho County,2017-Jan,1240,1202,38,3.1
Concho County,2017-Feb,1292,1252,40,3.1
Concho County,2017-Mar,1382,1345,37,2.7
Concho County,2017-Apr,1364,1332,32,2.3
Concho County,2017-May,1333,1266,67,5
Concho County,2017-Jun,1201,1132,69,5.7
Concho County,2017-Jul,1103,1037,66,6
Concho County,2017-Aug,1151,1086,65,5.6
Concho County,2017-Sep,1085,1032,53,4.9
Concho County,2017-Oct,1140,1090,50,4.4
Concho County,2017-Nov,1072,1022,50,4.7
Concho County,2017-Dec,1088,1043,45,4.1
Concho County,2018-Jan,1049,1005,44,4.2
Concho County,2018-Feb,1081,1039,42,3.9
Concho County,2018-Mar,1168,1128,40,3.4
Concho County,2018-Apr,1089,1052,37,3.4
Concho County,2018-May,1144,1108,36,3.1
Concho County,2018-Jun,1105,1062,43,3.9
Concho County,2018-Jul,1067,1022,45,4.2
Concho County,2018-Aug,1131,1085,46,4.1
Concho County,2018-Sep,1098,1057,41,3.7
Concho County,2018-Oct,1067,1031,36,3.4
Concho County,2018-Nov,1038,1004,34,3.3
Concho County,2018-Dec,1007,971,36,3.6
Concho County,2019-Jan,1030,993,37,3.6
Concho County,2019-Feb,1073,1037,36,3.4
Concho County,2019-Mar,1124,1088,36,3.2
Concho County,2019-Apr,1097,1060,37,3.4
Concho County,2019-May,1189,1150,39,3.3
Concho County,2019-Jun,1247,1202,45,3.6
Concho County,2019-Jul,1282,1235,47,3.7
Concho County,2019-Aug,1404,1358,46,3.3
Concho County,2019-Sep,1347,1306,41,3
Concho County,2019-Oct,1402,1363,39,2.8
Concho County,2019-Nov,1356,1319,37,2.7
Concho County,2019-Dec,1323,1290,33,2.5
Concho County,2020-Jan,1327,1290,37,2.8
Concho County,2020-Feb,1342,1305,37,2.8
Concho County,2020-Mar,1337,1279,58,4.3
Concho County,2020-Apr,1258,1190,68,5.4
Concho County,2020-May,1265,1194,71,5.6
Concho County,2020-Jun,1289,1213,76,5.9
Concho County,2020-Jul,1346,1270,76,5.6
Concho County,2020-Aug,1366,1308,58,4.2
Concho County,2020-Sep,1302,1248,54,4.1
Concho County,2020-Oct,1369,1318,51,3.7
Concho County,2020-Nov,1340,1280,60,4.5
Concho County,2020-Dec,1314,1249,65,4.9
Concho County,2021-Jan,1346,1279,67,5
Concho County,2021-Feb,1388,1321,67,4.8
Concho County,2021-Mar,1459,1394,65,4.5
Concho County,2021-Apr,1413,1354,59,4.2
Concho County,2021-May,1336,1279,57,4.3
Concho County,2021-Jun,1322,1256,66,5
Concho County,2021-Jul,1339,1282,57,4.3
Concho County,2021-Aug,1359,1305,54,4
Concho County,2021-Sep,1346,1294,52,3.9
Concho County,2021-Oct,1330,1279,51,3.8
Concho County,2021-Nov,1304,1257,47,3.6
Concho County,2021-Dec,1259,1217,42,3.3
Concho County,2022-Jan,1282,1232,50,3.9
Concho County,2022-Feb,1407,1357,50,3.6
Concho County,2022-Mar,1484,1445,39,2.6
Concho County,2022-Apr,1472,1433,39,2.6
Concho County,2022-May,1387,1345,42,3
Concho County,2022-Jun,1367,1321,46,3.4
Concho County,2022-Jul,1487(P),1444(P),43(P),2.9(P)
Cooke County,2012-Jan,20554,19442,1112,5.4
Cooke County,2012-Feb,20673,19593,1080,5.2
Cooke County,2012-Mar,20669,19631,1038,5
Cooke County,2012-Apr,20710,19747,963,4.6
Cooke County,2012-May,20809,19800,1009,4.8
Cooke County,2012-Jun,20803,19672,1131,5.4
Cooke County,2012-Jul,20749,19614,1135,5.5
Cooke County,2012-Aug,20515,19455,1060,5.2
Cooke County,2012-Sep,20567,19576,991,4.8
Cooke County,2012-Oct,20549,19595,954,4.6
Cooke County,2012-Nov,20592,19651,941,4.6
Cooke County,2012-Dec,20549,19586,963,4.7
Cooke County,2013-Jan,20320,19195,1125,5.5
Cooke County,2013-Feb,20416,19351,1065,5.2
Cooke County,2013-Mar,20385,19351,1034,5.1
Cooke County,2013-Apr,20455,19470,985,4.8
Cooke County,2013-May,20515,19464,1051,5.1
Cooke County,2013-Jun,20589,19433,1156,5.6
Cooke County,2013-Jul,20642,19503,1139,5.5
Cooke County,2013-Aug,20393,19346,1047,5.1
Cooke County,2013-Sep,20516,19493,1023,5
Cooke County,2013-Oct,20378,19430,948,4.7
Cooke County,2013-Nov,20383,19465,918,4.5
Cooke County,2013-Dec,20326,19470,856,4.2
Cooke County,2014-Jan,20109,19197,912,4.5
Cooke County,2014-Feb,20344,19437,907,4.5
Cooke County,2014-Mar,20447,19559,888,4.3
Cooke County,2014-Apr,20476,19738,738,3.6
Cooke County,2014-May,20652,19854,798,3.9
Cooke County,2014-Jun,20723,19853,870,4.2
Cooke County,2014-Jul,20691,19792,899,4.3
Cooke County,2014-Aug,20463,19620,843,4.1
Cooke County,2014-Sep,20525,19765,760,3.7
Cooke County,2014-Oct,20565,19848,717,3.5
Cooke County,2014-Nov,20615,19944,671,3.3
Cooke County,2014-Dec,20542,19928,614,3
Cooke County,2015-Jan,20437,19717,720,3.5
Cooke County,2015-Feb,20379,19674,705,3.5
Cooke County,2015-Mar,20225,19541,684,3.4
Cooke County,2015-Apr,20009,19344,665,3.3
Cooke County,2015-May,20018,19304,714,3.6
Cooke County,2015-Jun,19976,19157,819,4.1
Cooke County,2015-Jul,19808,19001,807,4.1
Cooke County,2015-Aug,19475,18702,773,4
Cooke County,2015-Sep,19304,18580,724,3.8
Cooke County,2015-Oct,19296,18568,728,3.8
Cooke County,2015-Nov,19202,18444,758,3.9
Cooke County,2015-Dec,19158,18436,722,3.8
Cooke County,2016-Jan,18823,18053,770,4.1
Cooke County,2016-Feb,19053,18309,744,3.9
Cooke County,2016-Mar,18993,18237,756,4
Cooke County,2016-Apr,18890,18178,712,3.8
Cooke County,2016-May,18940,18247,693,3.7
Cooke County,2016-Jun,18964,18163,801,4.2
Cooke County,2016-Jul,18913,18095,818,4.3
Cooke County,2016-Aug,18865,18086,779,4.1
Cooke County,2016-Sep,18856,18073,783,4.2
Cooke County,2016-Oct,18925,18180,745,3.9
Cooke County,2016-Nov,18950,18232,718,3.8
Cooke County,2016-Dec,18907,18197,710,3.8
Cooke County,2017-Jan,18555,17802,753,4.1
Cooke County,2017-Feb,18722,17972,750,4
Cooke County,2017-Mar,18892,18202,690,3.7
Cooke County,2017-Apr,18737,18095,642,3.4
Cooke County,2017-May,18716,18041,675,3.6
Cooke County,2017-Jun,18901,18166,735,3.9
Cooke County,2017-Jul,18802,18102,700,3.7
Cooke County,2017-Aug,18739,18067,672,3.6
Cooke County,2017-Sep,18639,18031,608,3.3
Cooke County,2017-Oct,18585,17942,643,3.5
Cooke County,2017-Nov,18626,17964,662,3.6
Cooke County,2017-Dec,18632,18010,622,3.3
Cooke County,2018-Jan,18554,17861,693,3.7
Cooke County,2018-Feb,18766,18132,634,3.4
Cooke County,2018-Mar,18929,18294,635,3.4
Cooke County,2018-Apr,18888,18334,554,2.9
Cooke County,2018-May,18978,18446,532,2.8
Cooke County,2018-Jun,19066,18420,646,3.4
Cooke County,2018-Jul,19015,18380,635,3.3
Cooke County,2018-Aug,19031,18434,597,3.1
Cooke County,2018-Sep,19031,18458,573,3
Cooke County,2018-Oct,19252,18729,523,2.7
Cooke County,2018-Nov,19222,18684,538,2.8
Cooke County,2018-Dec,19142,18601,541,2.8
Cooke County,2019-Jan,19293,18643,650,3.4
Cooke County,2019-Feb,19632,19046,586,3
Cooke County,2019-Mar,19764,19193,571,2.9
Cooke County,2019-Apr,19699,19240,459,2.3
Cooke County,2019-May,19612,19140,472,2.4
Cooke County,2019-Jun,19751,19159,592,3
Cooke County,2019-Jul,19782,19174,608,3.1
Cooke County,2019-Aug,19477,18915,562,2.9
Cooke County,2019-Sep,19463,18899,564,2.9
Cooke County,2019-Oct,19538,19006,532,2.7
Cooke County,2019-Nov,19513,18975,538,2.8
Cooke County,2019-Dec,19631,19129,502,2.6
Cooke County,2020-Jan,19359,18766,593,3.1
Cooke County,2020-Feb,19551,18955,596,3
Cooke County,2020-Mar,19220,18309,911,4.7
Cooke County,2020-Apr,19017,16566,2451,12.9
Cooke County,2020-May,19069,17019,2050,10.8
Cooke County,2020-Jun,18932,17187,1745,9.2
Cooke County,2020-Jul,19096,17460,1636,8.6
Cooke County,2020-Aug,19116,17774,1342,7
Cooke County,2020-Sep,19057,17742,1315,6.9
Cooke County,2020-Oct,18964,17767,1197,6.3
Cooke County,2020-Nov,18975,17741,1234,6.5
Cooke County,2020-Dec,18977,17784,1193,6.3
Cooke County,2021-Jan,19022,17798,1224,6.4
Cooke County,2021-Feb,19245,18068,1177,6.1
Cooke County,2021-Mar,19286,18110,1176,6.1
Cooke County,2021-Apr,19482,18519,963,4.9
Cooke County,2021-May,19463,18504,959,4.9
Cooke County,2021-Jun,19589,18528,1061,5.4
Cooke County,2021-Jul,19530,18561,969,5
Cooke County,2021-Aug,19409,18519,890,4.6
Cooke County,2021-Sep,19544,18488,1056,5.4
Cooke County,2021-Oct,19218,18413,805,4.2
Cooke County,2021-Nov,19285,18528,757,3.9
Cooke County,2021-Dec,19243,18573,670,3.5
Cooke County,2022-Jan,19237,18466,771,4
Cooke County,2022-Feb,19613,18830,783,4
Cooke County,2022-Mar,19707,19088,619,3.1
Cooke County,2022-Apr,19576,19010,566,2.9
Cooke County,2022-May,19629,19020,609,3.1
Cooke County,2022-Jun,19771,18938,833,4.2
Cooke County,2022-Jul,19706(P),18992(P),714(P),3.6(P)
Coryell County,2012-Jan,25105,23179,1926,7.7
Coryell County,2012-Feb,25187,23325,1862,7.4
Coryell County,2012-Mar,25151,23401,1750,7
Coryell County,2012-Apr,25152,23458,1694,6.7
Coryell County,2012-May,25290,23454,1836,7.3
Coryell County,2012-Jun,25410,23369,2041,8
Coryell County,2012-Jul,25589,23550,2039,8
Coryell County,2012-Aug,25449,23542,1907,7.5
Coryell County,2012-Sep,25498,23664,1834,7.2
Coryell County,2012-Oct,25505,23705,1800,7.1
Coryell County,2012-Nov,25347,23594,1753,6.9
Coryell County,2012-Dec,25294,23532,1762,7
Coryell County,2013-Jan,25017,23078,1939,7.8
Coryell County,2013-Feb,24958,23149,1809,7.2
Coryell County,2013-Mar,24972,23204,1768,7.1
Coryell County,2013-Apr,25137,23383,1754,7
Coryell County,2013-May,25249,23413,1836,7.3
Coryell County,2013-Jun,25263,23248,2015,8
Coryell County,2013-Jul,25405,23441,1964,7.7
Coryell County,2013-Aug,25322,23422,1900,7.5
Coryell County,2013-Sep,25385,23506,1879,7.4
Coryell County,2013-Oct,25098,23330,1768,7
Coryell County,2013-Nov,25190,23530,1660,6.6
Coryell County,2013-Dec,25081,23516,1565,6.2
Coryell County,2014-Jan,24722,23073,1649,6.7
Coryell County,2014-Feb,24783,23141,1642,6.6
Coryell County,2014-Mar,24729,23158,1571,6.4
Coryell County,2014-Apr,24785,23392,1393,5.6
Coryell County,2014-May,24843,23355,1488,6
Coryell County,2014-Jun,24778,23181,1597,6.4
Coryell County,2014-Jul,24744,23124,1620,6.5
Coryell County,2014-Aug,24582,23033,1549,6.3
Coryell County,2014-Sep,24573,23127,1446,5.9
Coryell County,2014-Oct,24611,23238,1373,5.6
Coryell County,2014-Nov,24642,23294,1348,5.5
Coryell County,2014-Dec,24481,23270,1211,4.9
Coryell County,2015-Jan,24139,22814,1325,5.5
Coryell County,2015-Feb,24230,23021,1209,5
Coryell County,2015-Mar,24207,23061,1146,4.7
Coryell County,2015-Apr,24343,23296,1047,4.3
Coryell County,2015-May,24479,23343,1136,4.6
Coryell County,2015-Jun,24373,23160,1213,5
Coryell County,2015-Jul,24534,23291,1243,5.1
Coryell County,2015-Aug,24511,23329,1182,4.8
Coryell County,2015-Sep,24585,23385,1200,4.9
Coryell County,2015-Oct,24728,23550,1178,4.8
Coryell County,2015-Nov,25000,23834,1166,4.7
Coryell County,2015-Dec,25059,23970,1089,4.3
Coryell County,2016-Jan,24135,23020,1115,4.6
Coryell County,2016-Feb,24368,23253,1115,4.6
Coryell County,2016-Mar,24380,23264,1116,4.6
Coryell County,2016-Apr,24401,23336,1065,4.4
Coryell County,2016-May,24383,23326,1057,4.3
Coryell County,2016-Jun,24431,23198,1233,5
Coryell County,2016-Jul,24510,23259,1251,5.1
Coryell County,2016-Aug,24440,23237,1203,4.9
Coryell County,2016-Sep,24507,23294,1213,4.9
Coryell County,2016-Oct,24457,23330,1127,4.6
Coryell County,2016-Nov,24611,23489,1122,4.6
Coryell County,2016-Dec,24510,23417,1093,4.5
Coryell County,2017-Jan,24134,22887,1247,5.2
Coryell County,2017-Feb,24222,22989,1233,5.1
Coryell County,2017-Mar,24203,23053,1150,4.8
Coryell County,2017-Apr,24322,23301,1021,4.2
Coryell County,2017-May,24308,23288,1020,4.2
Coryell County,2017-Jun,24250,23162,1088,4.5
Coryell County,2017-Jul,24234,23157,1077,4.4
Coryell County,2017-Aug,24230,23139,1091,4.5
Coryell County,2017-Sep,24232,23216,1016,4.2
Coryell County,2017-Oct,24080,23147,933,3.9
Coryell County,2017-Nov,24271,23265,1006,4.1
Coryell County,2017-Dec,24132,23189,943,3.9
Coryell County,2018-Jan,23627,22571,1056,4.5
Coryell County,2018-Feb,23750,22719,1031,4.3
Coryell County,2018-Mar,23602,22601,1001,4.2
Coryell County,2018-Apr,23679,22755,924,3.9
Coryell County,2018-May,23621,22700,921,3.9
Coryell County,2018-Jun,23657,22551,1106,4.7
Coryell County,2018-Jul,23687,22633,1054,4.4
Coryell County,2018-Aug,23539,22517,1022,4.3
Coryell County,2018-Sep,23634,22654,980,4.1
Coryell County,2018-Oct,23696,22728,968,4.1
Coryell County,2018-Nov,23758,22798,960,4
Coryell County,2018-Dec,23753,22776,977,4.1
Coryell County,2019-Jan,23609,22494,1115,4.7
Coryell County,2019-Feb,23684,22663,1021,4.3
Coryell County,2019-Mar,23558,22612,946,4
Coryell County,2019-Apr,23587,22779,808,3.4
Coryell County,2019-May,23554,22716,838,3.6
Coryell County,2019-Jun,23675,22648,1027,4.3
Coryell County,2019-Jul,23772,22726,1046,4.4
Coryell County,2019-Aug,23678,22693,985,4.2
Coryell County,2019-Sep,23767,22857,910,3.8
Coryell County,2019-Oct,23810,22926,884,3.7
Coryell County,2019-Nov,23920,23018,902,3.8
Coryell County,2019-Dec,23869,23030,839,3.5
Coryell County,2020-Jan,23702,22770,932,3.9
Coryell County,2020-Feb,23828,22932,896,3.8
Coryell County,2020-Mar,23503,22144,1359,5.8
Coryell County,2020-Apr,22386,20201,2185,9.8
Coryell County,2020-May,22930,20801,2129,9.3
Coryell County,2020-Jun,23460,21394,2066,8.8
Coryell County,2020-Jul,23753,21832,1921,8.1
Coryell County,2020-Aug,23839,22320,1519,6.4
Coryell County,2020-Sep,23886,22359,1527,6.4
Coryell County,2020-Oct,24033,22668,1365,5.7
Coryell County,2020-Nov,24146,22711,1435,5.9
Coryell County,2020-Dec,24133,22702,1431,5.9
Coryell County,2021-Jan,24158,22591,1567,6.5
Coryell County,2021-Feb,24280,22673,1607,6.6
Coryell County,2021-Mar,24278,22720,1558,6.4
Coryell County,2021-Apr,24273,22929,1344,5.5
Coryell County,2021-May,24333,23001,1332,5.5
Coryell County,2021-Jun,24448,22889,1559,6.4
Coryell County,2021-Jul,24316,22891,1425,5.9
Coryell County,2021-Aug,24299,22937,1362,5.6
Coryell County,2021-Sep,24330,23032,1298,5.3
Coryell County,2021-Oct,24476,23228,1248,5.1
Coryell County,2021-Nov,24527,23353,1174,4.8
Coryell County,2021-Dec,24431,23372,1059,4.3
Coryell County,2022-Jan,24491,23256,1235,5
Coryell County,2022-Feb,24799,23549,1250,5
Coryell County,2022-Mar,24713,23695,1018,4.1
Coryell County,2022-Apr,24530,23597,933,3.8
Coryell County,2022-May,24472,23458,1014,4.1
Coryell County,2022-Jun,24512,23329,1183,4.8
Coryell County,2022-Jul,24545(P),23378(P),1167(P),4.8(P)
Cottle County,2012-Jan,661,604,57,8.6
Cottle County,2012-Feb,646,591,55,8.5
Cottle County,2012-Mar,658,606,52,7.9
Cottle County,2012-Apr,658,609,49,7.4
Cottle County,2012-May,679,630,49,7.2
Cottle County,2012-Jun,714,662,52,7.3
Cottle County,2012-Jul,711,662,49,6.9
Cottle County,2012-Aug,690,644,46,6.7
Cottle County,2012-Sep,679,634,45,6.6
Cottle County,2012-Oct,635,586,49,7.7
Cottle County,2012-Nov,624,581,43,6.9
Cottle County,2012-Dec,614,570,44,7.2
Cottle County,2013-Jan,601,553,48,8
Cottle County,2013-Feb,612,563,49,8
Cottle County,2013-Mar,588,549,39,6.6
Cottle County,2013-Apr,605,566,39,6.4
Cottle County,2013-May,622,579,43,6.9
Cottle County,2013-Jun,641,592,49,7.6
Cottle County,2013-Jul,637,593,44,6.9
Cottle County,2013-Aug,626,581,45,7.2
Cottle County,2013-Sep,633,587,46,7.3
Cottle County,2013-Oct,653,610,43,6.6
Cottle County,2013-Nov,636,599,37,5.8
Cottle County,2013-Dec,625,596,29,4.6
Cottle County,2014-Jan,618,585,33,5.3
Cottle County,2014-Feb,630,590,40,6.3
Cottle County,2014-Mar,616,582,34,5.5
Cottle County,2014-Apr,613,585,28,4.6
Cottle County,2014-May,608,575,33,5.4
Cottle County,2014-Jun,614,577,37,6
Cottle County,2014-Jul,611,571,40,6.5
Cottle County,2014-Aug,608,568,40,6.6
Cottle County,2014-Sep,584,552,32,5.5
Cottle County,2014-Oct,592,553,39,6.6
Cottle County,2014-Nov,586,535,51,8.7
Cottle County,2014-Dec,570,526,44,7.7
Cottle County,2015-Jan,547,497,50,9.1
Cottle County,2015-Feb,555,512,43,7.7
Cottle County,2015-Mar,566,522,44,7.8
Cottle County,2015-Apr,553,514,39,7.1
Cottle County,2015-May,570,529,41,7.2
Cottle County,2015-Jun,569,529,40,7
Cottle County,2015-Jul,561,522,39,7
Cottle County,2015-Aug,534,499,35,6.6
Cottle County,2015-Sep,531,495,36,6.8
Cottle County,2015-Oct,532,497,35,6.6
Cottle County,2015-Nov,514,479,35,6.8
Cottle County,2015-Dec,520,487,33,6.3
Cottle County,2016-Jan,503,471,32,6.4
Cottle County,2016-Feb,527,496,31,5.9
Cottle County,2016-Mar,536,509,27,5
Cottle County,2016-Apr,531,507,24,4.5
Cottle County,2016-May,546,521,25,4.6
Cottle County,2016-Jun,537,509,28,5.2
Cottle County,2016-Jul,527,499,28,5.3
Cottle County,2016-Aug,531,507,24,4.5
Cottle County,2016-Sep,534,506,28,5.2
Cottle County,2016-Oct,524,498,26,5
Cottle County,2016-Nov,509,484,25,4.9
Cottle County,2016-Dec,497,473,24,4.8
Cottle County,2017-Jan,475,446,29,6.1
Cottle County,2017-Feb,497,469,28,5.6
Cottle County,2017-Mar,527,502,25,4.7
Cottle County,2017-Apr,535,514,21,3.9
Cottle County,2017-May,544,523,21,3.9
Cottle County,2017-Jun,526,504,22,4.2
Cottle County,2017-Jul,516,496,20,3.9
Cottle County,2017-Aug,523,504,19,3.6
Cottle County,2017-Sep,501,479,22,4.4
Cottle County,2017-Oct,531,513,18,3.4
Cottle County,2017-Nov,516,493,23,4.5
Cottle County,2017-Dec,507,486,21,4.1
Cottle County,2018-Jan,503,481,22,4.4
Cottle County,2018-Feb,513,490,23,4.5
Cottle County,2018-Mar,531,505,26,4.9
Cottle County,2018-Apr,523,496,27,5.2
Cottle County,2018-May,538,514,24,4.5
Cottle County,2018-Jun,536,512,24,4.5
Cottle County,2018-Jul,512,489,23,4.5
Cottle County,2018-Aug,533,510,23,4.3
Cottle County,2018-Sep,521,499,22,4.2
Cottle County,2018-Oct,540,519,21,3.9
Cottle County,2018-Nov,534,513,21,3.9
Cottle County,2018-Dec,533,512,21,3.9
Cottle County,2019-Jan,531,506,25,4.7
Cottle County,2019-Feb,536,510,26,4.9
Cottle County,2019-Mar,549,526,23,4.2
Cottle County,2019-Apr,545,527,18,3.3
Cottle County,2019-May,554,535,19,3.4
Cottle County,2019-Jun,551,528,23,4.2
Cottle County,2019-Jul,542,521,21,3.9
Cottle County,2019-Aug,552,532,20,3.6
Cottle County,2019-Sep,537,516,21,3.9
Cottle County,2019-Oct,538,516,22,4.1
Cottle County,2019-Nov,533,506,27,5.1
Cottle County,2019-Dec,539,514,25,4.6
Cottle County,2020-Jan,517,490,27,5.2
Cottle County,2020-Feb,538,514,24,4.5
Cottle County,2020-Mar,543,508,35,6.4
Cottle County,2020-Apr,534,507,27,5.1
Cottle County,2020-May,575,545,30,5.2
Cottle County,2020-Jun,569,538,31,5.4
Cottle County,2020-Jul,581,550,31,5.3
Cottle County,2020-Aug,578,552,26,4.5
Cottle County,2020-Sep,566,543,23,4.1
Cottle County,2020-Oct,569,548,21,3.7
Cottle County,2020-Nov,574,548,26,4.5
Cottle County,2020-Dec,621,590,31,5
Cottle County,2021-Jan,582,547,35,6
Cottle County,2021-Feb,589,555,34,5.8
Cottle County,2021-Mar,609,576,33,5.4
Cottle County,2021-Apr,622,596,26,4.2
Cottle County,2021-May,605,575,30,5
Cottle County,2021-Jun,621,587,34,5.5
Cottle County,2021-Jul,620,591,29,4.7
Cottle County,2021-Aug,629,601,28,4.5
Cottle County,2021-Sep,592,568,24,4.1
Cottle County,2021-Oct,582,558,24,4.1
Cottle County,2021-Nov,586,564,22,3.8
Cottle County,2021-Dec,611,592,19,3.1
Cottle County,2022-Jan,582,556,26,4.5
Cottle County,2022-Feb,614,587,27,4.4
Cottle County,2022-Mar,634,615,19,3
Cottle County,2022-Apr,650,633,17,2.6
Cottle County,2022-May,629,608,21,3.3
Cottle County,2022-Jun,646,621,25,3.9
Cottle County,2022-Jul,668(P),645(P),23(P),3.4(P)
Crane County,2012-Jan,2004,1896,108,5.4
Crane County,2012-Feb,2012,1909,103,5.1
Crane County,2012-Mar,2020,1922,98,4.9
Crane County,2012-Apr,2027,1930,97,4.8
Crane County,2012-May,2057,1952,105,5.1
Crane County,2012-Jun,2092,1971,121,5.8
Crane County,2012-Jul,2098,1985,113,5.4
Crane County,2012-Aug,2077,1975,102,4.9
Crane County,2012-Sep,2108,2014,94,4.5
Crane County,2012-Oct,2078,1986,92,4.4
Crane County,2012-Nov,2061,1974,87,4.2
Crane County,2012-Dec,2046,1962,84,4.1
Crane County,2013-Jan,2034,1934,100,4.9
Crane County,2013-Feb,2067,1971,96,4.6
Crane County,2013-Mar,2067,1969,98,4.7
Crane County,2013-Apr,2062,1968,94,4.6
Crane County,2013-May,2069,1969,100,4.8
Crane County,2013-Jun,2094,1984,110,5.3
Crane County,2013-Jul,2156,2054,102,4.7
Crane County,2013-Aug,2132,2037,95,4.5
Crane County,2013-Sep,2132,2042,90,4.2
Crane County,2013-Oct,2079,1996,83,4
Crane County,2013-Nov,2055,1972,83,4
Crane County,2013-Dec,2044,1969,75,3.7
Crane County,2014-Jan,2043,1964,79,3.9
Crane County,2014-Feb,2061,1977,84,4.1
Crane County,2014-Mar,2062,1983,79,3.8
Crane County,2014-Apr,2014,1944,70,3.5
Crane County,2014-May,2012,1930,82,4.1
Crane County,2014-Jun,1984,1887,97,4.9
Crane County,2014-Jul,2032,1936,96,4.7
Crane County,2014-Aug,2014,1926,88,4.4
Crane County,2014-Sep,1977,1895,82,4.1
Crane County,2014-Oct,1969,1894,75,3.8
Crane County,2014-Nov,1957,1882,75,3.8
Crane County,2014-Dec,1917,1846,71,3.7
Crane County,2015-Jan,1869,1781,88,4.7
Crane County,2015-Feb,1861,1774,87,4.7
Crane County,2015-Mar,1845,1753,92,5
Crane County,2015-Apr,1878,1788,90,4.8
Crane County,2015-May,1848,1752,96,5.2
Crane County,2015-Jun,1832,1726,106,5.8
Crane County,2015-Jul,1826,1712,114,6.2
Crane County,2015-Aug,1812,1702,110,6.1
Crane County,2015-Sep,1816,1699,117,6.4
Crane County,2015-Oct,1831,1706,125,6.8
Crane County,2015-Nov,1813,1683,130,7.2
Crane County,2015-Dec,1821,1697,124,6.8
Crane County,2016-Jan,1729,1604,125,7.2
Crane County,2016-Feb,1768,1622,146,8.3
Crane County,2016-Mar,1792,1618,174,9.7
Crane County,2016-Apr,1760,1594,166,9.4
Crane County,2016-May,1740,1581,159,9.1
Crane County,2016-Jun,1737,1564,173,10
Crane County,2016-Jul,1701,1541,160,9.4
Crane County,2016-Aug,1684,1529,155,9.2
Crane County,2016-Sep,1676,1530,146,8.7
Crane County,2016-Oct,1639,1517,122,7.4
Crane County,2016-Nov,1626,1510,116,7.1
Crane County,2016-Dec,1621,1506,115,7.1
Crane County,2017-Jan,1590,1476,114,7.2
Crane County,2017-Feb,1615,1503,112,6.9
Crane County,2017-Mar,1604,1507,97,6
Crane County,2017-Apr,1635,1553,82,5
Crane County,2017-May,1622,1542,80,4.9
Crane County,2017-Jun,1623,1540,83,5.1
Crane County,2017-Jul,1557,1475,82,5.3
Crane County,2017-Aug,1564,1482,82,5.2
Crane County,2017-Sep,1536,1463,73,4.8
Crane County,2017-Oct,1532,1465,67,4.4
Crane County,2017-Nov,1530,1463,67,4.4
Crane County,2017-Dec,1571,1505,66,4.2
Crane County,2018-Jan,1651,1577,74,4.5
Crane County,2018-Feb,1683,1606,77,4.6
Crane County,2018-Mar,1702,1627,75,4.4
Crane County,2018-Apr,1715,1645,70,4.1
Crane County,2018-May,1792,1726,66,3.7
Crane County,2018-Jun,1811,1734,77,4.3
Crane County,2018-Jul,1805,1734,71,3.9
Crane County,2018-Aug,1806,1741,65,3.6
Crane County,2018-Sep,1803,1741,62,3.4
Crane County,2018-Oct,1795,1732,63,3.5
Crane County,2018-Nov,1797,1735,62,3.5
Crane County,2018-Dec,1796,1737,59,3.3
Crane County,2019-Jan,1509,1443,66,4.4
Crane County,2019-Feb,1524,1458,66,4.3
Crane County,2019-Mar,1510,1454,56,3.7
Crane County,2019-Apr,1510,1463,47,3.1
Crane County,2019-May,1547,1494,53,3.4
Crane County,2019-Jun,1574,1507,67,4.3
Crane County,2019-Jul,1568,1499,69,4.4
Crane County,2019-Aug,1570,1505,65,4.1
Crane County,2019-Sep,1569,1504,65,4.1
Crane County,2019-Oct,1561,1500,61,3.9
Crane County,2019-Nov,1563,1500,63,4
Crane County,2019-Dec,1569,1503,66,4.2
Crane County,2020-Jan,1543,1465,78,5.1
Crane County,2020-Feb,1564,1492,72,4.6
Crane County,2020-Mar,1548,1432,116,7.5
Crane County,2020-Apr,1595,1334,261,16.4
Crane County,2020-May,1659,1329,330,19.9
Crane County,2020-Jun,1657,1322,335,20.2
Crane County,2020-Jul,1658,1354,304,18.3
Crane County,2020-Aug,1619,1381,238,14.7
Crane County,2020-Sep,1632,1397,235,14.4
Crane County,2020-Oct,1644,1412,232,14.1
Crane County,2020-Nov,1635,1406,229,14
Crane County,2020-Dec,1600,1386,214,13.4
Crane County,2021-Jan,1636,1431,205,12.5
Crane County,2021-Feb,1661,1450,211,12.7
Crane County,2021-Mar,1660,1469,191,11.5
Crane County,2021-Apr,1647,1479,168,10.2
Crane County,2021-May,1614,1459,155,9.6
Crane County,2021-Jun,1621,1452,169,10.4
Crane County,2021-Jul,1624,1471,153,9.4
Crane County,2021-Aug,1614,1475,139,8.6
Crane County,2021-Sep,1619,1491,128,7.9
Crane County,2021-Oct,1609,1488,121,7.5
Crane County,2021-Nov,1609,1493,116,7.2
Crane County,2021-Dec,1595,1484,111,7
Crane County,2022-Jan,1591,1469,122,7.7
Crane County,2022-Feb,1587,1459,128,8.1
Crane County,2022-Mar,1580,1481,99,6.3
Crane County,2022-Apr,1560,1471,89,5.7
Crane County,2022-May,1543,1456,87,5.6
Crane County,2022-Jun,1552,1448,104,6.7
Crane County,2022-Jul,1571(P),1471(P),100(P),6.4(P)
Crockett County,2012-Jan,1685,1587,98,5.8
Crockett County,2012-Feb,1691,1598,93,5.5
Crockett County,2012-Mar,1686,1601,85,5
Crockett County,2012-Apr,1713,1631,82,4.8
Crockett County,2012-May,1784,1698,86,4.8
Crockett County,2012-Jun,1824,1723,101,5.5
Crockett County,2012-Jul,1822,1726,96,5.3
Crockett County,2012-Aug,1825,1735,90,4.9
Crockett County,2012-Sep,1794,1711,83,4.6
Crockett County,2012-Oct,1767,1683,84,4.8
Crockett County,2012-Nov,1798,1719,79,4.4
Crockett County,2012-Dec,1846,1762,84,4.6
Crockett County,2013-Jan,1838,1741,97,5.3
Crockett County,2013-Feb,1849,1759,90,4.9
Crockett County,2013-Mar,1834,1746,88,4.8
Crockett County,2013-Apr,1872,1787,85,4.5
Crockett County,2013-May,1909,1805,104,5.4
Crockett County,2013-Jun,1937,1823,114,5.9
Crockett County,2013-Jul,1968,1858,110,5.6
Crockett County,2013-Aug,1954,1853,101,5.2
Crockett County,2013-Sep,1942,1839,103,5.3
Crockett County,2013-Oct,1865,1770,95,5.1
Crockett County,2013-Nov,1802,1713,89,4.9
Crockett County,2013-Dec,1785,1701,84,4.7
Crockett County,2014-Jan,1806,1721,85,4.7
Crockett County,2014-Feb,1828,1741,87,4.8
Crockett County,2014-Mar,1842,1757,85,4.6
Crockett County,2014-Apr,1902,1831,71,3.7
Crockett County,2014-May,1953,1880,73,3.7
Crockett County,2014-Jun,1976,1901,75,3.8
Crockett County,2014-Jul,1990,1915,75,3.8
Crockett County,2014-Aug,1988,1912,76,3.8
Crockett County,2014-Sep,2011,1938,73,3.6
Crockett County,2014-Oct,1955,1886,69,3.5
Crockett County,2014-Nov,1956,1891,65,3.3
Crockett County,2014-Dec,1952,1894,58,3
Crockett County,2015-Jan,1900,1816,84,4.4
Crockett County,2015-Feb,1939,1848,91,4.7
Crockett County,2015-Mar,1948,1842,106,5.4
Crockett County,2015-Apr,1982,1867,115,5.8
Crockett County,2015-May,1954,1836,118,6
Crockett County,2015-Jun,1953,1832,121,6.2
Crockett County,2015-Jul,1933,1807,126,6.5
Crockett County,2015-Aug,1913,1787,126,6.6
Crockett County,2015-Sep,1904,1782,122,6.4
Crockett County,2015-Oct,1845,1714,131,7.1
Crockett County,2015-Nov,1795,1669,126,7
Crockett County,2015-Dec,1753,1634,119,6.8
Crockett County,2016-Jan,1757,1621,136,7.7
Crockett County,2016-Feb,1772,1624,148,8.4
Crockett County,2016-Mar,1767,1615,152,8.6
Crockett County,2016-Apr,1751,1613,138,7.9
Crockett County,2016-May,1769,1633,136,7.7
Crockett County,2016-Jun,1781,1641,140,7.9
Crockett County,2016-Jul,1756,1623,133,7.6
Crockett County,2016-Aug,1775,1641,134,7.5
Crockett County,2016-Sep,1730,1601,129,7.5
Crockett County,2016-Oct,1657,1543,114,6.9
Crockett County,2016-Nov,1660,1549,111,6.7
Crockett County,2016-Dec,1668,1565,103,6.2
Crockett County,2017-Jan,1665,1566,99,5.9
Crockett County,2017-Feb,1670,1584,86,5.1
Crockett County,2017-Mar,1677,1599,78,4.7
Crockett County,2017-Apr,1697,1630,67,3.9
Crockett County,2017-May,1684,1616,68,4
Crockett County,2017-Jun,1708,1639,69,4
Crockett County,2017-Jul,1699,1633,66,3.9
Crockett County,2017-Aug,1702,1637,65,3.8
Crockett County,2017-Sep,1685,1623,62,3.7
Crockett County,2017-Oct,1633,1580,53,3.2
Crockett County,2017-Nov,1592,1538,54,3.4
Crockett County,2017-Dec,1592,1540,52,3.3
Crockett County,2018-Jan,1574,1518,56,3.6
Crockett County,2018-Feb,1594,1541,53,3.3
Crockett County,2018-Mar,1629,1577,52,3.2
Crockett County,2018-Apr,1621,1575,46,2.8
Crockett County,2018-May,1621,1576,45,2.8
Crockett County,2018-Jun,1639,1586,53,3.2
Crockett County,2018-Jul,1658,1609,49,3
Crockett County,2018-Aug,1678,1629,49,2.9
Crockett County,2018-Sep,1615,1568,47,2.9
Crockett County,2018-Oct,1599,1555,44,2.8
Crockett County,2018-Nov,1600,1557,43,2.7
Crockett County,2018-Dec,1588,1547,41,2.6
Crockett County,2019-Jan,1578,1532,46,2.9
Crockett County,2019-Feb,1606,1564,42,2.6
Crockett County,2019-Mar,1616,1575,41,2.5
Crockett County,2019-Apr,1628,1594,34,2.1
Crockett County,2019-May,1628,1591,37,2.3
Crockett County,2019-Jun,1638,1591,47,2.9
Crockett County,2019-Jul,1635,1587,48,2.9
Crockett County,2019-Aug,1646,1596,50,3
Crockett County,2019-Sep,1609,1555,54,3.4
Crockett County,2019-Oct,1615,1558,57,3.5
Crockett County,2019-Nov,1582,1528,54,3.4
Crockett County,2019-Dec,1569,1511,58,3.7
Crockett County,2020-Jan,1530,1463,67,4.4
Crockett County,2020-Feb,1552,1487,65,4.2
Crockett County,2020-Mar,1562,1463,99,6.3
Crockett County,2020-Apr,1502,1342,160,10.7
Crockett County,2020-May,1563,1356,207,13.2
Crockett County,2020-Jun,1580,1392,188,11.9
Crockett County,2020-Jul,1572,1395,177,11.3
Crockett County,2020-Aug,1559,1408,151,9.7
Crockett County,2020-Sep,1537,1391,146,9.5
Crockett County,2020-Oct,1515,1393,122,8.1
Crockett County,2020-Nov,1500,1364,136,9.1
Crockett County,2020-Dec,1488,1360,128,8.6
Crockett County,2021-Jan,1473,1344,129,8.8
Crockett County,2021-Feb,1476,1353,123,8.3
Crockett County,2021-Mar,1481,1366,115,7.8
Crockett County,2021-Apr,1499,1394,105,7
Crockett County,2021-May,1518,1421,97,6.4
Crockett County,2021-Jun,1515,1402,113,7.5
Crockett County,2021-Jul,1483,1380,103,6.9
Crockett County,2021-Aug,1467,1376,91,6.2
Crockett County,2021-Sep,1449,1370,79,5.5
Crockett County,2021-Oct,1430,1349,81,5.7
Crockett County,2021-Nov,1408,1331,77,5.5
Crockett County,2021-Dec,1406,1327,79,5.6
Crockett County,2022-Jan,1394,1308,86,6.2
Crockett County,2022-Feb,1419,1338,81,5.7
Crockett County,2022-Mar,1433,1369,64,4.5
Crockett County,2022-Apr,1412,1353,59,4.2
Crockett County,2022-May,1429,1366,63,4.4
Crockett County,2022-Jun,1414,1350,64,4.5
Crockett County,2022-Jul,1410(P),1344(P),66(P),4.7(P)
Crosby County,2012-Jan,2875,2633,242,8.4
Crosby County,2012-Feb,2847,2611,236,8.3
Crosby County,2012-Mar,2867,2650,217,7.6
Crosby County,2012-Apr,2918,2714,204,7
Crosby County,2012-May,2930,2718,212,7.2
Crosby County,2012-Jun,2991,2757,234,7.8
Crosby County,2012-Jul,2967,2742,225,7.6
Crosby County,2012-Aug,2923,2715,208,7.1
Crosby County,2012-Sep,2930,2739,191,6.5
Crosby County,2012-Oct,2886,2713,173,6
Crosby County,2012-Nov,2882,2712,170,5.9
Crosby County,2012-Dec,2823,2654,169,6
Crosby County,2013-Jan,2687,2489,198,7.4
Crosby County,2013-Feb,2703,2514,189,7
Crosby County,2013-Mar,2678,2495,183,6.8
Crosby County,2013-Apr,2756,2591,165,6
Crosby County,2013-May,2801,2634,167,6
Crosby County,2013-Jun,2841,2656,185,6.5
Crosby County,2013-Jul,2860,2683,177,6.2
Crosby County,2013-Aug,2776,2619,157,5.7
Crosby County,2013-Sep,2803,2648,155,5.5
Crosby County,2013-Oct,2787,2643,144,5.2
Crosby County,2013-Nov,2705,2574,131,4.8
Crosby County,2013-Dec,2734,2611,123,4.5
Crosby County,2014-Jan,2615,2483,132,5
Crosby County,2014-Feb,2700,2564,136,5
Crosby County,2014-Mar,2715,2575,140,5.2
Crosby County,2014-Apr,2737,2617,120,4.4
Crosby County,2014-May,2765,2638,127,4.6
Crosby County,2014-Jun,2754,2615,139,5
Crosby County,2014-Jul,2741,2599,142,5.2
Crosby County,2014-Aug,2678,2546,132,4.9
Crosby County,2014-Sep,2698,2570,128,4.7
Crosby County,2014-Oct,2691,2574,117,4.3
Crosby County,2014-Nov,2641,2526,115,4.4
Crosby County,2014-Dec,2592,2487,105,4.1
Crosby County,2015-Jan,2597,2469,128,4.9
Crosby County,2015-Feb,2680,2553,127,4.7
Crosby County,2015-Mar,2727,2605,122,4.5
Crosby County,2015-Apr,2681,2570,111,4.1
Crosby County,2015-May,2720,2602,118,4.3
Crosby County,2015-Jun,2713,2579,134,4.9
Crosby County,2015-Jul,2662,2532,130,4.9
Crosby County,2015-Aug,2601,2486,115,4.4
Crosby County,2015-Sep,2624,2516,108,4.1
Crosby County,2015-Oct,2627,2525,102,3.9
Crosby County,2015-Nov,2569,2471,98,3.8
Crosby County,2015-Dec,2582,2488,94,3.6
Crosby County,2016-Jan,2471,2371,100,4
Crosby County,2016-Feb,2637,2531,106,4
Crosby County,2016-Mar,2690,2583,107,4
Crosby County,2016-Apr,2701,2595,106,3.9
Crosby County,2016-May,2757,2649,108,3.9
Crosby County,2016-Jun,2699,2560,139,5.2
Crosby County,2016-Jul,2600,2454,146,5.6
Crosby County,2016-Aug,2636,2506,130,4.9
Crosby County,2016-Sep,2590,2467,123,4.7
Crosby County,2016-Oct,2577,2468,109,4.2
Crosby County,2016-Nov,2566,2463,103,4
Crosby County,2016-Dec,2545,2445,100,3.9
Crosby County,2017-Jan,2440,2332,108,4.4
Crosby County,2017-Feb,2522,2399,123,4.9
Crosby County,2017-Mar,2632,2508,124,4.7
Crosby County,2017-Apr,2609,2504,105,4
Crosby County,2017-May,2613,2509,104,4
Crosby County,2017-Jun,2579,2452,127,4.9
Crosby County,2017-Jul,2486,2358,128,5.1
Crosby County,2017-Aug,2535,2414,121,4.8
Crosby County,2017-Sep,2460,2369,91,3.7
Crosby County,2017-Oct,2517,2436,81,3.2
Crosby County,2017-Nov,2468,2382,86,3.5
Crosby County,2017-Dec,2475,2388,87,3.5
Crosby County,2018-Jan,2361,2261,100,4.2
Crosby County,2018-Feb,2440,2319,121,5
Crosby County,2018-Mar,2537,2415,122,4.8
Crosby County,2018-Apr,2475,2370,105,4.2
Crosby County,2018-May,2535,2430,105,4.1
Crosby County,2018-Jun,2501,2369,132,5.3
Crosby County,2018-Jul,2460,2328,132,5.4
Crosby County,2018-Aug,2516,2391,125,5
Crosby County,2018-Sep,2475,2357,118,4.8
Crosby County,2018-Oct,2446,2337,109,4.5
Crosby County,2018-Nov,2424,2319,105,4.3
Crosby County,2018-Dec,2371,2271,100,4.2
Crosby County,2019-Jan,2332,2228,104,4.5
Crosby County,2019-Feb,2390,2293,97,4.1
Crosby County,2019-Mar,2448,2352,96,3.9
Crosby County,2019-Apr,2420,2340,80,3.3
Crosby County,2019-May,2454,2367,87,3.5
Crosby County,2019-Jun,2433,2322,111,4.6
Crosby County,2019-Jul,2442,2321,121,5
Crosby County,2019-Aug,2510,2404,106,4.2
Crosby County,2019-Sep,2435,2337,98,4
Crosby County,2019-Oct,2482,2391,91,3.7
Crosby County,2019-Nov,2396,2312,84,3.5
Crosby County,2019-Dec,2410,2332,78,3.2
Crosby County,2020-Jan,2301,2209,92,4
Crosby County,2020-Feb,2329,2247,82,3.5
Crosby County,2020-Mar,2315,2196,119,5.1
Crosby County,2020-Apr,2114,1970,144,6.8
Crosby County,2020-May,2191,2030,161,7.3
Crosby County,2020-Jun,2219,2082,137,6.2
Crosby County,2020-Jul,2262,2120,142,6.3
Crosby County,2020-Aug,2324,2213,111,4.8
Crosby County,2020-Sep,2284,2171,113,4.9
Crosby County,2020-Oct,2365,2255,110,4.7
Crosby County,2020-Nov,2307,2188,119,5.2
Crosby County,2020-Dec,2312,2185,127,5.5
Crosby County,2021-Jan,2350,2195,155,6.6
Crosby County,2021-Feb,2419,2274,145,6
Crosby County,2021-Mar,2496,2350,146,5.8
Crosby County,2021-Apr,2445,2318,127,5.2
Crosby County,2021-May,2389,2254,135,5.7
Crosby County,2021-Jun,2365,2200,165,7
Crosby County,2021-Jul,2348,2199,149,6.3
Crosby County,2021-Aug,2371,2238,133,5.6
Crosby County,2021-Sep,2376,2254,122,5.1
Crosby County,2021-Oct,2358,2242,116,4.9
Crosby County,2021-Nov,2304,2198,106,4.6
Crosby County,2021-Dec,2289,2196,93,4.1
Crosby County,2022-Jan,2314,2205,109,4.7
Crosby County,2022-Feb,2464,2357,107,4.3
Crosby County,2022-Mar,2547,2455,92,3.6
Crosby County,2022-Apr,2518,2429,89,3.5
Crosby County,2022-May,2442,2351,91,3.7
Crosby County,2022-Jun,2412,2305,107,4.4
Crosby County,2022-Jul,2530(P),2410(P),120(P),4.7(P)
Culberson County,2012-Jan,985,920,65,6.6
Culberson County,2012-Feb,984,922,62,6.3
Culberson County,2012-Mar,991,932,59,6
Culberson County,2012-Apr,980,923,57,5.8
Culberson County,2012-May,996,932,64,6.4
Culberson County,2012-Jun,1026,957,69,6.7
Culberson County,2012-Jul,1004,935,69,6.9
Culberson County,2012-Aug,986,928,58,5.9
Culberson County,2012-Sep,968,915,53,5.5
Culberson County,2012-Oct,969,915,54,5.6
Culberson County,2012-Nov,972,922,50,5.1
Culberson County,2012-Dec,980,930,50,5.1
Culberson County,2013-Jan,974,915,59,6.1
Culberson County,2013-Feb,991,937,54,5.4
Culberson County,2013-Mar,1016,963,53,5.2
Culberson County,2013-Apr,1008,959,49,4.9
Culberson County,2013-May,1019,965,54,5.3
Culberson County,2013-Jun,1045,987,58,5.6
Culberson County,2013-Jul,1046,990,56,5.4
Culberson County,2013-Aug,1058,1005,53,5
Culberson County,2013-Sep,1057,1004,53,5
Culberson County,2013-Oct,1007,957,50,5
Culberson County,2013-Nov,992,951,41,4.1
Culberson County,2013-Dec,991,951,40,4
Culberson County,2014-Jan,961,915,46,4.8
Culberson County,2014-Feb,966,918,48,5
Culberson County,2014-Mar,974,931,43,4.4
Culberson County,2014-Apr,986,949,37,3.8
Culberson County,2014-May,1030,990,40,3.9
Culberson County,2014-Jun,1053,1008,45,4.3
Culberson County,2014-Jul,1060,1012,48,4.5
Culberson County,2014-Aug,1064,1020,44,4.1
Culberson County,2014-Sep,1060,1017,43,4.1
Culberson County,2014-Oct,981,939,42,4.3
Culberson County,2014-Nov,997,960,37,3.7
Culberson County,2014-Dec,1002,963,39,3.9
Culberson County,2015-Jan,1010,967,43,4.3
Culberson County,2015-Feb,1009,968,41,4.1
Culberson County,2015-Mar,1010,965,45,4.5
Culberson County,2015-Apr,1001,955,46,4.6
Culberson County,2015-May,1010,961,49,4.9
Culberson County,2015-Jun,1034,986,48,4.6
Culberson County,2015-Jul,1059,1009,50,4.7
Culberson County,2015-Aug,1056,1017,39,3.7
Culberson County,2015-Sep,1071,1028,43,4
Culberson County,2015-Oct,1071,1033,38,3.5
Culberson County,2015-Nov,1076,1033,43,4
Culberson County,2015-Dec,1076,1038,38,3.5
Culberson County,2016-Jan,1032,995,37,3.6
Culberson County,2016-Feb,1015,976,39,3.8
Culberson County,2016-Mar,1013,974,39,3.8
Culberson County,2016-Apr,1006,968,38,3.8
Culberson County,2016-May,1012,972,40,4
Culberson County,2016-Jun,1013,970,43,4.2
Culberson County,2016-Jul,1035,991,44,4.3
Culberson County,2016-Aug,1030,983,47,4.6
Culberson County,2016-Sep,991,949,42,4.2
Culberson County,2016-Oct,941,901,40,4.3
Culberson County,2016-Nov,950,912,38,4
Culberson County,2016-Dec,960,918,42,4.4
Culberson County,2017-Jan,915,873,42,4.6
Culberson County,2017-Feb,912,868,44,4.8
Culberson County,2017-Mar,925,883,42,4.5
Culberson County,2017-Apr,906,872,34,3.8
Culberson County,2017-May,914,878,36,3.9
Culberson County,2017-Jun,919,884,35,3.8
Culberson County,2017-Jul,936,904,32,3.4
Culberson County,2017-Aug,924,891,33,3.6
Culberson County,2017-Sep,898,869,29,3.2
Culberson County,2017-Oct,919,893,26,2.8
Culberson County,2017-Nov,906,878,28,3.1
Culberson County,2017-Dec,921,895,26,2.8
Culberson County,2018-Jan,941,911,30,3.2
Culberson County,2018-Feb,949,915,34,3.6
Culberson County,2018-Mar,962,931,31,3.2
Culberson County,2018-Apr,952,927,25,2.6
Culberson County,2018-May,962,937,25,2.6
Culberson County,2018-Jun,966,935,31,3.2
Culberson County,2018-Jul,977,947,30,3.1
Culberson County,2018-Aug,983,953,30,3.1
Culberson County,2018-Sep,962,933,29,3
Culberson County,2018-Oct,970,942,28,2.9
Culberson County,2018-Nov,985,956,29,2.9
Culberson County,2018-Dec,980,946,34,3.5
Culberson County,2019-Jan,991,953,38,3.8
Culberson County,2019-Feb,982,952,30,3.1
Culberson County,2019-Mar,986,955,31,3.1
Culberson County,2019-Apr,1011,960,51,5
Culberson County,2019-May,1034,989,45,4.4
Culberson County,2019-Jun,1049,998,51,4.9
Culberson County,2019-Jul,1066,1014,52,4.9
Culberson County,2019-Aug,1061,1014,47,4.4
Culberson County,2019-Sep,1048,1003,45,4.3
Culberson County,2019-Oct,1034,991,43,4.2
Culberson County,2019-Nov,1029,989,40,3.9
Culberson County,2019-Dec,1052,1018,34,3.2
Culberson County,2020-Jan,1103,1063,40,3.6
Culberson County,2020-Feb,1136,1103,33,2.9
Culberson County,2020-Mar,1132,1083,49,4.3
Culberson County,2020-Apr,1067,986,81,7.6
Culberson County,2020-May,1114,1005,109,9.8
Culberson County,2020-Jun,1132,1030,102,9
Culberson County,2020-Jul,1169,1058,111,9.5
Culberson County,2020-Aug,1162,1075,87,7.5
Culberson County,2020-Sep,1128,1053,75,6.6
Culberson County,2020-Oct,1110,1043,67,6
Culberson County,2020-Nov,1091,1023,68,6.2
Culberson County,2020-Dec,1098,1035,63,5.7
Culberson County,2021-Jan,1077,1012,65,6
Culberson County,2021-Feb,1090,1031,59,5.4
Culberson County,2021-Mar,1092,1033,59,5.4
Culberson County,2021-Apr,1067,1015,52,4.9
Culberson County,2021-May,1050,1002,48,4.6
Culberson County,2021-Jun,1067,1011,56,5.2
Culberson County,2021-Jul,1080,1027,53,4.9
Culberson County,2021-Aug,1074,1023,51,4.7
Culberson County,2021-Sep,1066,1015,51,4.8
Culberson County,2021-Oct,1046,1001,45,4.3
Culberson County,2021-Nov,1037,995,42,4.1
Culberson County,2021-Dec,1048,1012,36,3.4
Culberson County,2022-Jan,1054,1011,43,4.1
Culberson County,2022-Feb,1080,1040,40,3.7
Culberson County,2022-Mar,1085,1054,31,2.9
Culberson County,2022-Apr,1067,1037,30,2.8
Culberson County,2022-May,1071,1037,34,3.2
Culberson County,2022-Jun,1079,1043,36,3.3
Culberson County,2022-Jul,1101(P),1067(P),34(P),3.1(P)
Dallam County,2012-Jan,3927,3766,161,4.1
Dallam County,2012-Feb,3915,3755,160,4.1
Dallam County,2012-Mar,3975,3830,145,3.6
Dallam County,2012-Apr,4062,3924,138,3.4
Dallam County,2012-May,4078,3932,146,3.6
Dallam County,2012-Jun,4180,4013,167,4
Dallam County,2012-Jul,4117,3952,165,4
Dallam County,2012-Aug,4030,3878,152,3.8
Dallam County,2012-Sep,4019,3880,139,3.5
Dallam County,2012-Oct,3992,3856,136,3.4
Dallam County,2012-Nov,3954,3828,126,3.2
Dallam County,2012-Dec,3900,3771,129,3.3
Dallam County,2013-Jan,3812,3666,146,3.8
Dallam County,2013-Feb,3784,3644,140,3.7
Dallam County,2013-Mar,3787,3655,132,3.5
Dallam County,2013-Apr,3902,3773,129,3.3
Dallam County,2013-May,3969,3830,139,3.5
Dallam County,2013-Jun,4041,3887,154,3.8
Dallam County,2013-Jul,4053,3903,150,3.7
Dallam County,2013-Aug,3941,3802,139,3.5
Dallam County,2013-Sep,3915,3773,142,3.6
Dallam County,2013-Oct,3899,3772,127,3.3
Dallam County,2013-Nov,3774,3649,125,3.3
Dallam County,2013-Dec,3800,3680,120,3.2
Dallam County,2014-Jan,3783,3659,124,3.3
Dallam County,2014-Feb,3880,3750,130,3.4
Dallam County,2014-Mar,3909,3787,122,3.1
Dallam County,2014-Apr,3952,3846,106,2.7
Dallam County,2014-May,3971,3854,117,2.9
Dallam County,2014-Jun,4039,3908,131,3.2
Dallam County,2014-Jul,4012,3879,133,3.3
Dallam County,2014-Aug,3914,3791,123,3.1
Dallam County,2014-Sep,3909,3799,110,2.8
Dallam County,2014-Oct,3864,3762,102,2.6
Dallam County,2014-Nov,3772,3673,99,2.6
Dallam County,2014-Dec,3747,3656,91,2.4
Dallam County,2015-Jan,3875,3773,102,2.6
Dallam County,2015-Feb,3952,3862,90,2.3
Dallam County,2015-Mar,4039,3957,82,2
Dallam County,2015-Apr,4040,3965,75,1.9
Dallam County,2015-May,4054,3967,87,2.1
Dallam County,2015-Jun,4090,3990,100,2.4
Dallam County,2015-Jul,4064,3966,98,2.4
Dallam County,2015-Aug,3996,3911,85,2.1
Dallam County,2015-Sep,4008,3921,87,2.2
Dallam County,2015-Oct,4036,3952,84,2.1
Dallam County,2015-Nov,3972,3884,88,2.2
Dallam County,2015-Dec,3965,3888,77,1.9
Dallam County,2016-Jan,3871,3787,84,2.2
Dallam County,2016-Feb,4023,3935,88,2.2
Dallam County,2016-Mar,4067,3984,83,2
Dallam County,2016-Apr,4061,3987,74,1.8
Dallam County,2016-May,4142,4065,77,1.9
Dallam County,2016-Jun,4080,3988,92,2.3
Dallam County,2016-Jul,3998,3894,104,2.6
Dallam County,2016-Aug,3991,3891,100,2.5
Dallam County,2016-Sep,3936,3845,91,2.3
Dallam County,2016-Oct,3978,3885,93,2.3
Dallam County,2016-Nov,3954,3863,91,2.3
Dallam County,2016-Dec,3912,3820,92,2.4
Dallam County,2017-Jan,3886,3791,95,2.4
Dallam County,2017-Feb,3951,3856,95,2.4
Dallam County,2017-Mar,4082,3996,86,2.1
Dallam County,2017-Apr,4118,4045,73,1.8
Dallam County,2017-May,4136,4051,85,2.1
Dallam County,2017-Jun,4134,4039,95,2.3
Dallam County,2017-Jul,4044,3941,103,2.5
Dallam County,2017-Aug,4050,3955,95,2.3
Dallam County,2017-Sep,3986,3904,82,2.1
Dallam County,2017-Oct,4054,3974,80,2
Dallam County,2017-Nov,3968,3888,80,2
Dallam County,2017-Dec,3935,3860,75,1.9
Dallam County,2018-Jan,3929,3848,81,2.1
Dallam County,2018-Feb,3983,3897,86,2.2
Dallam County,2018-Mar,4093,4007,86,2.1
Dallam County,2018-Apr,4040,3970,70,1.7
Dallam County,2018-May,4128,4051,77,1.9
Dallam County,2018-Jun,4097,4002,95,2.3
Dallam County,2018-Jul,4066,3974,92,2.3
Dallam County,2018-Aug,4059,3977,82,2
Dallam County,2018-Sep,3974,3896,78,2
Dallam County,2018-Oct,3936,3861,75,1.9
Dallam County,2018-Nov,3886,3806,80,2.1
Dallam County,2018-Dec,3819,3735,84,2.2
Dallam County,2019-Jan,3791,3699,92,2.4
Dallam County,2019-Feb,3870,3788,82,2.1
Dallam County,2019-Mar,3933,3858,75,1.9
Dallam County,2019-Apr,3854,3792,62,1.6
Dallam County,2019-May,3895,3831,64,1.6
Dallam County,2019-Jun,3886,3795,91,2.3
Dallam County,2019-Jul,3949,3861,88,2.2
Dallam County,2019-Aug,4000,3924,76,1.9
Dallam County,2019-Sep,3858,3786,72,1.9
Dallam County,2019-Oct,3950,3877,73,1.8
Dallam County,2019-Nov,3853,3778,75,1.9
Dallam County,2019-Dec,3857,3785,72,1.9
Dallam County,2020-Jan,3697,3615,82,2.2
Dallam County,2020-Feb,3745,3668,77,2.1
Dallam County,2020-Mar,3709,3591,118,3.2
Dallam County,2020-Apr,3514,3418,96,2.7
Dallam County,2020-May,3614,3493,121,3.3
Dallam County,2020-Jun,3663,3536,127,3.5
Dallam County,2020-Jul,3727,3611,116,3.1
Dallam County,2020-Aug,3780,3681,99,2.6
Dallam County,2020-Sep,3734,3634,100,2.7
Dallam County,2020-Oct,3822,3732,90,2.4
Dallam County,2020-Nov,3739,3634,105,2.8
Dallam County,2020-Dec,3751,3653,98,2.6
Dallam County,2021-Jan,3809,3697,112,2.9
Dallam County,2021-Feb,3894,3776,118,3
Dallam County,2021-Mar,3951,3830,121,3.1
Dallam County,2021-Apr,3903,3810,93,2.4
Dallam County,2021-May,3800,3706,94,2.5
Dallam County,2021-Jun,3810,3687,123,3.2
Dallam County,2021-Jul,3799,3692,107,2.8
Dallam County,2021-Aug,3803,3710,93,2.4
Dallam County,2021-Sep,3767,3672,95,2.5
Dallam County,2021-Oct,3750,3660,90,2.4
Dallam County,2021-Nov,3671,3588,83,2.3
Dallam County,2021-Dec,3677,3603,74,2
Dallam County,2022-Jan,3689,3604,85,2.3
Dallam County,2022-Feb,3846,3759,87,2.3
Dallam County,2022-Mar,3943,3873,70,1.8
Dallam County,2022-Apr,3911,3850,61,1.6
Dallam County,2022-May,3806,3732,74,1.9
Dallam County,2022-Jun,3791,3701,90,2.4
Dallam County,2022-Jul,3907(P),3812(P),95(P),2.4(P)
Dallas County,2012-Jan,1208849,1115478,93371,7.7
Dallas County,2012-Feb,1215607,1123290,92317,7.6
Dallas County,2012-Mar,1213238,1126933,86305,7.1
Dallas County,2012-Apr,1214197,1132855,81342,6.7
Dallas County,2012-May,1218919,1133351,85568,7
Dallas County,2012-Jun,1224548,1131596,92952,7.6
Dallas County,2012-Jul,1225342,1132448,92894,7.6
Dallas County,2012-Aug,1220118,1131688,88430,7.2
Dallas County,2012-Sep,1223165,1140381,82784,6.8
Dallas County,2012-Oct,1226595,1145331,81264,6.6
Dallas County,2012-Nov,1226739,1148003,78736,6.4
Dallas County,2012-Dec,1226412,1146062,80350,6.6
Dallas County,2013-Jan,1217809,1128066,89743,7.4
Dallas County,2013-Feb,1218935,1132951,85984,7.1
Dallas County,2013-Mar,1218088,1135760,82328,6.8
Dallas County,2013-Apr,1224001,1144853,79148,6.5
Dallas County,2013-May,1228053,1146329,81724,6.7
Dallas County,2013-Jun,1235731,1147377,88354,7.1
Dallas County,2013-Jul,1239571,1153990,85581,6.9
Dallas County,2013-Aug,1239086,1156884,82202,6.6
Dallas County,2013-Sep,1242181,1160416,81765,6.6
Dallas County,2013-Oct,1236193,1157120,79073,6.4
Dallas County,2013-Nov,1247696,1172345,75351,6
Dallas County,2013-Dec,1242795,1171865,70930,5.7
Dallas County,2014-Jan,1233458,1158089,75369,6.1
Dallas County,2014-Feb,1238194,1162273,75921,6.1
Dallas County,2014-Mar,1241062,1168431,72631,5.9
Dallas County,2014-Apr,1241245,1176363,64882,5.2
Dallas County,2014-May,1243718,1175353,68365,5.5
Dallas County,2014-Jun,1250257,1177923,72334,5.8
Dallas County,2014-Jul,1257205,1182900,74305,5.9
Dallas County,2014-Aug,1255940,1183474,72466,5.8
Dallas County,2014-Sep,1254952,1187818,67134,5.3
Dallas County,2014-Oct,1257190,1194511,62679,5
Dallas County,2014-Nov,1262056,1200517,61539,4.9
Dallas County,2014-Dec,1256036,1199980,56056,4.5
Dallas County,2015-Jan,1247270,1184967,62303,5
Dallas County,2015-Feb,1247677,1189575,58102,4.7
Dallas County,2015-Mar,1244318,1189252,55066,4.4
Dallas County,2015-Apr,1254913,1204415,50498,4
Dallas County,2015-May,1258594,1205800,52794,4.2
Dallas County,2015-Jun,1263661,1206994,56667,4.5
Dallas County,2015-Jul,1270201,1212771,57430,4.5
Dallas County,2015-Aug,1269585,1215366,54219,4.3
Dallas County,2015-Sep,1267101,1213433,53668,4.2
Dallas County,2015-Oct,1273667,1221090,52577,4.1
Dallas County,2015-Nov,1281470,1229426,52044,4.1
Dallas County,2015-Dec,1281312,1232586,48726,3.8
Dallas County,2016-Jan,1273227,1221376,51851,4.1
Dallas County,2016-Feb,1283724,1232305,51419,4
Dallas County,2016-Mar,1284623,1233142,51481,4
Dallas County,2016-Apr,1288355,1240406,47949,3.7
Dallas County,2016-May,1288467,1240706,47761,3.7
Dallas County,2016-Jun,1297705,1242618,55087,4.2
Dallas County,2016-Jul,1307160,1250483,56677,4.3
Dallas County,2016-Aug,1307058,1251805,55253,4.2
Dallas County,2016-Sep,1310263,1254690,55573,4.2
Dallas County,2016-Oct,1312223,1259845,52378,4
Dallas County,2016-Nov,1318851,1267767,51084,3.9
Dallas County,2016-Dec,1317958,1266628,51330,3.9
Dallas County,2017-Jan,1299654,1243045,56609,4.4
Dallas County,2017-Feb,1308788,1250623,58165,4.4
Dallas County,2017-Mar,1307003,1252148,54855,4.2
Dallas County,2017-Apr,1312405,1261955,50450,3.8
Dallas County,2017-May,1307565,1257051,50514,3.9
Dallas County,2017-Jun,1315381,1260673,54708,4.2
Dallas County,2017-Jul,1322950,1268856,54094,4.1
Dallas County,2017-Aug,1322562,1267636,54926,4.2
Dallas County,2017-Sep,1327467,1277860,49607,3.7
Dallas County,2017-Oct,1321765,1275710,46055,3.5
Dallas County,2017-Nov,1331520,1283519,48001,3.6
Dallas County,2017-Dec,1327676,1280809,46867,3.5
Dallas County,2018-Jan,1309312,1256657,52655,4
Dallas County,2018-Feb,1320654,1266913,53741,4.1
Dallas County,2018-Mar,1314590,1263076,51514,3.9
Dallas County,2018-Apr,1317971,1269939,48032,3.6
Dallas County,2018-May,1315570,1268400,47170,3.6
Dallas County,2018-Jun,1326862,1271382,55480,4.2
Dallas County,2018-Jul,1332595,1278104,54491,4.1
Dallas County,2018-Aug,1322531,1270273,52258,4
Dallas County,2018-Sep,1324506,1274347,50159,3.8
Dallas County,2018-Oct,1330205,1282547,47658,3.6
Dallas County,2018-Nov,1335966,1288847,47119,3.5
Dallas County,2018-Dec,1336637,1288910,47727,3.6
Dallas County,2019-Jan,1314450,1259379,55071,4.2
Dallas County,2019-Feb,1318050,1267560,50490,3.8
Dallas County,2019-Mar,1312528,1265885,46643,3.6
Dallas County,2019-Apr,1313269,1272025,41244,3.1
Dallas County,2019-May,1312907,1271012,41895,3.2
Dallas County,2019-Jun,1325627,1275798,49829,3.8
Dallas County,2019-Jul,1334544,1283728,50816,3.8
Dallas County,2019-Aug,1332749,1283819,48930,3.7
Dallas County,2019-Sep,1336302,1290595,45707,3.4
Dallas County,2019-Oct,1344542,1300106,44436,3.3
Dallas County,2019-Nov,1349900,1306082,43818,3.2
Dallas County,2019-Dec,1346706,1305894,40812,3
Dallas County,2020-Jan,1320572,1275096,45476,3.4
Dallas County,2020-Feb,1328130,1284552,43578,3.3
Dallas County,2020-Mar,1303577,1235446,68131,5.2
Dallas County,2020-Apr,1248932,1091448,157484,12.6
Dallas County,2020-May,1296320,1134938,161382,12.4
Dallas County,2020-Jun,1316723,1171321,145402,11
Dallas County,2020-Jul,1325789,1193343,132446,10
Dallas County,2020-Aug,1335105,1227300,107805,8.1
Dallas County,2020-Sep,1338027,1234811,103216,7.7
Dallas County,2020-Oct,1348177,1258539,89638,6.6
Dallas County,2020-Nov,1354812,1263517,91295,6.7
Dallas County,2020-Dec,1355109,1265218,89891,6.6
Dallas County,2021-Jan,1350843,1257497,93346,6.9
Dallas County,2021-Feb,1358908,1266823,92085,6.8
Dallas County,2021-Mar,1357249,1268693,88556,6.5
Dallas County,2021-Apr,1360996,1280123,80873,5.9
Dallas County,2021-May,1359635,1283458,76177,5.6
Dallas County,2021-Jun,1367700,1282395,85305,6.2
Dallas County,2021-Jul,1375692,1296910,78782,5.7
Dallas County,2021-Aug,1377190,1303000,74190,5.4
Dallas County,2021-Sep,1377498,1309349,68149,4.9
Dallas County,2021-Oct,1385292,1320749,64543,4.7
Dallas County,2021-Nov,1400372,1339408,60964,4.4
Dallas County,2021-Dec,1395947,1339969,55978,4
Dallas County,2022-Jan,1401272,1337801,63471,4.5
Dallas County,2022-Feb,1414338,1351349,62989,4.5
Dallas County,2022-Mar,1414711,1362991,51720,3.7
Dallas County,2022-Apr,1416167,1367277,48890,3.5
Dallas County,2022-May,1426273,1375210,51063,3.6
Dallas County,2022-Jun,1431325,1373261,58064,4.1
Dallas County,2022-Jul,1431282(P),1373463(P),57819(P),4.0(P)
Dawson County,2012-Jan,5065,4707,358,7.1
Dawson County,2012-Feb,5016,4651,365,7.3
Dawson County,2012-Mar,5031,4700,331,6.6
Dawson County,2012-Apr,5053,4736,317,6.3
Dawson County,2012-May,5085,4753,332,6.5
Dawson County,2012-Jun,5165,4806,359,7
Dawson County,2012-Jul,5067,4719,348,6.9
Dawson County,2012-Aug,4972,4647,325,6.5
Dawson County,2012-Sep,5060,4756,304,6
Dawson County,2012-Oct,5080,4806,274,5.4
Dawson County,2012-Nov,5100,4828,272,5.3
Dawson County,2012-Dec,5117,4829,288,5.6
Dawson County,2013-Jan,4998,4661,337,6.7
Dawson County,2013-Feb,4934,4607,327,6.6
Dawson County,2013-Mar,4912,4604,308,6.3
Dawson County,2013-Apr,4888,4591,297,6.1
Dawson County,2013-May,4945,4609,336,6.8
Dawson County,2013-Jun,5017,4642,375,7.5
Dawson County,2013-Jul,4990,4639,351,7
Dawson County,2013-Aug,4902,4568,334,6.8
Dawson County,2013-Sep,5040,4707,333,6.6
Dawson County,2013-Oct,5081,4778,303,6
Dawson County,2013-Nov,5062,4776,286,5.6
Dawson County,2013-Dec,5123,4853,270,5.3
Dawson County,2014-Jan,4923,4652,271,5.5
Dawson County,2014-Feb,4975,4683,292,5.9
Dawson County,2014-Mar,4964,4695,269,5.4
Dawson County,2014-Apr,4840,4609,231,4.8
Dawson County,2014-May,4893,4646,247,5
Dawson County,2014-Jun,4881,4616,265,5.4
Dawson County,2014-Jul,4792,4532,260,5.4
Dawson County,2014-Aug,4744,4503,241,5.1
Dawson County,2014-Sep,4865,4643,222,4.6
Dawson County,2014-Oct,4953,4740,213,4.3
Dawson County,2014-Nov,4957,4752,205,4.1
Dawson County,2014-Dec,4914,4737,177,3.6
Dawson County,2015-Jan,4836,4616,220,4.5
Dawson County,2015-Feb,4838,4616,222,4.6
Dawson County,2015-Mar,4836,4618,218,4.5
Dawson County,2015-Apr,4809,4603,206,4.3
Dawson County,2015-May,4852,4634,218,4.5
Dawson County,2015-Jun,4846,4612,234,4.8
Dawson County,2015-Jul,4763,4526,237,5
Dawson County,2015-Aug,4707,4486,221,4.7
Dawson County,2015-Sep,4707,4485,222,4.7
Dawson County,2015-Oct,4714,4503,211,4.5
Dawson County,2015-Nov,4693,4484,209,4.5
Dawson County,2015-Dec,4691,4492,199,4.2
Dawson County,2016-Jan,4464,4266,198,4.4
Dawson County,2016-Feb,4573,4368,205,4.5
Dawson County,2016-Mar,4636,4408,228,4.9
Dawson County,2016-Apr,4756,4521,235,4.9
Dawson County,2016-May,4793,4561,232,4.8
Dawson County,2016-Jun,4737,4478,259,5.5
Dawson County,2016-Jul,4616,4351,265,5.7
Dawson County,2016-Aug,4631,4366,265,5.7
Dawson County,2016-Sep,4602,4347,255,5.5
Dawson County,2016-Oct,4616,4388,228,4.9
Dawson County,2016-Nov,4643,4428,215,4.6
Dawson County,2016-Dec,4641,4424,217,4.7
Dawson County,2017-Jan,4603,4361,242,5.3
Dawson County,2017-Feb,4639,4388,251,5.4
Dawson County,2017-Mar,4727,4487,240,5.1
Dawson County,2017-Apr,4732,4477,255,5.4
Dawson County,2017-May,4708,4475,233,4.9
Dawson County,2017-Jun,4693,4440,253,5.4
Dawson County,2017-Jul,4571,4333,238,5.2
Dawson County,2017-Aug,4541,4311,230,5.1
Dawson County,2017-Sep,4450,4250,200,4.5
Dawson County,2017-Oct,4474,4295,179,4
Dawson County,2017-Nov,4512,4321,191,4.2
Dawson County,2017-Dec,4513,4330,183,4.1
Dawson County,2018-Jan,4495,4301,194,4.3
Dawson County,2018-Feb,4509,4305,204,4.5
Dawson County,2018-Mar,4556,4364,192,4.2
Dawson County,2018-Apr,4563,4376,187,4.1
Dawson County,2018-May,4620,4441,179,3.9
Dawson County,2018-Jun,4606,4387,219,4.8
Dawson County,2018-Jul,4559,4350,209,4.6
Dawson County,2018-Aug,4476,4258,218,4.9
Dawson County,2018-Sep,4454,4245,209,4.7
Dawson County,2018-Oct,4467,4279,188,4.2
Dawson County,2018-Nov,4485,4311,174,3.9
Dawson County,2018-Dec,4447,4271,176,4
Dawson County,2019-Jan,4605,4408,197,4.3
Dawson County,2019-Feb,4624,4439,185,4
Dawson County,2019-Mar,4663,4494,169,3.6
Dawson County,2019-Apr,4536,4383,153,3.4
Dawson County,2019-May,4584,4414,170,3.7
Dawson County,2019-Jun,4543,4356,187,4.1
Dawson County,2019-Jul,4569,4376,193,4.2
Dawson County,2019-Aug,4591,4407,184,4
Dawson County,2019-Sep,4519,4335,184,4.1
Dawson County,2019-Oct,4533,4364,169,3.7
Dawson County,2019-Nov,4502,4328,174,3.9
Dawson County,2019-Dec,4532,4364,168,3.7
Dawson County,2020-Jan,4531,4328,203,4.5
Dawson County,2020-Feb,4517,4323,194,4.3
Dawson County,2020-Mar,4483,4197,286,6.4
Dawson County,2020-Apr,4269,3845,424,9.9
Dawson County,2020-May,4473,3930,543,12.1
Dawson County,2020-Jun,4512,3976,536,11.9
Dawson County,2020-Jul,4585,4073,512,11.2
Dawson County,2020-Aug,4618,4192,426,9.2
Dawson County,2020-Sep,4571,4148,423,9.3
Dawson County,2020-Oct,4669,4272,397,8.5
Dawson County,2020-Nov,4646,4242,404,8.7
Dawson County,2020-Dec,4620,4214,406,8.8
Dawson County,2021-Jan,4698,4282,416,8.9
Dawson County,2021-Feb,4704,4310,394,8.4
Dawson County,2021-Mar,4789,4418,371,7.7
Dawson County,2021-Apr,4736,4402,334,7.1
Dawson County,2021-May,4579,4271,308,6.7
Dawson County,2021-Jun,4583,4235,348,7.6
Dawson County,2021-Jul,4535,4211,324,7.1
Dawson County,2021-Aug,4564,4261,303,6.6
Dawson County,2021-Sep,4511,4224,287,6.4
Dawson County,2021-Oct,4514,4237,277,6.1
Dawson County,2021-Nov,4499,4236,263,5.8
Dawson County,2021-Dec,4460,4223,237,5.3
Dawson County,2022-Jan,4522,4254,268,5.9
Dawson County,2022-Feb,4625,4360,265,5.7
Dawson County,2022-Mar,4717,4501,216,4.6
Dawson County,2022-Apr,4597,4388,209,4.5
Dawson County,2022-May,4496,4284,212,4.7
Dawson County,2022-Jun,4480,4245,235,5.2
Dawson County,2022-Jul,4556(P),4318(P),238(P),5.2(P)
Deaf Smith County,2012-Jan,9146,8664,482,5.3
Deaf Smith County,2012-Feb,9048,8572,476,5.3
Deaf Smith County,2012-Mar,9123,8701,422,4.6
Deaf Smith County,2012-Apr,9305,8898,407,4.4
Deaf Smith County,2012-May,9378,8950,428,4.6
Deaf Smith County,2012-Jun,9620,9140,480,5
Deaf Smith County,2012-Jul,9527,9037,490,5.1
Deaf Smith County,2012-Aug,9388,8955,433,4.6
Deaf Smith County,2012-Sep,9477,9073,404,4.3
Deaf Smith County,2012-Oct,9316,8915,401,4.3
Deaf Smith County,2012-Nov,9224,8837,387,4.2
Deaf Smith County,2012-Dec,9095,8690,405,4.5
Deaf Smith County,2013-Jan,8883,8424,459,5.2
Deaf Smith County,2013-Feb,8892,8453,439,4.9
Deaf Smith County,2013-Mar,8873,8470,403,4.5
Deaf Smith County,2013-Apr,9146,8753,393,4.3
Deaf Smith County,2013-May,9230,8820,410,4.4
Deaf Smith County,2013-Jun,9432,8963,469,5
Deaf Smith County,2013-Jul,9499,9055,444,4.7
Deaf Smith County,2013-Aug,9251,8844,407,4.4
Deaf Smith County,2013-Sep,9237,8836,401,4.3
Deaf Smith County,2013-Oct,9194,8818,376,4.1
Deaf Smith County,2013-Nov,8952,8578,374,4.2
Deaf Smith County,2013-Dec,9053,8703,350,3.9
Deaf Smith County,2014-Jan,8867,8505,362,4.1
Deaf Smith County,2014-Feb,9115,8742,373,4.1
Deaf Smith County,2014-Mar,9106,8749,357,3.9
Deaf Smith County,2014-Apr,9191,8896,295,3.2
Deaf Smith County,2014-May,9279,8949,330,3.6
Deaf Smith County,2014-Jun,9323,8951,372,4
Deaf Smith County,2014-Jul,9199,8816,383,4.2
Deaf Smith County,2014-Aug,9119,8771,348,3.8
Deaf Smith County,2014-Sep,9128,8806,322,3.5
Deaf Smith County,2014-Oct,9088,8785,303,3.3
Deaf Smith County,2014-Nov,8887,8598,289,3.3
Deaf Smith County,2014-Dec,8815,8548,267,3
Deaf Smith County,2015-Jan,8642,8331,311,3.6
Deaf Smith County,2015-Feb,8893,8592,301,3.4
Deaf Smith County,2015-Mar,9008,8723,285,3.2
Deaf Smith County,2015-Apr,8841,8586,255,2.9
Deaf Smith County,2015-May,9014,8741,273,3
Deaf Smith County,2015-Jun,9046,8743,303,3.3
Deaf Smith County,2015-Jul,8821,8529,292,3.3
Deaf Smith County,2015-Aug,8660,8390,270,3.1
Deaf Smith County,2015-Sep,8720,8442,278,3.2
Deaf Smith County,2015-Oct,8739,8477,262,3
Deaf Smith County,2015-Nov,8575,8311,264,3.1
Deaf Smith County,2015-Dec,8605,8349,256,3
Deaf Smith County,2016-Jan,8298,8025,273,3.3
Deaf Smith County,2016-Feb,8716,8449,267,3.1
Deaf Smith County,2016-Mar,8914,8639,275,3.1
Deaf Smith County,2016-Apr,8904,8673,231,2.6
Deaf Smith County,2016-May,8996,8758,238,2.6
Deaf Smith County,2016-Jun,8837,8549,288,3.3
Deaf Smith County,2016-Jul,8545,8255,290,3.4
Deaf Smith County,2016-Aug,8677,8388,289,3.3
Deaf Smith County,2016-Sep,8507,8217,290,3.4
Deaf Smith County,2016-Oct,8357,8093,264,3.2
Deaf Smith County,2016-Nov,8330,8068,262,3.1
Deaf Smith County,2016-Dec,8280,8013,267,3.2
Deaf Smith County,2017-Jan,8117,7836,281,3.5
Deaf Smith County,2017-Feb,8289,7989,300,3.6
Deaf Smith County,2017-Mar,8557,8278,279,3.3
Deaf Smith County,2017-Apr,8520,8275,245,2.9
Deaf Smith County,2017-May,8539,8290,249,2.9
Deaf Smith County,2017-Jun,8474,8192,282,3.3
Deaf Smith County,2017-Jul,8198,7915,283,3.5
Deaf Smith County,2017-Aug,8296,8040,256,3.1
Deaf Smith County,2017-Sep,8074,7849,225,2.8
Deaf Smith County,2017-Oct,8227,8026,201,2.4
Deaf Smith County,2017-Nov,8028,7804,224,2.8
Deaf Smith County,2017-Dec,8122,7892,230,2.8
Deaf Smith County,2018-Jan,8087,7842,245,3
Deaf Smith County,2018-Feb,8264,8016,248,3
Deaf Smith County,2018-Mar,8583,8335,248,2.9
Deaf Smith County,2018-Apr,8356,8139,217,2.6
Deaf Smith County,2018-May,8538,8328,210,2.5
Deaf Smith County,2018-Jun,8494,8222,272,3.2
Deaf Smith County,2018-Jul,8381,8118,263,3.1
Deaf Smith County,2018-Aug,8510,8274,236,2.8
Deaf Smith County,2018-Sep,8357,8127,230,2.8
Deaf Smith County,2018-Oct,8270,8054,216,2.6
Deaf Smith County,2018-Nov,8201,7986,215,2.6
Deaf Smith County,2018-Dec,8080,7857,223,2.8
Deaf Smith County,2019-Jan,7990,7737,253,3.2
Deaf Smith County,2019-Feb,8194,7955,239,2.9
Deaf Smith County,2019-Mar,8329,8097,232,2.8
Deaf Smith County,2019-Apr,8276,8079,197,2.4
Deaf Smith County,2019-May,8379,8182,197,2.4
Deaf Smith County,2019-Jun,8373,8110,263,3.1
Deaf Smith County,2019-Jul,8372,8102,270,3.2
Deaf Smith County,2019-Aug,8540,8303,237,2.8
Deaf Smith County,2019-Sep,8416,8191,225,2.7
Deaf Smith County,2019-Oct,8506,8298,208,2.4
Deaf Smith County,2019-Nov,8318,8100,218,2.6
Deaf Smith County,2019-Dec,8320,8122,198,2.4
Deaf Smith County,2020-Jan,8349,8129,220,2.6
Deaf Smith County,2020-Feb,8529,8313,216,2.5
Deaf Smith County,2020-Mar,8511,8186,325,3.8
Deaf Smith County,2020-Apr,8139,7829,310,3.8
Deaf Smith County,2020-May,8220,7895,325,4
Deaf Smith County,2020-Jun,8379,8020,359,4.3
Deaf Smith County,2020-Jul,8489,8140,349,4.1
Deaf Smith County,2020-Aug,8643,8349,294,3.4
Deaf Smith County,2020-Sep,8432,8146,286,3.4
Deaf Smith County,2020-Oct,8627,8334,293,3.4
Deaf Smith County,2020-Nov,8428,8105,323,3.8
Deaf Smith County,2020-Dec,8411,8066,345,4.1
Deaf Smith County,2021-Jan,8626,8270,356,4.1
Deaf Smith County,2021-Feb,8894,8526,368,4.1
Deaf Smith County,2021-Mar,9134,8757,377,4.1
Deaf Smith County,2021-Apr,8931,8620,311,3.5
Deaf Smith County,2021-May,8681,8388,293,3.4
Deaf Smith County,2021-Jun,8732,8359,373,4.3
Deaf Smith County,2021-Jul,8710,8380,330,3.8
Deaf Smith County,2021-Aug,8794,8480,314,3.6
Deaf Smith County,2021-Sep,8783,8481,302,3.4
Deaf Smith County,2021-Oct,8692,8403,289,3.3
Deaf Smith County,2021-Nov,8534,8260,274,3.2
Deaf Smith County,2021-Dec,8472,8220,252,3
Deaf Smith County,2022-Jan,8654,8359,295,3.4
Deaf Smith County,2022-Feb,9108,8813,295,3.2
Deaf Smith County,2022-Mar,9380,9142,238,2.5
Deaf Smith County,2022-Apr,9206,8983,223,2.4
Deaf Smith County,2022-May,8977,8742,235,2.6
Deaf Smith County,2022-Jun,8975,8680,295,3.3
Deaf Smith County,2022-Jul,9253(P),8968(P),285(P),3.1(P)
Delta County,2012-Jan,2546,2352,194,7.6
Delta County,2012-Feb,2585,2392,193,7.5
Delta County,2012-Mar,2599,2426,173,6.7
Delta County,2012-Apr,2587,2427,160,6.2
Delta County,2012-May,2613,2439,174,6.7
Delta County,2012-Jun,2643,2453,190,7.2
Delta County,2012-Jul,2599,2418,181,7
Delta County,2012-Aug,2626,2454,172,6.5
Delta County,2012-Sep,2675,2504,171,6.4
Delta County,2012-Oct,2640,2473,167,6.3
Delta County,2012-Nov,2654,2489,165,6.2
Delta County,2012-Dec,2650,2487,163,6.2
Delta County,2013-Jan,2584,2401,183,7.1
Delta County,2013-Feb,2610,2437,173,6.6
Delta County,2013-Mar,2616,2454,162,6.2
Delta County,2013-Apr,2622,2459,163,6.2
Delta County,2013-May,2657,2478,179,6.7
Delta County,2013-Jun,2679,2493,186,6.9
Delta County,2013-Jul,2628,2455,173,6.6
Delta County,2013-Aug,2630,2460,170,6.5
Delta County,2013-Sep,2662,2495,167,6.3
Delta County,2013-Oct,2630,2464,166,6.3
Delta County,2013-Nov,2622,2475,147,5.6
Delta County,2013-Dec,2626,2485,141,5.4
Delta County,2014-Jan,2607,2459,148,5.7
Delta County,2014-Feb,2674,2500,174,6.5
Delta County,2014-Mar,2685,2519,166,6.2
Delta County,2014-Apr,2682,2527,155,5.8
Delta County,2014-May,2676,2513,163,6.1
Delta County,2014-Jun,2678,2508,170,6.3
Delta County,2014-Jul,2650,2475,175,6.6
Delta County,2014-Aug,2634,2457,177,6.7
Delta County,2014-Sep,2658,2486,172,6.5
Delta County,2014-Oct,2633,2478,155,5.9
Delta County,2014-Nov,2617,2469,148,5.7
Delta County,2014-Dec,2591,2454,137,5.3
Delta County,2015-Jan,2576,2433,143,5.6
Delta County,2015-Feb,2613,2479,134,5.1
Delta County,2015-Mar,2610,2487,123,4.7
Delta County,2015-Apr,2582,2464,118,4.6
Delta County,2015-May,2596,2474,122,4.7
Delta County,2015-Jun,2605,2480,125,4.8
Delta County,2015-Jul,2594,2469,125,4.8
Delta County,2015-Aug,2581,2467,114,4.4
Delta County,2015-Sep,2603,2492,111,4.3
Delta County,2015-Oct,2597,2491,106,4.1
Delta County,2015-Nov,2593,2486,107,4.1
Delta County,2015-Dec,2580,2486,94,3.6
Delta County,2016-Jan,2560,2459,101,3.9
Delta County,2016-Feb,2618,2522,96,3.7
Delta County,2016-Mar,2653,2557,96,3.6
Delta County,2016-Apr,2606,2520,86,3.3
Delta County,2016-May,2611,2521,90,3.4
Delta County,2016-Jun,2586,2484,102,3.9
Delta County,2016-Jul,2597,2487,110,4.2
Delta County,2016-Aug,2614,2506,108,4.1
Delta County,2016-Sep,2615,2509,106,4.1
Delta County,2016-Oct,2602,2510,92,3.5
Delta County,2016-Nov,2612,2514,98,3.8
Delta County,2016-Dec,2611,2512,99,3.8
Delta County,2017-Jan,2582,2475,107,4.1
Delta County,2017-Feb,2592,2497,95,3.7
Delta County,2017-Mar,2609,2519,90,3.4
Delta County,2017-Apr,2559,2486,73,2.9
Delta County,2017-May,2556,2476,80,3.1
Delta County,2017-Jun,2553,2460,93,3.6
Delta County,2017-Jul,2532,2439,93,3.7
Delta County,2017-Aug,2527,2441,86,3.4
Delta County,2017-Sep,2447,2367,80,3.3
Delta County,2017-Oct,2466,2391,75,3
Delta County,2017-Nov,2462,2386,76,3.1
Delta County,2017-Dec,2456,2377,79,3.2
Delta County,2018-Jan,2444,2355,89,3.6
Delta County,2018-Feb,2471,2378,93,3.8
Delta County,2018-Mar,2446,2361,85,3.5
Delta County,2018-Apr,2412,2333,79,3.3
Delta County,2018-May,2413,2337,76,3.1
Delta County,2018-Jun,2433,2345,88,3.6
Delta County,2018-Jul,2391,2305,86,3.6
Delta County,2018-Aug,2400,2315,85,3.5
Delta County,2018-Sep,2420,2330,90,3.7
Delta County,2018-Oct,2417,2336,81,3.4
Delta County,2018-Nov,2410,2336,74,3.1
Delta County,2018-Dec,2402,2318,84,3.5
Delta County,2019-Jan,2394,2302,92,3.8
Delta County,2019-Feb,2413,2330,83,3.4
Delta County,2019-Mar,2420,2339,81,3.3
Delta County,2019-Apr,2399,2328,71,3
Delta County,2019-May,2402,2328,74,3.1
Delta County,2019-Jun,2399,2318,81,3.4
Delta County,2019-Jul,2390,2302,88,3.7
Delta County,2019-Aug,2419,2330,89,3.7
Delta County,2019-Sep,2419,2334,85,3.5
Delta County,2019-Oct,2446,2365,81,3.3
Delta County,2019-Nov,2426,2343,83,3.4
Delta County,2019-Dec,2410,2335,75,3.1
Delta County,2020-Jan,2410,2326,84,3.5
Delta County,2020-Feb,2428,2344,84,3.5
Delta County,2020-Mar,2384,2265,119,5
Delta County,2020-Apr,2225,2051,174,7.8
Delta County,2020-May,2278,2109,169,7.4
Delta County,2020-Jun,2327,2161,166,7.1
Delta County,2020-Jul,2366,2205,161,6.8
Delta County,2020-Aug,2396,2269,127,5.3
Delta County,2020-Sep,2412,2288,124,5.1
Delta County,2020-Oct,2440,2326,114,4.7
Delta County,2020-Nov,2433,2307,126,5.2
Delta County,2020-Dec,2421,2300,121,5
Delta County,2021-Jan,2432,2296,136,5.6
Delta County,2021-Feb,2458,2322,136,5.5
Delta County,2021-Mar,2470,2339,131,5.3
Delta County,2021-Apr,2458,2344,114,4.6
Delta County,2021-May,2448,2326,122,5
Delta County,2021-Jun,2432,2302,130,5.3
Delta County,2021-Jul,2419,2295,124,5.1
Delta County,2021-Aug,2428,2314,114,4.7
Delta County,2021-Sep,2449,2334,115,4.7
Delta County,2021-Oct,2455,2343,112,4.6
Delta County,2021-Nov,2446,2343,103,4.2
Delta County,2021-Dec,2427,2333,94,3.9
Delta County,2022-Jan,2438,2334,104,4.3
Delta County,2022-Feb,2486,2373,113,4.5
Delta County,2022-Mar,2501,2412,89,3.6
Delta County,2022-Apr,2465,2383,82,3.3
Delta County,2022-May,2461,2374,87,3.5
Delta County,2022-Jun,2453,2347,106,4.3
Delta County,2022-Jul,2457(P),2354(P),103(P),4.2(P)
Denton County,2012-Jan,382699,359450,23249,6.1
Denton County,2012-Feb,385148,362237,22911,5.9
Denton County,2012-Mar,385371,363472,21899,5.7
Denton County,2012-Apr,385931,365442,20489,5.3
Denton County,2012-May,387687,365959,21728,5.6
Denton County,2012-Jun,389212,365060,24152,6.2
Denton County,2012-Jul,389728,365337,24391,6.3
Denton County,2012-Aug,387751,364925,22826,5.9
Denton County,2012-Sep,388544,367429,21115,5.4
Denton County,2012-Oct,389907,369164,20743,5.3
Denton County,2012-Nov,389859,369701,20158,5.2
Denton County,2012-Dec,389765,369250,20515,5.3
Denton County,2013-Jan,393691,370371,23320,5.9
Denton County,2013-Feb,394263,372039,22224,5.6
Denton County,2013-Mar,395026,373213,21813,5.5
Denton County,2013-Apr,396338,375905,20433,5.2
Denton County,2013-May,398136,376724,21412,5.4
Denton County,2013-Jun,400995,377127,23868,6
Denton County,2013-Jul,402384,379243,23141,5.8
Denton County,2013-Aug,402139,380211,21928,5.5
Denton County,2013-Sep,402802,381290,21512,5.3
Denton County,2013-Oct,400923,380206,20717,5.2
Denton County,2013-Nov,404630,384862,19768,4.9
Denton County,2013-Dec,403408,384866,18542,4.6
Denton County,2014-Jan,407548,387475,20073,4.9
Denton County,2014-Feb,409199,388705,20494,5
Denton County,2014-Mar,410944,390878,20066,4.9
Denton County,2014-Apr,410932,393575,17357,4.2
Denton County,2014-May,411742,393378,18364,4.5
Denton County,2014-Jun,414045,394163,19882,4.8
Denton County,2014-Jul,416422,395898,20524,4.9
Denton County,2014-Aug,415922,396122,19800,4.8
Denton County,2014-Sep,415263,397174,18089,4.4
Denton County,2014-Oct,416207,399264,16943,4.1
Denton County,2014-Nov,417713,401111,16602,4
Denton County,2014-Dec,416359,401367,14992,3.6
Denton County,2015-Jan,422436,405298,17138,4.1
Denton County,2015-Feb,423344,407254,16090,3.8
Denton County,2015-Mar,422427,406820,15607,3.7
Denton County,2015-Apr,425668,411621,14047,3.3
Denton County,2015-May,426884,411968,14916,3.5
Denton County,2015-Jun,428988,412571,16417,3.8
Denton County,2015-Jul,431017,414575,16442,3.8
Denton County,2015-Aug,430908,415607,15301,3.6
Denton County,2015-Sep,429923,414859,15064,3.5
Denton County,2015-Oct,432119,417359,14760,3.4
Denton County,2015-Nov,434959,420163,14796,3.4
Denton County,2015-Dec,435349,421542,13807,3.2
Denton County,2016-Jan,442839,427844,14995,3.4
Denton County,2016-Feb,446755,431849,14906,3.3
Denton County,2016-Mar,447190,431893,15297,3.4
Denton County,2016-Apr,448033,434177,13856,3.1
Denton County,2016-May,448282,434337,13945,3.1
Denton County,2016-Jun,451425,434782,16643,3.7
Denton County,2016-Jul,454849,437679,17170,3.8
Denton County,2016-Aug,454920,438320,16600,3.6
Denton County,2016-Sep,456322,439748,16574,3.6
Denton County,2016-Oct,456913,441268,15645,3.4
Denton County,2016-Nov,459419,444123,15296,3.3
Denton County,2016-Dec,458816,443357,15459,3.4
Denton County,2017-Jan,461076,443919,17157,3.7
Denton County,2017-Feb,464183,446558,17625,3.8
Denton County,2017-Mar,464222,447362,16860,3.6
Denton County,2017-Apr,465860,450960,14900,3.2
Denton County,2017-May,464358,449147,15211,3.3
Denton County,2017-Jun,467044,450196,16848,3.6
Denton County,2017-Jul,470013,453375,16638,3.5
Denton County,2017-Aug,469591,452998,16593,3.5
Denton County,2017-Sep,471629,456770,14859,3.2
Denton County,2017-Oct,469612,455891,13721,2.9
Denton County,2017-Nov,472925,458476,14449,3.1
Denton County,2017-Dec,471120,457117,14003,3
Denton County,2018-Jan,473073,457171,15902,3.4
Denton County,2018-Feb,477369,461143,16226,3.4
Denton County,2018-Mar,475803,459526,16277,3.4
Denton County,2018-Apr,476551,462012,14539,3.1
Denton County,2018-May,476081,461759,14322,3
Denton County,2018-Jun,479961,463030,16931,3.5
Denton County,2018-Jul,481919,465416,16503,3.4
Denton County,2018-Aug,478856,462857,15999,3.3
Denton County,2018-Sep,479729,464347,15382,3.2
Denton County,2018-Oct,481897,467405,14492,3
Denton County,2018-Nov,483970,469591,14379,3
Denton County,2018-Dec,483627,469142,14485,3
Denton County,2019-Jan,490548,473709,16839,3.4
Denton County,2019-Feb,492728,476983,15745,3.2
Denton County,2019-Mar,491616,476442,15174,3.1
Denton County,2019-Apr,491880,478972,12908,2.6
Denton County,2019-May,491791,478723,13068,2.7
Denton County,2019-Jun,496354,480508,15846,3.2
Denton County,2019-Jul,499881,483532,16349,3.3
Denton County,2019-Aug,499067,483524,15543,3.1
Denton County,2019-Sep,500802,486122,14680,2.9
Denton County,2019-Oct,504183,490119,14064,2.8
Denton County,2019-Nov,505982,492008,13974,2.8
Denton County,2019-Dec,504821,491804,13017,2.6
Denton County,2020-Jan,512247,497515,14732,2.9
Denton County,2020-Feb,515380,501123,14257,2.8
Denton County,2020-Mar,504633,482170,22463,4.5
Denton County,2020-Apr,482621,426537,56084,11.6
Denton County,2020-May,496621,443098,53523,10.8
Denton County,2020-Jun,503242,457148,46094,9.2
Denton County,2020-Jul,506156,465420,40736,8
Denton County,2020-Aug,510728,478520,32208,6.3
Denton County,2020-Sep,512148,481713,30435,5.9
Denton County,2020-Oct,517911,491359,26552,5.1
Denton County,2020-Nov,520910,493381,27529,5.3
Denton County,2020-Dec,521408,493902,27506,5.3
Denton County,2021-Jan,519479,490903,28576,5.5
Denton County,2021-Feb,522541,494555,27986,5.4
Denton County,2021-Mar,520913,494884,26029,5
Denton County,2021-Apr,523219,499539,23680,4.5
Denton County,2021-May,523457,500541,22916,4.4
Denton County,2021-Jun,526302,500162,26140,5
Denton County,2021-Jul,528980,505271,23709,4.5
Denton County,2021-Aug,529693,507605,22088,4.2
Denton County,2021-Sep,531432,510226,21206,4
Denton County,2021-Oct,534668,514974,19694,3.7
Denton County,2021-Nov,540760,522302,18458,3.4
Denton County,2021-Dec,539377,522486,16891,3.1
Denton County,2022-Jan,541779,522442,19337,3.6
Denton County,2022-Feb,547442,527912,19530,3.6
Denton County,2022-Mar,548046,532013,16033,2.9
Denton County,2022-Apr,549156,534125,15031,2.7
Denton County,2022-May,552851,536885,15966,2.9
Denton County,2022-Jun,554749,535837,18912,3.4
Denton County,2022-Jul,554494(P),535865(P),18629(P),3.4(P)
DeWitt County,2012-Jan,9583,9064,519,5.4
DeWitt County,2012-Feb,9539,9055,484,5.1
DeWitt County,2012-Mar,9611,9154,457,4.8
DeWitt County,2012-Apr,9652,9228,424,4.4
DeWitt County,2012-May,9741,9286,455,4.7
DeWitt County,2012-Jun,9875,9354,521,5.3
DeWitt County,2012-Jul,9841,9312,529,5.4
DeWitt County,2012-Aug,9807,9338,469,4.8
DeWitt County,2012-Sep,9778,9345,433,4.4
DeWitt County,2012-Oct,9752,9336,416,4.3
DeWitt County,2012-Nov,9735,9326,409,4.2
DeWitt County,2012-Dec,9699,9275,424,4.4
DeWitt County,2013-Jan,9651,9168,483,5
DeWitt County,2013-Feb,9617,9160,457,4.8
DeWitt County,2013-Mar,9609,9172,437,4.5
DeWitt County,2013-Apr,9730,9301,429,4.4
DeWitt County,2013-May,9735,9260,475,4.9
DeWitt County,2013-Jun,9826,9303,523,5.3
DeWitt County,2013-Jul,9727,9207,520,5.3
DeWitt County,2013-Aug,9703,9214,489,5
DeWitt County,2013-Sep,9624,9151,473,4.9
DeWitt County,2013-Oct,9638,9201,437,4.5
DeWitt County,2013-Nov,9671,9251,420,4.3
DeWitt County,2013-Dec,9658,9268,390,4
DeWitt County,2014-Jan,9716,9299,417,4.3
DeWitt County,2014-Feb,9766,9353,413,4.2
DeWitt County,2014-Mar,9836,9434,402,4.1
DeWitt County,2014-Apr,9936,9589,347,3.5
DeWitt County,2014-May,9994,9607,387,3.9
DeWitt County,2014-Jun,10163,9738,425,4.2
DeWitt County,2014-Jul,10150,9708,442,4.4
DeWitt County,2014-Aug,10045,9635,410,4.1
DeWitt County,2014-Sep,10055,9678,377,3.7
DeWitt County,2014-Oct,10171,9805,366,3.6
DeWitt County,2014-Nov,10108,9754,354,3.5
DeWitt County,2014-Dec,10045,9735,310,3.1
DeWitt County,2015-Jan,10196,9839,357,3.5
DeWitt County,2015-Feb,10085,9731,354,3.5
DeWitt County,2015-Mar,10121,9768,353,3.5
DeWitt County,2015-Apr,9989,9629,360,3.6
DeWitt County,2015-May,9947,9573,374,3.8
DeWitt County,2015-Jun,10111,9687,424,4.2
DeWitt County,2015-Jul,10267,9807,460,4.5
DeWitt County,2015-Aug,10148,9708,440,4.3
DeWitt County,2015-Sep,10127,9691,436,4.3
DeWitt County,2015-Oct,9973,9531,442,4.4
DeWitt County,2015-Nov,9884,9445,439,4.4
DeWitt County,2015-Dec,9830,9427,403,4.1
DeWitt County,2016-Jan,9469,9051,418,4.4
DeWitt County,2016-Feb,9557,9118,439,4.6
DeWitt County,2016-Mar,9612,9155,457,4.8
DeWitt County,2016-Apr,9706,9241,465,4.8
DeWitt County,2016-May,9532,9090,442,4.6
DeWitt County,2016-Jun,9623,9045,578,6
DeWitt County,2016-Jul,9634,9005,629,6.5
DeWitt County,2016-Aug,9540,8936,604,6.3
DeWitt County,2016-Sep,9468,8870,598,6.3
DeWitt County,2016-Oct,9411,8867,544,5.8
DeWitt County,2016-Nov,9277,8743,534,5.8
DeWitt County,2016-Dec,9200,8676,524,5.7
DeWitt County,2017-Jan,9317,8759,558,6
DeWitt County,2017-Feb,9476,8937,539,5.7
DeWitt County,2017-Mar,9494,9007,487,5.1
DeWitt County,2017-Apr,9462,9020,442,4.7
DeWitt County,2017-May,9422,9007,415,4.4
DeWitt County,2017-Jun,9563,9141,422,4.4
DeWitt County,2017-Jul,9609,9205,404,4.2
DeWitt County,2017-Aug,9585,9189,396,4.1
DeWitt County,2017-Sep,9580,9211,369,3.9
DeWitt County,2017-Oct,9592,9256,336,3.5
DeWitt County,2017-Nov,9489,9148,341,3.6
DeWitt County,2017-Dec,9551,9216,335,3.5
DeWitt County,2018-Jan,9698,9354,344,3.5
DeWitt County,2018-Feb,9711,9374,337,3.5
DeWitt County,2018-Mar,9727,9409,318,3.3
DeWitt County,2018-Apr,9694,9404,290,3
DeWitt County,2018-May,9674,9385,289,3
DeWitt County,2018-Jun,9723,9393,330,3.4
DeWitt County,2018-Jul,9733,9425,308,3.2
DeWitt County,2018-Aug,9657,9350,307,3.2
DeWitt County,2018-Sep,9553,9257,296,3.1
DeWitt County,2018-Oct,9578,9295,283,3
DeWitt County,2018-Nov,9412,9141,271,2.9
DeWitt County,2018-Dec,9400,9126,274,2.9
DeWitt County,2019-Jan,9601,9305,296,3.1
DeWitt County,2019-Feb,9611,9345,266,2.8
DeWitt County,2019-Mar,9665,9413,252,2.6
DeWitt County,2019-Apr,9590,9369,221,2.3
DeWitt County,2019-May,9554,9333,221,2.3
DeWitt County,2019-Jun,9614,9340,274,2.9
DeWitt County,2019-Jul,9735,9464,271,2.8
DeWitt County,2019-Aug,9826,9567,259,2.6
DeWitt County,2019-Sep,9727,9481,246,2.5
DeWitt County,2019-Oct,9609,9360,249,2.6
DeWitt County,2019-Nov,9495,9245,250,2.6
DeWitt County,2019-Dec,9463,9224,239,2.5
DeWitt County,2020-Jan,9288,9039,249,2.7
DeWitt County,2020-Feb,9422,9176,246,2.6
DeWitt County,2020-Mar,9268,8891,377,4.1
DeWitt County,2020-Apr,8714,8084,630,7.2
DeWitt County,2020-May,8984,8267,717,8
DeWitt County,2020-Jun,9160,8418,742,8.1
DeWitt County,2020-Jul,9239,8476,763,8.3
DeWitt County,2020-Aug,9135,8505,630,6.9
DeWitt County,2020-Sep,9040,8417,623,6.9
DeWitt County,2020-Oct,9069,8522,547,6
DeWitt County,2020-Nov,9082,8518,564,6.2
DeWitt County,2020-Dec,9140,8592,548,6
DeWitt County,2021-Jan,9268,8698,570,6.2
DeWitt County,2021-Feb,9414,8849,565,6
DeWitt County,2021-Mar,9433,8907,526,5.6
DeWitt County,2021-Apr,9362,8883,479,5.1
DeWitt County,2021-May,9280,8822,458,4.9
DeWitt County,2021-Jun,9357,8846,511,5.5
DeWitt County,2021-Jul,9538,9068,470,4.9
DeWitt County,2021-Aug,9520,9092,428,4.5
DeWitt County,2021-Sep,9508,9111,397,4.2
DeWitt County,2021-Oct,9453,9066,387,4.1
DeWitt County,2021-Nov,9421,9065,356,3.8
DeWitt County,2021-Dec,9416,9087,329,3.5
DeWitt County,2022-Jan,9483,9107,376,4
DeWitt County,2022-Feb,9669,9304,365,3.8
DeWitt County,2022-Mar,9740,9439,301,3.1
DeWitt County,2022-Apr,9567,9292,275,2.9
DeWitt County,2022-May,9443,9155,288,3
DeWitt County,2022-Jun,9496,9155,341,3.6
DeWitt County,2022-Jul,9663(P),9326(P),337(P),3.5(P)
Dickens County,2012-Jan,851,749,102,12
Dickens County,2012-Feb,835,728,107,12.8
Dickens County,2012-Mar,829,735,94,11.3
Dickens County,2012-Apr,847,760,87,10.3
Dickens County,2012-May,845,758,87,10.3
Dickens County,2012-Jun,861,767,94,10.9
Dickens County,2012-Jul,854,765,89,10.4
Dickens County,2012-Aug,829,742,87,10.5
Dickens County,2012-Sep,813,731,82,10.1
Dickens County,2012-Oct,809,733,76,9.4
Dickens County,2012-Nov,805,729,76,9.4
Dickens County,2012-Dec,797,719,78,9.8
Dickens County,2013-Jan,768,686,82,10.7
Dickens County,2013-Feb,756,680,76,10.1
Dickens County,2013-Mar,752,676,76,10.1
Dickens County,2013-Apr,766,700,66,8.6
Dickens County,2013-May,767,696,71,9.3
Dickens County,2013-Jun,804,726,78,9.7
Dickens County,2013-Jul,793,719,74,9.3
Dickens County,2013-Aug,760,689,71,9.3
Dickens County,2013-Sep,779,705,74,9.5
Dickens County,2013-Oct,781,712,69,8.8
Dickens County,2013-Nov,754,690,64,8.5
Dickens County,2013-Dec,751,692,59,7.9
Dickens County,2014-Jan,727,669,58,8
Dickens County,2014-Feb,743,686,57,7.7
Dickens County,2014-Mar,744,686,58,7.8
Dickens County,2014-Apr,748,698,50,6.7
Dickens County,2014-May,759,710,49,6.5
Dickens County,2014-Jun,767,721,46,6
Dickens County,2014-Jul,758,712,46,6.1
Dickens County,2014-Aug,734,689,45,6.1
Dickens County,2014-Sep,745,702,43,5.8
Dickens County,2014-Oct,755,713,42,5.6
Dickens County,2014-Nov,734,695,39,5.3
Dickens County,2014-Dec,706,673,33,4.7
Dickens County,2015-Jan,699,663,36,5.2
Dickens County,2015-Feb,701,668,33,4.7
Dickens County,2015-Mar,729,693,36,4.9
Dickens County,2015-Apr,728,695,33,4.5
Dickens County,2015-May,740,704,36,4.9
Dickens County,2015-Jun,734,701,33,4.5
Dickens County,2015-Jul,721,686,35,4.9
Dickens County,2015-Aug,702,668,34,4.8
Dickens County,2015-Sep,684,654,30,4.4
Dickens County,2015-Oct,677,649,28,4.1
Dickens County,2015-Nov,658,629,29,4.4
Dickens County,2015-Dec,662,635,27,4.1
Dickens County,2016-Jan,672,637,35,5.2
Dickens County,2016-Feb,694,663,31,4.5
Dickens County,2016-Mar,714,677,37,5.2
Dickens County,2016-Apr,724,693,31,4.3
Dickens County,2016-May,745,713,32,4.3
Dickens County,2016-Jun,736,697,39,5.3
Dickens County,2016-Jul,682,645,37,5.4
Dickens County,2016-Aug,679,643,36,5.3
Dickens County,2016-Sep,675,637,38,5.6
Dickens County,2016-Oct,666,634,32,4.8
Dickens County,2016-Nov,657,624,33,5
Dickens County,2016-Dec,663,632,31,4.7
Dickens County,2017-Jan,662,627,35,5.3
Dickens County,2017-Feb,672,635,37,5.5
Dickens County,2017-Mar,692,657,35,5.1
Dickens County,2017-Apr,695,661,34,4.9
Dickens County,2017-May,707,672,35,5
Dickens County,2017-Jun,696,663,33,4.7
Dickens County,2017-Jul,660,622,38,5.8
Dickens County,2017-Aug,686,647,39,5.7
Dickens County,2017-Sep,659,629,30,4.6
Dickens County,2017-Oct,664,640,24,3.6
Dickens County,2017-Nov,649,622,27,4.2
Dickens County,2017-Dec,654,628,26,4
Dickens County,2018-Jan,647,619,28,4.3
Dickens County,2018-Feb,660,629,31,4.7
Dickens County,2018-Mar,683,653,30,4.4
Dickens County,2018-Apr,686,659,27,3.9
Dickens County,2018-May,704,679,25,3.6
Dickens County,2018-Jun,694,663,31,4.5
Dickens County,2018-Jul,667,635,32,4.8
Dickens County,2018-Aug,663,634,29,4.4
Dickens County,2018-Sep,664,636,28,4.2
Dickens County,2018-Oct,654,628,26,4
Dickens County,2018-Nov,643,615,28,4.4
Dickens County,2018-Dec,634,607,27,4.3
Dickens County,2019-Jan,647,616,31,4.8
Dickens County,2019-Feb,653,622,31,4.7
Dickens County,2019-Mar,657,628,29,4.4
Dickens County,2019-Apr,672,647,25,3.7
Dickens County,2019-May,677,653,24,3.5
Dickens County,2019-Jun,691,662,29,4.2
Dickens County,2019-Jul,679,649,30,4.4
Dickens County,2019-Aug,693,663,30,4.3
Dickens County,2019-Sep,658,630,28,4.3
Dickens County,2019-Oct,673,646,27,4
Dickens County,2019-Nov,644,617,27,4.2
Dickens County,2019-Dec,652,628,24,3.7
Dickens County,2020-Jan,632,602,30,4.7
Dickens County,2020-Feb,650,626,24,3.7
Dickens County,2020-Mar,662,625,37,5.6
Dickens County,2020-Apr,640,591,49,7.7
Dickens County,2020-May,669,618,51,7.6
Dickens County,2020-Jun,673,620,53,7.9
Dickens County,2020-Jul,668,617,51,7.6
Dickens County,2020-Aug,665,628,37,5.6
Dickens County,2020-Sep,661,619,42,6.4
Dickens County,2020-Oct,666,629,37,5.6
Dickens County,2020-Nov,639,601,38,5.9
Dickens County,2020-Dec,642,601,41,6.4
Dickens County,2021-Jan,679,640,39,5.7
Dickens County,2021-Feb,683,646,37,5.4
Dickens County,2021-Mar,710,666,44,6.2
Dickens County,2021-Apr,697,660,37,5.3
Dickens County,2021-May,720,683,37,5.1
Dickens County,2021-Jun,715,675,40,5.6
Dickens County,2021-Jul,701,665,36,5.1
Dickens County,2021-Aug,706,669,37,5.2
Dickens County,2021-Sep,697,665,32,4.6
Dickens County,2021-Oct,684,655,29,4.2
Dickens County,2021-Nov,662,635,27,4.1
Dickens County,2021-Dec,659,634,25,3.8
Dickens County,2022-Jan,687,657,30,4.4
Dickens County,2022-Feb,723,692,31,4.3
Dickens County,2022-Mar,745,720,25,3.4
Dickens County,2022-Apr,743,718,25,3.4
Dickens County,2022-May,772,743,29,3.8
Dickens County,2022-Jun,768,733,35,4.6
Dickens County,2022-Jul,790(P),750(P),40(P),5.1(P)
Dimmit County,2012-Jan,5589,5240,349,6.2
Dimmit County,2012-Feb,5696,5353,343,6
Dimmit County,2012-Mar,5665,5339,326,5.8
Dimmit County,2012-Apr,5639,5338,301,5.3
Dimmit County,2012-May,5694,5379,315,5.5
Dimmit County,2012-Jun,5866,5495,371,6.3
Dimmit County,2012-Jul,5788,5408,380,6.6
Dimmit County,2012-Aug,5746,5409,337,5.9
Dimmit County,2012-Sep,5834,5527,307,5.3
Dimmit County,2012-Oct,5748,5433,315,5.5
Dimmit County,2012-Nov,5814,5497,317,5.5
Dimmit County,2012-Dec,5933,5594,339,5.7
Dimmit County,2013-Jan,6200,5832,368,5.9
Dimmit County,2013-Feb,6374,6019,355,5.6
Dimmit County,2013-Mar,6486,6151,335,5.2
Dimmit County,2013-Apr,6497,6175,322,5
Dimmit County,2013-May,6604,6246,358,5.4
Dimmit County,2013-Jun,6728,6333,395,5.9
Dimmit County,2013-Jul,6875,6494,381,5.5
Dimmit County,2013-Aug,7025,6663,362,5.2
Dimmit County,2013-Sep,7079,6762,317,4.5
Dimmit County,2013-Oct,7022,6710,312,4.4
Dimmit County,2013-Nov,7119,6816,303,4.3
Dimmit County,2013-Dec,7213,6923,290,4
Dimmit County,2014-Jan,7375,7059,316,4.3
Dimmit County,2014-Feb,7296,6969,327,4.5
Dimmit County,2014-Mar,7219,6914,305,4.2
Dimmit County,2014-Apr,7251,6985,266,3.7
Dimmit County,2014-May,7463,7182,281,3.8
Dimmit County,2014-Jun,7614,7286,328,4.3
Dimmit County,2014-Jul,7593,7262,331,4.4
Dimmit County,2014-Aug,7888,7555,333,4.2
Dimmit County,2014-Sep,7952,7676,276,3.5
Dimmit County,2014-Oct,8061,7811,250,3.1
Dimmit County,2014-Nov,7974,7721,253,3.2
Dimmit County,2014-Dec,8078,7834,244,3
Dimmit County,2015-Jan,7937,7670,267,3.4
Dimmit County,2015-Feb,7691,7416,275,3.6
Dimmit County,2015-Mar,7586,7309,277,3.7
Dimmit County,2015-Apr,7541,7255,286,3.8
Dimmit County,2015-May,7288,6995,293,4
Dimmit County,2015-Jun,7031,6679,352,5
Dimmit County,2015-Jul,6890,6534,356,5.2
Dimmit County,2015-Aug,6752,6377,375,5.6
Dimmit County,2015-Sep,6706,6338,368,5.5
Dimmit County,2015-Oct,6791,6424,367,5.4
Dimmit County,2015-Nov,6915,6521,394,5.7
Dimmit County,2015-Dec,6834,6442,392,5.7
Dimmit County,2016-Jan,6748,6333,415,6.1
Dimmit County,2016-Feb,6646,6222,424,6.4
Dimmit County,2016-Mar,6466,6002,464,7.2
Dimmit County,2016-Apr,6388,5943,445,7
Dimmit County,2016-May,6203,5764,439,7.1
Dimmit County,2016-Jun,6130,5629,501,8.2
Dimmit County,2016-Jul,6020,5512,508,8.4
Dimmit County,2016-Aug,6067,5577,490,8.1
Dimmit County,2016-Sep,6011,5561,450,7.5
Dimmit County,2016-Oct,6110,5700,410,6.7
Dimmit County,2016-Nov,6067,5667,400,6.6
Dimmit County,2016-Dec,6042,5642,400,6.6
Dimmit County,2017-Jan,6148,5737,411,6.7
Dimmit County,2017-Feb,6226,5826,400,6.4
Dimmit County,2017-Mar,6283,5903,380,6
Dimmit County,2017-Apr,6140,5790,350,5.7
Dimmit County,2017-May,6138,5825,313,5.1
Dimmit County,2017-Jun,6070,5720,350,5.8
Dimmit County,2017-Jul,6452,6118,334,5.2
Dimmit County,2017-Aug,6517,6186,331,5.1
Dimmit County,2017-Sep,6751,6463,288,4.3
Dimmit County,2017-Oct,6891,6625,266,3.9
Dimmit County,2017-Nov,6848,6582,266,3.9
Dimmit County,2017-Dec,6827,6576,251,3.7
Dimmit County,2018-Jan,6778,6506,272,4
Dimmit County,2018-Feb,6946,6693,253,3.6
Dimmit County,2018-Mar,7057,6830,227,3.2
Dimmit County,2018-Apr,7259,7057,202,2.8
Dimmit County,2018-May,7237,7033,204,2.8
Dimmit County,2018-Jun,7401,7118,283,3.8
Dimmit County,2018-Jul,7471,7218,253,3.4
Dimmit County,2018-Aug,7450,7250,200,2.7
Dimmit County,2018-Sep,7449,7257,192,2.6
Dimmit County,2018-Oct,7567,7379,188,2.5
Dimmit County,2018-Nov,7497,7315,182,2.4
Dimmit County,2018-Dec,7327,7140,187,2.6
Dimmit County,2019-Jan,7415,7206,209,2.8
Dimmit County,2019-Feb,7568,7376,192,2.5
Dimmit County,2019-Mar,7512,7333,179,2.4
Dimmit County,2019-Apr,7482,7326,156,2.1
Dimmit County,2019-May,7421,7259,162,2.2
Dimmit County,2019-Jun,7290,7073,217,3
Dimmit County,2019-Jul,7886,7666,220,2.8
Dimmit County,2019-Aug,7254,7061,193,2.7
Dimmit County,2019-Sep,7178,7000,178,2.5
Dimmit County,2019-Oct,7174,6991,183,2.6
Dimmit County,2019-Nov,7065,6884,181,2.6
Dimmit County,2019-Dec,7011,6840,171,2.4
Dimmit County,2020-Jan,7104,6910,194,2.7
Dimmit County,2020-Feb,7083,6889,194,2.7
Dimmit County,2020-Mar,6914,6636,278,4
Dimmit County,2020-Apr,6311,5870,441,7
Dimmit County,2020-May,6355,5803,552,8.7
Dimmit County,2020-Jun,6311,5736,575,9.1
Dimmit County,2020-Jul,6246,5702,544,8.7
Dimmit County,2020-Aug,6170,5725,445,7.2
Dimmit County,2020-Sep,6138,5716,422,6.9
Dimmit County,2020-Oct,6175,5763,412,6.7
Dimmit County,2020-Nov,6139,5706,433,7.1
Dimmit County,2020-Dec,6191,5768,423,6.8
Dimmit County,2021-Jan,5718,5307,411,7.2
Dimmit County,2021-Feb,5776,5361,415,7.2
Dimmit County,2021-Mar,5788,5403,385,6.7
Dimmit County,2021-Apr,5892,5539,353,6
Dimmit County,2021-May,5835,5509,326,5.6
Dimmit County,2021-Jun,5845,5460,385,6.6
Dimmit County,2021-Jul,5867,5532,335,5.7
Dimmit County,2021-Aug,5895,5589,306,5.2
Dimmit County,2021-Sep,5865,5581,284,4.8
Dimmit County,2021-Oct,5889,5605,284,4.8
Dimmit County,2021-Nov,5816,5557,259,4.5
Dimmit County,2021-Dec,5766,5517,249,4.3
Dimmit County,2022-Jan,5715,5440,275,4.8
Dimmit County,2022-Feb,5758,5499,259,4.5
Dimmit County,2022-Mar,5744,5530,214,3.7
Dimmit County,2022-Apr,5638,5408,230,4.1
Dimmit County,2022-May,5612,5375,237,4.2
Dimmit County,2022-Jun,5607,5321,286,5.1
Dimmit County,2022-Jul,5661(P),5383(P),278(P),4.9(P)
Donley County,2012-Jan,1706,1603,103,6
Donley County,2012-Feb,1686,1586,100,5.9
Donley County,2012-Mar,1700,1608,92,5.4
Donley County,2012-Apr,1726,1637,89,5.2
Donley County,2012-May,1743,1646,97,5.6
Donley County,2012-Jun,1723,1603,120,7
Donley County,2012-Jul,1680,1564,116,6.9
Donley County,2012-Aug,1667,1555,112,6.7
Donley County,2012-Sep,1681,1587,94,5.6
Donley County,2012-Oct,1727,1635,92,5.3
Donley County,2012-Nov,1723,1631,92,5.3
Donley County,2012-Dec,1705,1609,96,5.6
Donley County,2013-Jan,1895,1795,100,5.3
Donley County,2013-Feb,2006,1903,103,5.1
Donley County,2013-Mar,2124,2027,97,4.6
Donley County,2013-Apr,2281,2184,97,4.3
Donley County,2013-May,2361,2257,104,4.4
Donley County,2013-Jun,2366,2248,118,5
Donley County,2013-Jul,2091,1974,117,5.6
Donley County,2013-Aug,1824,1711,113,6.2
Donley County,2013-Sep,1788,1681,107,6
Donley County,2013-Oct,1741,1647,94,5.4
Donley County,2013-Nov,1684,1596,88,5.2
Donley County,2013-Dec,1647,1564,83,5
Donley County,2014-Jan,1625,1541,84,5.2
Donley County,2014-Feb,1637,1553,84,5.1
Donley County,2014-Mar,1638,1561,77,4.7
Donley County,2014-Apr,1654,1589,65,3.9
Donley County,2014-May,1652,1570,82,5
Donley County,2014-Jun,1638,1545,93,5.7
Donley County,2014-Jul,1602,1506,96,6
Donley County,2014-Aug,1557,1466,91,5.8
Donley County,2014-Sep,1608,1530,78,4.9
Donley County,2014-Oct,1620,1548,72,4.4
Donley County,2014-Nov,1599,1533,66,4.1
Donley County,2014-Dec,1577,1517,60,3.8
Donley County,2015-Jan,1598,1526,72,4.5
Donley County,2015-Feb,1617,1553,64,4
Donley County,2015-Mar,1636,1576,60,3.7
Donley County,2015-Apr,1646,1592,54,3.3
Donley County,2015-May,1660,1598,62,3.7
Donley County,2015-Jun,1664,1586,78,4.7
Donley County,2015-Jul,1579,1500,79,5
Donley County,2015-Aug,1516,1441,75,4.9
Donley County,2015-Sep,1544,1472,72,4.7
Donley County,2015-Oct,1569,1505,64,4.1
Donley County,2015-Nov,1547,1488,59,3.8
Donley County,2015-Dec,1546,1486,60,3.9
Donley County,2016-Jan,1520,1461,59,3.9
Donley County,2016-Feb,1586,1522,64,4
Donley County,2016-Mar,1587,1525,62,3.9
Donley County,2016-Apr,1622,1563,59,3.6
Donley County,2016-May,1601,1545,56,3.5
Donley County,2016-Jun,1610,1534,76,4.7
Donley County,2016-Jul,1528,1452,76,5
Donley County,2016-Aug,1532,1460,72,4.7
Donley County,2016-Sep,1509,1447,62,4.1
Donley County,2016-Oct,1535,1479,56,3.6
Donley County,2016-Nov,1536,1477,59,3.8
Donley County,2016-Dec,1515,1457,58,3.8
Donley County,2017-Jan,1476,1419,57,3.9
Donley County,2017-Feb,1496,1432,64,4.3
Donley County,2017-Mar,1543,1485,58,3.8
Donley County,2017-Apr,1547,1494,53,3.4
Donley County,2017-May,1529,1477,52,3.4
Donley County,2017-Jun,1553,1488,65,4.2
Donley County,2017-Jul,1442,1380,62,4.3
Donley County,2017-Aug,1435,1379,56,3.9
Donley County,2017-Sep,1439,1394,45,3.1
Donley County,2017-Oct,1491,1448,43,2.9
Donley County,2017-Nov,1485,1433,52,3.5
Donley County,2017-Dec,1479,1430,49,3.3
Donley County,2018-Jan,1449,1399,50,3.5
Donley County,2018-Feb,1470,1420,50,3.4
Donley County,2018-Mar,1505,1457,48,3.2
Donley County,2018-Apr,1485,1441,44,3
Donley County,2018-May,1627,1581,46,2.8
Donley County,2018-Jun,1737,1670,67,3.9
Donley County,2018-Jul,1648,1582,66,4
Donley County,2018-Aug,1604,1541,63,3.9
Donley County,2018-Sep,1517,1462,55,3.6
Donley County,2018-Oct,1538,1485,53,3.4
Donley County,2018-Nov,1478,1430,48,3.2
Donley County,2018-Dec,1462,1408,54,3.7
Donley County,2019-Jan,1432,1368,64,4.5
Donley County,2019-Feb,1459,1406,53,3.6
Donley County,2019-Mar,1448,1403,45,3.1
Donley County,2019-Apr,1452,1417,35,2.4
Donley County,2019-May,1460,1419,41,2.8
Donley County,2019-Jun,1464,1408,56,3.8
Donley County,2019-Jul,1376,1321,55,4
Donley County,2019-Aug,1391,1333,58,4.2
Donley County,2019-Sep,1364,1319,45,3.3
Donley County,2019-Oct,1425,1382,43,3
Donley County,2019-Nov,1397,1354,43,3.1
Donley County,2019-Dec,1411,1370,41,2.9
Donley County,2020-Jan,1442,1392,50,3.5
Donley County,2020-Feb,1443,1400,43,3
Donley County,2020-Mar,1431,1364,67,4.7
Donley County,2020-Apr,1310,1252,58,4.4
Donley County,2020-May,1356,1294,62,4.6
Donley County,2020-Jun,1411,1324,87,6.2
Donley County,2020-Jul,1366,1285,81,5.9
Donley County,2020-Aug,1413,1347,66,4.7
Donley County,2020-Sep,1384,1328,56,4
Donley County,2020-Oct,1444,1395,49,3.4
Donley County,2020-Nov,1424,1365,59,4.1
Donley County,2020-Dec,1435,1371,64,4.5
Donley County,2021-Jan,1395,1322,73,5.2
Donley County,2021-Feb,1407,1338,69,4.9
Donley County,2021-Mar,1447,1384,63,4.4
Donley County,2021-Apr,1486,1429,57,3.8
Donley County,2021-May,1469,1417,52,3.5
Donley County,2021-Jun,1485,1410,75,5.1
Donley County,2021-Jul,1435,1369,66,4.6
Donley County,2021-Aug,1428,1368,60,4.2
Donley County,2021-Sep,1445,1393,52,3.6
Donley County,2021-Oct,1485,1432,53,3.6
Donley County,2021-Nov,1453,1406,47,3.2
Donley County,2021-Dec,1450,1404,46,3.2
Donley County,2022-Jan,1423,1371,52,3.7
Donley County,2022-Feb,1459,1409,50,3.4
Donley County,2022-Mar,1506,1464,42,2.8
Donley County,2022-Apr,1506,1466,40,2.7
Donley County,2022-May,1498,1452,46,3.1
Donley County,2022-Jun,1499,1442,57,3.8
Donley County,2022-Jul,1523(P),1463(P),60(P),3.9(P)
Duval County,2012-Jan,5209,4804,405,7.8
Duval County,2012-Feb,5279,4888,391,7.4
Duval County,2012-Mar,5309,4924,385,7.3
Duval County,2012-Apr,5367,5003,364,6.8
Duval County,2012-May,5455,5079,376,6.9
Duval County,2012-Jun,5555,5138,417,7.5
Duval County,2012-Jul,5499,5089,410,7.5
Duval County,2012-Aug,5421,5040,381,7
Duval County,2012-Sep,5541,5184,357,6.4
Duval County,2012-Oct,5499,5146,353,6.4
Duval County,2012-Nov,5448,5103,345,6.3
Duval County,2012-Dec,5442,5081,361,6.6
Duval County,2013-Jan,5419,5043,376,6.9
Duval County,2013-Feb,5460,5090,370,6.8
Duval County,2013-Mar,5476,5122,354,6.5
Duval County,2013-Apr,5551,5208,343,6.2
Duval County,2013-May,5569,5213,356,6.4
Duval County,2013-Jun,5641,5241,400,7.1
Duval County,2013-Jul,5606,5207,399,7.1
Duval County,2013-Aug,5588,5231,357,6.4
Duval County,2013-Sep,5568,5216,352,6.3
Duval County,2013-Oct,5526,5186,340,6.2
Duval County,2013-Nov,5500,5185,315,5.7
Duval County,2013-Dec,5469,5157,312,5.7
Duval County,2014-Jan,5462,5150,312,5.7
Duval County,2014-Feb,5502,5160,342,6.2
Duval County,2014-Mar,5533,5203,330,6
Duval County,2014-Apr,5587,5290,297,5.3
Duval County,2014-May,5620,5313,307,5.5
Duval County,2014-Jun,5615,5283,332,5.9
Duval County,2014-Jul,5544,5211,333,6
Duval County,2014-Aug,5469,5133,336,6.1
Duval County,2014-Sep,5526,5223,303,5.5
Duval County,2014-Oct,5533,5237,296,5.3
Duval County,2014-Nov,5463,5174,289,5.3
Duval County,2014-Dec,5416,5150,266,4.9
Duval County,2015-Jan,5549,5242,307,5.5
Duval County,2015-Feb,5502,5159,343,6.2
Duval County,2015-Mar,5447,5086,361,6.6
Duval County,2015-Apr,5356,4950,406,7.6
Duval County,2015-May,5329,4886,443,8.3
Duval County,2015-Jun,5294,4835,459,8.7
Duval County,2015-Jul,5135,4670,465,9.1
Duval County,2015-Aug,5060,4623,437,8.6
Duval County,2015-Sep,5095,4623,472,9.3
Duval County,2015-Oct,5062,4599,463,9.1
Duval County,2015-Nov,5081,4591,490,9.6
Duval County,2015-Dec,4986,4516,470,9.4
Duval County,2016-Jan,4874,4390,484,9.9
Duval County,2016-Feb,4957,4428,529,10.7
Duval County,2016-Mar,4979,4415,564,11.3
Duval County,2016-Apr,4948,4378,570,11.5
Duval County,2016-May,4880,4357,523,10.7
Duval County,2016-Jun,4895,4309,586,12
Duval County,2016-Jul,4836,4278,558,11.5
Duval County,2016-Aug,4854,4296,558,11.5
Duval County,2016-Sep,4868,4315,553,11.4
Duval County,2016-Oct,4881,4371,510,10.4
Duval County,2016-Nov,4856,4357,499,10.3
Duval County,2016-Dec,4809,4327,482,10
Duval County,2017-Jan,4846,4345,501,10.3
Duval County,2017-Feb,4865,4378,487,10
Duval County,2017-Mar,4846,4406,440,9.1
Duval County,2017-Apr,4800,4390,410,8.5
Duval County,2017-May,4805,4435,370,7.7
Duval County,2017-Jun,4810,4434,376,7.8
Duval County,2017-Jul,4725,4380,345,7.3
Duval County,2017-Aug,4710,4356,354,7.5
Duval County,2017-Sep,4779,4459,320,6.7
Duval County,2017-Oct,4704,4428,276,5.9
Duval County,2017-Nov,4641,4361,280,6
Duval County,2017-Dec,4679,4412,267,5.7
Duval County,2018-Jan,4885,4597,288,5.9
Duval County,2018-Feb,4913,4627,286,5.8
Duval County,2018-Mar,5012,4738,274,5.5
Duval County,2018-Apr,5027,4774,253,5
Duval County,2018-May,5018,4771,247,4.9
Duval County,2018-Jun,5040,4747,293,5.8
Duval County,2018-Jul,5031,4736,295,5.9
Duval County,2018-Aug,5019,4764,255,5.1
Duval County,2018-Sep,5036,4765,271,5.4
Duval County,2018-Oct,5113,4873,240,4.7
Duval County,2018-Nov,5075,4834,241,4.7
Duval County,2018-Dec,5037,4806,231,4.6
Duval County,2019-Jan,4970,4723,247,5
Duval County,2019-Feb,4935,4706,229,4.6
Duval County,2019-Mar,4937,4714,223,4.5
Duval County,2019-Apr,4885,4704,181,3.7
Duval County,2019-May,4901,4724,177,3.6
Duval County,2019-Jun,4928,4699,229,4.6
Duval County,2019-Jul,4898,4662,236,4.8
Duval County,2019-Aug,4899,4668,231,4.7
Duval County,2019-Sep,4861,4658,203,4.2
Duval County,2019-Oct,4883,4678,205,4.2
Duval County,2019-Nov,4851,4631,220,4.5
Duval County,2019-Dec,4778,4547,231,4.8
Duval County,2020-Jan,4788,4539,249,5.2
Duval County,2020-Feb,4811,4570,241,5
Duval County,2020-Mar,4788,4420,368,7.7
Duval County,2020-Apr,4688,4027,661,14.1
Duval County,2020-May,4854,4043,811,16.7
Duval County,2020-Jun,4845,4056,789,16.3
Duval County,2020-Jul,4895,4108,787,16.1
Duval County,2020-Aug,4848,4190,658,13.6
Duval County,2020-Sep,4792,4141,651,13.6
Duval County,2020-Oct,4802,4215,587,12.2
Duval County,2020-Nov,4779,4168,611,12.8
Duval County,2020-Dec,4699,4108,591,12.6
Duval County,2021-Jan,5421,4840,581,10.7
Duval County,2021-Feb,5441,4896,545,10
Duval County,2021-Mar,5452,4943,509,9.3
Duval County,2021-Apr,5457,4960,497,9.1
Duval County,2021-May,5397,4944,453,8.4
Duval County,2021-Jun,5388,4884,504,9.4
Duval County,2021-Jul,5484,5018,466,8.5
Duval County,2021-Aug,5496,5064,432,7.9
Duval County,2021-Sep,5524,5140,384,7
Duval County,2021-Oct,5555,5190,365,6.6
Duval County,2021-Nov,5511,5157,354,6.4
Duval County,2021-Dec,5431,5096,335,6.2
Duval County,2022-Jan,5519,5152,367,6.6
Duval County,2022-Feb,5553,5194,359,6.5
Duval County,2022-Mar,5537,5238,299,5.4
Duval County,2022-Apr,5522,5244,278,5
Duval County,2022-May,5480,5201,279,5.1
Duval County,2022-Jun,5459,5157,302,5.5
Duval County,2022-Jul,5513(P),5214(P),299(P),5.4(P)
Eastland County,2012-Jan,8043,7446,597,7.4
Eastland County,2012-Feb,8279,7690,589,7.1
Eastland County,2012-Mar,8296,7759,537,6.5
Eastland County,2012-Apr,8271,7786,485,5.9
Eastland County,2012-May,8286,7757,529,6.4
Eastland County,2012-Jun,8404,7772,632,7.5
Eastland County,2012-Jul,8266,7644,622,7.5
Eastland County,2012-Aug,8207,7649,558,6.8
Eastland County,2012-Sep,8234,7731,503,6.1
Eastland County,2012-Oct,8246,7749,497,6
Eastland County,2012-Nov,8258,7763,495,6
Eastland County,2012-Dec,8168,7666,502,6.1
Eastland County,2013-Jan,8334,7782,552,6.6
Eastland County,2013-Feb,8287,7755,532,6.4
Eastland County,2013-Mar,8298,7777,521,6.3
Eastland County,2013-Apr,8465,7979,486,5.7
Eastland County,2013-May,8556,8037,519,6.1
Eastland County,2013-Jun,8549,7937,612,7.2
Eastland County,2013-Jul,8604,8030,574,6.7
Eastland County,2013-Aug,8596,8074,522,6.1
Eastland County,2013-Sep,8652,8142,510,5.9
Eastland County,2013-Oct,8664,8188,476,5.5
Eastland County,2013-Nov,8636,8160,476,5.5
Eastland County,2013-Dec,8512,8067,445,5.2
Eastland County,2014-Jan,8355,7912,443,5.3
Eastland County,2014-Feb,8405,7958,447,5.3
Eastland County,2014-Mar,8379,7955,424,5.1
Eastland County,2014-Apr,8305,7939,366,4.4
Eastland County,2014-May,8389,7981,408,4.9
Eastland County,2014-Jun,8344,7894,450,5.4
Eastland County,2014-Jul,8262,7794,468,5.7
Eastland County,2014-Aug,8203,7756,447,5.4
Eastland County,2014-Sep,8316,7914,402,4.8
Eastland County,2014-Oct,8367,8002,365,4.4
Eastland County,2014-Nov,8506,8138,368,4.3
Eastland County,2014-Dec,8375,8049,326,3.9
Eastland County,2015-Jan,8319,7940,379,4.6
Eastland County,2015-Feb,8371,8006,365,4.4
Eastland County,2015-Mar,8231,7867,364,4.4
Eastland County,2015-Apr,8164,7817,347,4.3
Eastland County,2015-May,8187,7811,376,4.6
Eastland County,2015-Jun,8080,7656,424,5.2
Eastland County,2015-Jul,7912,7509,403,5.1
Eastland County,2015-Aug,7863,7476,387,4.9
Eastland County,2015-Sep,7937,7557,380,4.8
Eastland County,2015-Oct,7913,7518,395,5
Eastland County,2015-Nov,7821,7414,407,5.2
Eastland County,2015-Dec,7716,7328,388,5
Eastland County,2016-Jan,7455,7035,420,5.6
Eastland County,2016-Feb,7531,7122,409,5.4
Eastland County,2016-Mar,7511,7092,419,5.6
Eastland County,2016-Apr,7597,7208,389,5.1
Eastland County,2016-May,7453,7066,387,5.2
Eastland County,2016-Jun,7526,7081,445,5.9
Eastland County,2016-Jul,7175,6738,437,6.1
Eastland County,2016-Aug,7159,6744,415,5.8
Eastland County,2016-Sep,7395,6998,397,5.4
Eastland County,2016-Oct,7434,7058,376,5.1
Eastland County,2016-Nov,7471,7098,373,5
Eastland County,2016-Dec,7373,6982,391,5.3
Eastland County,2017-Jan,7469,7040,429,5.7
Eastland County,2017-Feb,7758,7346,412,5.3
Eastland County,2017-Mar,7904,7537,367,4.6
Eastland County,2017-Apr,7804,7476,328,4.2
Eastland County,2017-May,7811,7490,321,4.1
Eastland County,2017-Jun,7793,7428,365,4.7
Eastland County,2017-Jul,7736,7384,352,4.6
Eastland County,2017-Aug,7760,7406,354,4.6
Eastland County,2017-Sep,7931,7622,309,3.9
Eastland County,2017-Oct,7992,7715,277,3.5
Eastland County,2017-Nov,8311,8022,289,3.5
Eastland County,2017-Dec,8318,8045,273,3.3
Eastland County,2018-Jan,8034,7728,306,3.8
Eastland County,2018-Feb,8264,7960,304,3.7
Eastland County,2018-Mar,8553,8253,300,3.5
Eastland County,2018-Apr,8430,8160,270,3.2
Eastland County,2018-May,8627,8352,275,3.2
Eastland County,2018-Jun,8688,8345,343,3.9
Eastland County,2018-Jul,8665,8354,311,3.6
Eastland County,2018-Aug,8692,8392,300,3.5
Eastland County,2018-Sep,8762,8485,277,3.2
Eastland County,2018-Oct,8775,8515,260,3
Eastland County,2018-Nov,8819,8559,260,2.9
Eastland County,2018-Dec,8759,8495,264,3
Eastland County,2019-Jan,8542,8235,307,3.6
Eastland County,2019-Feb,8593,8307,286,3.3
Eastland County,2019-Mar,8579,8306,273,3.2
Eastland County,2019-Apr,8309,8065,244,2.9
Eastland County,2019-May,8284,8027,257,3.1
Eastland County,2019-Jun,8182,7870,312,3.8
Eastland County,2019-Jul,8074,7769,305,3.8
Eastland County,2019-Aug,8091,7795,296,3.7
Eastland County,2019-Sep,8015,7752,263,3.3
Eastland County,2019-Oct,8172,7912,260,3.2
Eastland County,2019-Nov,8109,7860,249,3.1
Eastland County,2019-Dec,7998,7766,232,2.9
Eastland County,2020-Jan,7691,7384,307,4
Eastland County,2020-Feb,7642,7373,269,3.5
Eastland County,2020-Mar,7538,7124,414,5.5
Eastland County,2020-Apr,7060,6482,578,8.2
Eastland County,2020-May,6894,6242,652,9.5
Eastland County,2020-Jun,7030,6355,675,9.6
Eastland County,2020-Jul,7048,6454,594,8.4
Eastland County,2020-Aug,7183,6692,491,6.8
Eastland County,2020-Sep,7277,6782,495,6.8
Eastland County,2020-Oct,7380,6931,449,6.1
Eastland County,2020-Nov,7314,6851,463,6.3
Eastland County,2020-Dec,7308,6814,494,6.8
Eastland County,2021-Jan,7325,6815,510,7
Eastland County,2021-Feb,7384,6870,514,7
Eastland County,2021-Mar,7492,7009,483,6.4
Eastland County,2021-Apr,7443,7013,430,5.8
Eastland County,2021-May,7407,6995,412,5.6
Eastland County,2021-Jun,7383,6883,500,6.8
Eastland County,2021-Jul,7136,6713,423,5.9
Eastland County,2021-Aug,7173,6775,398,5.5
Eastland County,2021-Sep,7352,6964,388,5.3
Eastland County,2021-Oct,7399,7034,365,4.9
Eastland County,2021-Nov,7334,6993,341,4.6
Eastland County,2021-Dec,7255,6947,308,4.2
Eastland County,2022-Jan,7152,6807,345,4.8
Eastland County,2022-Feb,7214,6865,349,4.8
Eastland County,2022-Mar,7325,7036,289,3.9
Eastland County,2022-Apr,7112,6834,278,3.9
Eastland County,2022-May,7010,6706,304,4.3
Eastland County,2022-Jun,6987,6637,350,5
Eastland County,2022-Jul,6863(P),6538(P),325(P),4.7(P)
Ector County,2012-Jan,74897,71080,3817,5.1
Ector County,2012-Feb,75447,71755,3692,4.9
Ector County,2012-Mar,75719,72280,3439,4.5
Ector County,2012-Apr,76198,72951,3247,4.3
Ector County,2012-May,76704,73258,3446,4.5
Ector County,2012-Jun,76774,72832,3942,5.1
Ector County,2012-Jul,77590,73631,3959,5.1
Ector County,2012-Aug,77403,73729,3674,4.7
Ector County,2012-Sep,78244,74920,3324,4.2
Ector County,2012-Oct,78390,75142,3248,4.1
Ector County,2012-Nov,77730,74566,3164,4.1
Ector County,2012-Dec,77548,74359,3189,4.1
Ector County,2013-Jan,78150,74453,3697,4.7
Ector County,2013-Feb,78336,74877,3459,4.4
Ector County,2013-Mar,77791,74477,3314,4.3
Ector County,2013-Apr,78484,75275,3209,4.1
Ector County,2013-May,78652,75183,3469,4.4
Ector County,2013-Jun,78511,74581,3930,5
Ector County,2013-Jul,78924,75149,3775,4.8
Ector County,2013-Aug,78460,74903,3557,4.5
Ector County,2013-Sep,79037,75603,3434,4.3
Ector County,2013-Oct,78417,75164,3253,4.1
Ector County,2013-Nov,79020,75889,3131,4
Ector County,2013-Dec,79196,76220,2976,3.8
Ector County,2014-Jan,79835,76684,3151,3.9
Ector County,2014-Feb,80626,77446,3180,3.9
Ector County,2014-Mar,80803,77790,3013,3.7
Ector County,2014-Apr,80899,78298,2601,3.2
Ector County,2014-May,81133,78273,2860,3.5
Ector County,2014-Jun,81948,78807,3141,3.8
Ector County,2014-Jul,82975,79737,3238,3.9
Ector County,2014-Aug,82827,79841,2986,3.6
Ector County,2014-Sep,83648,80901,2747,3.3
Ector County,2014-Oct,84000,81415,2585,3.1
Ector County,2014-Nov,84187,81665,2522,3
Ector County,2014-Dec,84098,81673,2425,2.9
Ector County,2015-Jan,83484,80539,2945,3.5
Ector County,2015-Feb,82554,79393,3161,3.8
Ector County,2015-Mar,81635,78319,3316,4.1
Ector County,2015-Apr,80882,77536,3346,4.1
Ector County,2015-May,79958,76287,3671,4.6
Ector County,2015-Jun,79773,75747,4026,5
Ector County,2015-Jul,79408,75324,4084,5.1
Ector County,2015-Aug,78764,74849,3915,5
Ector County,2015-Sep,78438,74409,4029,5.1
Ector County,2015-Oct,77840,73758,4082,5.2
Ector County,2015-Nov,77552,73387,4165,5.4
Ector County,2015-Dec,77345,73305,4040,5.2
Ector County,2016-Jan,77346,73068,4278,5.5
Ector County,2016-Feb,77579,73025,4554,5.9
Ector County,2016-Mar,76897,71995,4902,6.4
Ector County,2016-Apr,76429,71460,4969,6.5
Ector County,2016-May,75503,70637,4866,6.4
Ector County,2016-Jun,75531,70076,5455,7.2
Ector County,2016-Jul,76064,70623,5441,7.2
Ector County,2016-Aug,75992,70661,5331,7
Ector County,2016-Sep,76273,71102,5171,6.8
Ector County,2016-Oct,75608,70952,4656,6.2
Ector County,2016-Nov,75832,71446,4386,5.8
Ector County,2016-Dec,75877,71617,4260,5.6
Ector County,2017-Jan,75369,71001,4368,5.8
Ector County,2017-Feb,76054,71883,4171,5.5
Ector County,2017-Mar,76065,72284,3781,5
Ector County,2017-Apr,76561,73214,3347,4.4
Ector County,2017-May,76602,73420,3182,4.2
Ector County,2017-Jun,77109,73825,3284,4.3
Ector County,2017-Jul,78618,75463,3155,4
Ector County,2017-Aug,78630,75530,3100,3.9
Ector County,2017-Sep,79805,77040,2765,3.5
Ector County,2017-Oct,79741,77232,2509,3.1
Ector County,2017-Nov,80664,78069,2595,3.2
Ector County,2017-Dec,80543,78091,2452,3
Ector County,2018-Jan,81026,78361,2665,3.3
Ector County,2018-Feb,82347,79765,2582,3.1
Ector County,2018-Mar,82831,80379,2452,3
Ector County,2018-Apr,84123,81948,2175,2.6
Ector County,2018-May,84122,81982,2140,2.5
Ector County,2018-Jun,84784,82251,2533,3
Ector County,2018-Jul,85711,83319,2392,2.8
Ector County,2018-Aug,85220,82887,2333,2.7
Ector County,2018-Sep,86359,84158,2201,2.5
Ector County,2018-Oct,86566,84490,2076,2.4
Ector County,2018-Nov,87080,85014,2066,2.4
Ector County,2018-Dec,87518,85408,2110,2.4
Ector County,2019-Jan,86924,84492,2432,2.8
Ector County,2019-Feb,87735,85441,2294,2.6
Ector County,2019-Mar,87060,84906,2154,2.5
Ector County,2019-Apr,87269,85450,1819,2.1
Ector County,2019-May,86894,84941,1953,2.2
Ector County,2019-Jun,87052,84616,2436,2.8
Ector County,2019-Jul,87982,85454,2528,2.9
Ector County,2019-Aug,87440,84917,2523,2.9
Ector County,2019-Sep,87833,85435,2398,2.7
Ector County,2019-Oct,87459,85056,2403,2.7
Ector County,2019-Nov,86979,84466,2513,2.9
Ector County,2019-Dec,86598,84126,2472,2.9
Ector County,2020-Jan,86105,83216,2889,3.4
Ector County,2020-Feb,86672,83899,2773,3.2
Ector County,2020-Mar,84963,80683,4280,5
Ector County,2020-Apr,80152,69850,10302,12.9
Ector County,2020-May,81829,68704,13125,16
Ector County,2020-Jun,81975,68889,13086,16
Ector County,2020-Jul,80935,68171,12764,15.8
Ector County,2020-Aug,80276,69531,10745,13.4
Ector County,2020-Sep,80299,69858,10441,13
Ector County,2020-Oct,80717,71197,9520,11.8
Ector County,2020-Nov,80862,71251,9611,11.9
Ector County,2020-Dec,80633,71297,9336,11.6
Ector County,2021-Jan,80166,71169,8997,11.2
Ector County,2021-Feb,80580,71992,8588,10.7
Ector County,2021-Mar,80428,72578,7850,9.8
Ector County,2021-Apr,80667,73304,7363,9.1
Ector County,2021-May,79963,73193,6770,8.5
Ector County,2021-Jun,80474,73186,7288,9.1
Ector County,2021-Jul,80368,73751,6617,8.2
Ector County,2021-Aug,80243,74108,6135,7.6
Ector County,2021-Sep,80564,74934,5630,7
Ector County,2021-Oct,80586,75258,5328,6.6
Ector County,2021-Nov,80983,75960,5023,6.2
Ector County,2021-Dec,81054,76357,4697,5.8
Ector County,2022-Jan,81295,76123,5172,6.4
Ector County,2022-Feb,81635,76571,5064,6.2
Ector County,2022-Mar,81369,77227,4142,5.1
Ector County,2022-Apr,80950,77077,3873,4.8
Ector County,2022-May,81187,77284,3903,4.8
Ector County,2022-Jun,81030,76713,4317,5.3
Ector County,2022-Jul,80807(P),76698(P),4109(P),5.1(P)
Edwards County,2012-Jan,934,877,57,6.1
Edwards County,2012-Feb,907,850,57,6.3
Edwards County,2012-Mar,921,869,52,5.6
Edwards County,2012-Apr,920,870,50,5.4
Edwards County,2012-May,912,858,54,5.9
Edwards County,2012-Jun,966,904,62,6.4
Edwards County,2012-Jul,955,885,70,7.3
Edwards County,2012-Aug,937,871,66,7
Edwards County,2012-Sep,926,864,62,6.7
Edwards County,2012-Oct,923,862,61,6.6
Edwards County,2012-Nov,908,853,55,6.1
Edwards County,2012-Dec,888,827,61,6.9
Edwards County,2013-Jan,882,817,65,7.4
Edwards County,2013-Feb,874,814,60,6.9
Edwards County,2013-Mar,868,812,56,6.5
Edwards County,2013-Apr,890,837,53,6
Edwards County,2013-May,900,847,53,5.9
Edwards County,2013-Jun,959,899,60,6.3
Edwards County,2013-Jul,962,908,54,5.6
Edwards County,2013-Aug,935,884,51,5.5
Edwards County,2013-Sep,887,839,48,5.4
Edwards County,2013-Oct,891,846,45,5.1
Edwards County,2013-Nov,883,838,45,5.1
Edwards County,2013-Dec,887,842,45,5.1
Edwards County,2014-Jan,849,804,45,5.3
Edwards County,2014-Feb,868,825,43,5
Edwards County,2014-Mar,861,819,42,4.9
Edwards County,2014-Apr,864,830,34,3.9
Edwards County,2014-May,882,848,34,3.9
Edwards County,2014-Jun,895,857,38,4.2
Edwards County,2014-Jul,904,866,38,4.2
Edwards County,2014-Aug,888,844,44,5
Edwards County,2014-Sep,862,826,36,4.2
Edwards County,2014-Oct,850,817,33,3.9
Edwards County,2014-Nov,837,803,34,4.1
Edwards County,2014-Dec,829,799,30,3.6
Edwards County,2015-Jan,842,807,35,4.2
Edwards County,2015-Feb,863,821,42,4.9
Edwards County,2015-Mar,867,830,37,4.3
Edwards County,2015-Apr,859,828,31,3.6
Edwards County,2015-May,890,843,47,5.3
Edwards County,2015-Jun,911,862,49,5.4
Edwards County,2015-Jul,911,864,47,5.2
Edwards County,2015-Aug,860,817,43,5
Edwards County,2015-Sep,866,823,43,5
Edwards County,2015-Oct,844,806,38,4.5
Edwards County,2015-Nov,834,796,38,4.6
Edwards County,2015-Dec,841,806,35,4.2
Edwards County,2016-Jan,821,784,37,4.5
Edwards County,2016-Feb,862,821,41,4.8
Edwards County,2016-Mar,870,829,41,4.7
Edwards County,2016-Apr,850,814,36,4.2
Edwards County,2016-May,866,830,36,4.2
Edwards County,2016-Jun,891,842,49,5.5
Edwards County,2016-Jul,871,824,47,5.4
Edwards County,2016-Aug,873,830,43,4.9
Edwards County,2016-Sep,863,821,42,4.9
Edwards County,2016-Oct,884,844,40,4.5
Edwards County,2016-Nov,877,843,34,3.9
Edwards County,2016-Dec,875,838,37,4.2
Edwards County,2017-Jan,869,831,38,4.4
Edwards County,2017-Feb,885,847,38,4.3
Edwards County,2017-Mar,899,865,34,3.8
Edwards County,2017-Apr,885,856,29,3.3
Edwards County,2017-May,898,869,29,3.2
Edwards County,2017-Jun,912,883,29,3.2
Edwards County,2017-Jul,935,906,29,3.1
Edwards County,2017-Aug,945,915,30,3.2
Edwards County,2017-Sep,892,869,23,2.6
Edwards County,2017-Oct,909,887,22,2.4
Edwards County,2017-Nov,887,862,25,2.8
Edwards County,2017-Dec,870,846,24,2.8
Edwards County,2018-Jan,849,825,24,2.8
Edwards County,2018-Feb,850,825,25,2.9
Edwards County,2018-Mar,891,865,26,2.9
Edwards County,2018-Apr,864,843,21,2.4
Edwards County,2018-May,873,850,23,2.6
Edwards County,2018-Jun,890,863,27,3
Edwards County,2018-Jul,877,850,27,3.1
Edwards County,2018-Aug,902,873,29,3.2
Edwards County,2018-Sep,877,853,24,2.7
Edwards County,2018-Oct,873,852,21,2.4
Edwards County,2018-Nov,878,855,23,2.6
Edwards County,2018-Dec,866,840,26,3
Edwards County,2019-Jan,902,870,32,3.5
Edwards County,2019-Feb,929,899,30,3.2
Edwards County,2019-Mar,965,937,28,2.9
Edwards County,2019-Apr,963,943,20,2.1
Edwards County,2019-May,998,978,20,2
Edwards County,2019-Jun,1037,1010,27,2.6
Edwards County,2019-Jul,1066,1041,25,2.3
Edwards County,2019-Aug,1127,1105,22,2
Edwards County,2019-Sep,1125,1102,23,2
Edwards County,2019-Oct,1143,1122,21,1.8
Edwards County,2019-Nov,1102,1082,20,1.8
Edwards County,2019-Dec,1072,1055,17,1.6
Edwards County,2020-Jan,1142,1121,21,1.8
Edwards County,2020-Feb,1180,1159,21,1.8
Edwards County,2020-Mar,1150,1115,35,3
Edwards County,2020-Apr,1070,1039,31,2.9
Edwards County,2020-May,1171,1125,46,3.9
Edwards County,2020-Jun,1206,1153,53,4.4
Edwards County,2020-Jul,1290,1236,54,4.2
Edwards County,2020-Aug,1335,1289,46,3.4
Edwards County,2020-Sep,1338,1288,50,3.7
Edwards County,2020-Oct,1294,1243,51,3.9
Edwards County,2020-Nov,1277,1222,55,4.3
Edwards County,2020-Dec,1282,1225,57,4.4
Edwards County,2021-Jan,1325,1265,60,4.5
Edwards County,2021-Feb,1376,1314,62,4.5
Edwards County,2021-Mar,1306,1251,55,4.2
Edwards County,2021-Apr,1298,1245,53,4.1
Edwards County,2021-May,1248,1194,54,4.3
Edwards County,2021-Jun,1263,1202,61,4.8
Edwards County,2021-Jul,1255,1201,54,4.3
Edwards County,2021-Aug,1237,1186,51,4.1
Edwards County,2021-Sep,1262,1208,54,4.3
Edwards County,2021-Oct,1221,1167,54,4.4
Edwards County,2021-Nov,1202,1150,52,4.3
Edwards County,2021-Dec,1187,1142,45,3.8
Edwards County,2022-Jan,1234,1189,45,3.6
Edwards County,2022-Feb,1297,1251,46,3.5
Edwards County,2022-Mar,1269,1233,36,2.8
Edwards County,2022-Apr,1270,1236,34,2.7
Edwards County,2022-May,1280,1245,35,2.7
Edwards County,2022-Jun,1293,1257,36,2.8
Edwards County,2022-Jul,1330(P),1295(P),35(P),2.6(P)
Ellis County,2012-Jan,75768,70274,5494,7.3
Ellis County,2012-Feb,76189,70731,5458,7.2
Ellis County,2012-Mar,76169,70991,5178,6.8
Ellis County,2012-Apr,76200,71399,4801,6.3
Ellis County,2012-May,76434,71428,5006,6.5
Ellis County,2012-Jun,76998,71362,5636,7.3
Ellis County,2012-Jul,77020,71409,5611,7.3
Ellis County,2012-Aug,76618,71337,5281,6.9
Ellis County,2012-Sep,76743,71891,4852,6.3
Ellis County,2012-Oct,77046,72166,4880,6.3
Ellis County,2012-Nov,77047,72329,4718,6.1
Ellis County,2012-Dec,77008,72170,4838,6.3
Ellis County,2013-Jan,76624,71221,5403,7.1
Ellis County,2013-Feb,76642,71531,5111,6.7
Ellis County,2013-Mar,76643,71695,4948,6.5
Ellis County,2013-Apr,76973,72325,4648,6
Ellis County,2013-May,77294,72447,4847,6.3
Ellis County,2013-Jun,77864,72546,5318,6.8
Ellis County,2013-Jul,78132,72973,5159,6.6
Ellis County,2013-Aug,77956,73094,4862,6.2
Ellis County,2013-Sep,78024,73338,4686,6
Ellis County,2013-Oct,77646,73134,4512,5.8
Ellis County,2013-Nov,78339,74019,4320,5.5
Ellis County,2013-Dec,78107,74025,4082,5.2
Ellis County,2014-Jan,77881,73561,4320,5.5
Ellis County,2014-Feb,78265,73880,4385,5.6
Ellis County,2014-Mar,78491,74272,4219,5.4
Ellis County,2014-Apr,78436,74797,3639,4.6
Ellis County,2014-May,78699,74752,3947,5
Ellis County,2014-Jun,79185,74914,4271,5.4
Ellis County,2014-Jul,79600,75209,4391,5.5
Ellis County,2014-Aug,79376,75198,4178,5.3
Ellis County,2014-Sep,79301,75494,3807,4.8
Ellis County,2014-Oct,79453,75906,3547,4.5
Ellis County,2014-Nov,79685,76243,3442,4.3
Ellis County,2014-Dec,79284,76181,3103,3.9
Ellis County,2015-Jan,79722,76207,3515,4.4
Ellis County,2015-Feb,79837,76555,3282,4.1
Ellis County,2015-Mar,79728,76579,3149,3.9
Ellis County,2015-Apr,80381,77518,2863,3.6
Ellis County,2015-May,80766,77637,3129,3.9
Ellis County,2015-Jun,81166,77705,3461,4.3
Ellis County,2015-Jul,81572,78026,3546,4.3
Ellis County,2015-Aug,81472,78143,3329,4.1
Ellis County,2015-Sep,81266,78046,3220,4
Ellis County,2015-Oct,81634,78535,3099,3.8
Ellis County,2015-Nov,82090,79008,3082,3.8
Ellis County,2015-Dec,82118,79221,2897,3.5
Ellis County,2016-Jan,83183,80095,3088,3.7
Ellis County,2016-Feb,83977,80917,3060,3.6
Ellis County,2016-Mar,84072,81015,3057,3.6
Ellis County,2016-Apr,84376,81490,2886,3.4
Ellis County,2016-May,84471,81555,2916,3.5
Ellis County,2016-Jun,85089,81618,3471,4.1
Ellis County,2016-Jul,85616,82038,3578,4.2
Ellis County,2016-Aug,85619,82158,3461,4
Ellis County,2016-Sep,85733,82310,3423,4
Ellis County,2016-Oct,85808,82637,3171,3.7
Ellis County,2016-Nov,86192,83133,3059,3.5
Ellis County,2016-Dec,86165,83057,3108,3.6
Ellis County,2017-Jan,85959,82586,3373,3.9
Ellis County,2017-Feb,86558,83133,3425,4
Ellis County,2017-Mar,86624,83332,3292,3.8
Ellis County,2017-Apr,86814,83958,2856,3.3
Ellis County,2017-May,86633,83646,2987,3.4
Ellis County,2017-Jun,87146,83851,3295,3.8
Ellis County,2017-Jul,87543,84292,3251,3.7
Ellis County,2017-Aug,87414,84259,3155,3.6
Ellis County,2017-Sep,87739,84882,2857,3.3
Ellis County,2017-Oct,87419,84803,2616,3
Ellis County,2017-Nov,88052,85265,2787,3.2
Ellis County,2017-Dec,87818,85107,2711,3.1
Ellis County,2018-Jan,88649,85630,3019,3.4
Ellis County,2018-Feb,89446,86356,3090,3.5
Ellis County,2018-Mar,89322,86197,3125,3.5
Ellis County,2018-Apr,89380,86606,2774,3.1
Ellis County,2018-May,89330,86557,2773,3.1
Ellis County,2018-Jun,90110,86713,3397,3.8
Ellis County,2018-Jul,90378,87123,3255,3.6
Ellis County,2018-Aug,89722,86654,3068,3.4
Ellis County,2018-Sep,89855,86895,2960,3.3
Ellis County,2018-Oct,90264,87428,2836,3.1
Ellis County,2018-Nov,90657,87829,2828,3.1
Ellis County,2018-Dec,90659,87799,2860,3.2
Ellis County,2019-Jan,91879,88449,3430,3.7
Ellis County,2019-Feb,92126,89065,3061,3.3
Ellis County,2019-Mar,91953,89014,2939,3.2
Ellis County,2019-Apr,91899,89411,2488,2.7
Ellis County,2019-May,91933,89375,2558,2.8
Ellis County,2019-Jun,92852,89675,3177,3.4
Ellis County,2019-Jul,93466,90224,3242,3.5
Ellis County,2019-Aug,93307,90308,2999,3.2
Ellis County,2019-Sep,93521,90709,2812,3
Ellis County,2019-Oct,94133,91409,2724,2.9
Ellis County,2019-Nov,94419,91749,2670,2.8
Ellis County,2019-Dec,94264,91763,2501,2.7
Ellis County,2020-Jan,95848,92939,2909,3
Ellis County,2020-Feb,96416,93651,2765,2.9
Ellis County,2020-Mar,94490,90100,4390,4.6
Ellis County,2020-Apr,88280,79613,8667,9.8
Ellis County,2020-May,91131,82763,8368,9.2
Ellis County,2020-Jun,93101,85398,7703,8.3
Ellis County,2020-Jul,93915,87012,6903,7.4
Ellis County,2020-Aug,95124,89523,5601,5.9
Ellis County,2020-Sep,95457,90012,5445,5.7
Ellis County,2020-Oct,96606,91782,4824,5
Ellis County,2020-Nov,97114,92069,5045,5.2
Ellis County,2020-Dec,97307,92197,5110,5.3
Ellis County,2021-Jan,97080,91676,5404,5.6
Ellis County,2021-Feb,97717,92403,5314,5.4
Ellis County,2021-Mar,97616,92623,4993,5.1
Ellis County,2021-Apr,97849,93405,4444,4.5
Ellis County,2021-May,97946,93584,4362,4.5
Ellis County,2021-Jun,98525,93471,5054,5.1
Ellis County,2021-Jul,99146,94533,4613,4.7
Ellis County,2021-Aug,99279,95003,4276,4.3
Ellis County,2021-Sep,99457,95450,4007,4
Ellis County,2021-Oct,100091,96248,3843,3.8
Ellis County,2021-Nov,101193,97541,3652,3.6
Ellis County,2021-Dec,100914,97582,3332,3.3
Ellis County,2022-Jan,101311,97429,3882,3.8
Ellis County,2022-Feb,102464,98549,3915,3.8
Ellis County,2022-Mar,102701,99490,3211,3.1
Ellis County,2022-Apr,102817,99783,3034,3
Ellis County,2022-May,103543,100284,3259,3.1
Ellis County,2022-Jun,103912,100109,3803,3.7
Ellis County,2022-Jul,104014(P),100231(P),3783(P),3.6(P)
El Paso County,2012-Jan,345527,314319,31208,9
El Paso County,2012-Feb,347595,316403,31192,9
El Paso County,2012-Mar,346171,316977,29194,8.4
El Paso County,2012-Apr,346578,318800,27778,8
El Paso County,2012-May,347843,318530,29313,8.4
El Paso County,2012-Jun,346433,314417,32016,9.2
El Paso County,2012-Jul,346433,314536,31897,9.2
El Paso County,2012-Aug,344861,314737,30124,8.7
El Paso County,2012-Sep,346551,318289,28262,8.2
El Paso County,2012-Oct,347539,319756,27783,8
El Paso County,2012-Nov,347231,320126,27105,7.8
El Paso County,2012-Dec,347402,319557,27845,8
El Paso County,2013-Jan,346992,316680,30312,8.7
El Paso County,2013-Feb,347182,317931,29251,8.4
El Paso County,2013-Mar,345757,317826,27931,8.1
El Paso County,2013-Apr,346889,320001,26888,7.8
El Paso County,2013-May,348306,320320,27986,8
El Paso County,2013-Jun,346013,315694,30319,8.8
El Paso County,2013-Jul,345009,316056,28953,8.4
El Paso County,2013-Aug,345403,317736,27667,8
El Paso County,2013-Sep,347520,320421,27099,7.8
El Paso County,2013-Oct,345480,319313,26167,7.6
El Paso County,2013-Nov,348070,322773,25297,7.3
El Paso County,2013-Dec,346804,322948,23856,6.9
El Paso County,2014-Jan,346798,321937,24861,7.2
El Paso County,2014-Feb,347748,322824,24924,7.2
El Paso County,2014-Mar,347407,323819,23588,6.8
El Paso County,2014-Apr,346027,324810,21217,6.1
El Paso County,2014-May,345994,323772,22222,6.4
El Paso County,2014-Jun,344394,320527,23867,6.9
El Paso County,2014-Jul,342539,318211,24328,7.1
El Paso County,2014-Aug,342497,318821,23676,6.9
El Paso County,2014-Sep,341967,320118,21849,6.4
El Paso County,2014-Oct,341677,321384,20293,5.9
El Paso County,2014-Nov,342390,322434,19956,5.8
El Paso County,2014-Dec,340185,322109,18076,5.3
El Paso County,2015-Jan,340488,320487,20001,5.9
El Paso County,2015-Feb,340260,321547,18713,5.5
El Paso County,2015-Mar,339424,321610,17814,5.2
El Paso County,2015-Apr,340591,324138,16453,4.8
El Paso County,2015-May,342300,324868,17432,5.1
El Paso County,2015-Jun,340614,321802,18812,5.5
El Paso County,2015-Jul,339904,320996,18908,5.6
El Paso County,2015-Aug,340465,322677,17788,5.2
El Paso County,2015-Sep,341724,324194,17530,5.1
El Paso County,2015-Oct,343739,326507,17232,5
El Paso County,2015-Nov,346384,329272,17112,4.9
El Paso County,2015-Dec,345486,329361,16125,4.7
El Paso County,2016-Jan,346058,328874,17184,5
El Paso County,2016-Feb,347906,331152,16754,4.8
El Paso County,2016-Mar,348218,331352,16866,4.8
El Paso County,2016-Apr,349310,333507,15803,4.5
El Paso County,2016-May,348837,333088,15749,4.5
El Paso County,2016-Jun,347855,329544,18311,5.3
El Paso County,2016-Jul,349824,331118,18706,5.3
El Paso County,2016-Aug,351306,332671,18635,5.3
El Paso County,2016-Sep,353567,335113,18454,5.2
El Paso County,2016-Oct,351507,334040,17467,5
El Paso County,2016-Nov,352752,335806,16946,4.8
El Paso County,2016-Dec,352083,334948,17135,4.9
El Paso County,2017-Jan,350743,332246,18497,5.3
El Paso County,2017-Feb,353234,334571,18663,5.3
El Paso County,2017-Mar,351783,334541,17242,4.9
El Paso County,2017-Apr,353008,337292,15716,4.5
El Paso County,2017-May,351313,335485,15828,4.5
El Paso County,2017-Jun,348853,331544,17309,5
El Paso County,2017-Jul,348661,331869,16792,4.8
El Paso County,2017-Aug,349307,332437,16870,4.8
El Paso County,2017-Sep,353393,337966,15427,4.4
El Paso County,2017-Oct,350932,336581,14351,4.1
El Paso County,2017-Nov,353887,338838,15049,4.3
El Paso County,2017-Dec,353366,338582,14784,4.2
El Paso County,2018-Jan,353958,337612,16346,4.6
El Paso County,2018-Feb,356455,340218,16237,4.6
El Paso County,2018-Mar,353960,338465,15495,4.4
El Paso County,2018-Apr,354799,340417,14382,4.1
El Paso County,2018-May,353673,339663,14010,4
El Paso County,2018-Jun,352057,335647,16410,4.7
El Paso County,2018-Jul,352891,337104,15787,4.5
El Paso County,2018-Aug,352484,337101,15383,4.4
El Paso County,2018-Sep,355180,340195,14985,4.2
El Paso County,2018-Oct,357232,343126,14106,3.9
El Paso County,2018-Nov,358660,344723,13937,3.9
El Paso County,2018-Dec,357836,343656,14180,4
El Paso County,2019-Jan,356832,340847,15985,4.5
El Paso County,2019-Feb,358784,343921,14863,4.1
El Paso County,2019-Mar,356905,343208,13697,3.8
El Paso County,2019-Apr,355643,343756,11887,3.3
El Paso County,2019-May,354979,342806,12173,3.4
El Paso County,2019-Jun,354520,339980,14540,4.1
El Paso County,2019-Jul,356157,341520,14637,4.1
El Paso County,2019-Aug,357176,342994,14182,4
El Paso County,2019-Sep,360737,347196,13541,3.8
El Paso County,2019-Oct,361630,348391,13239,3.7
El Paso County,2019-Nov,362793,349677,13116,3.6
El Paso County,2019-Dec,361693,349278,12415,3.4
El Paso County,2020-Jan,360598,346661,13937,3.9
El Paso County,2020-Feb,362366,349144,13222,3.6
El Paso County,2020-Mar,357404,337595,19809,5.5
El Paso County,2020-Apr,341555,294905,46650,13.7
El Paso County,2020-May,353650,306320,47330,13.4
El Paso County,2020-Jun,358621,317891,40730,11.4
El Paso County,2020-Jul,360785,324171,36614,10.1
El Paso County,2020-Aug,362666,333068,29598,8.2
El Paso County,2020-Sep,363901,335520,28381,7.8
El Paso County,2020-Oct,363606,338374,25232,6.9
El Paso County,2020-Nov,364885,336009,28876,7.9
El Paso County,2020-Dec,364726,337334,27392,7.5
El Paso County,2021-Jan,363319,335111,28208,7.8
El Paso County,2021-Feb,366601,338987,27614,7.5
El Paso County,2021-Mar,364078,338325,25753,7.1
El Paso County,2021-Apr,362036,338354,23682,6.5
El Paso County,2021-May,361322,338966,22356,6.2
El Paso County,2021-Jun,362116,336840,25276,7
El Paso County,2021-Jul,362870,339959,22911,6.3
El Paso County,2021-Aug,363699,342102,21597,5.9
El Paso County,2021-Sep,364398,344356,20042,5.5
El Paso County,2021-Oct,365623,346247,19376,5.3
El Paso County,2021-Nov,366621,348329,18292,5
El Paso County,2021-Dec,363442,346240,17202,4.7
El Paso County,2022-Jan,365338,345735,19603,5.4
El Paso County,2022-Feb,366804,347500,19304,5.3
El Paso County,2022-Mar,364193,348354,15839,4.3
El Paso County,2022-Apr,360377,345396,14981,4.2
El Paso County,2022-May,359062,343456,15606,4.3
El Paso County,2022-Jun,361868,344167,17701,4.9
El Paso County,2022-Jul,361618(P),344380(P),17238(P),4.8(P)
Erath County,2012-Jan,19819,18670,1149,5.8
Erath County,2012-Feb,19986,18865,1121,5.6
Erath County,2012-Mar,20010,18966,1044,5.2
Erath County,2012-Apr,20336,19307,1029,5.1
Erath County,2012-May,20511,19416,1095,5.3
Erath County,2012-Jun,20471,19212,1259,6.2
Erath County,2012-Jul,20055,18775,1280,6.4
Erath County,2012-Aug,19751,18605,1146,5.8
Erath County,2012-Sep,20116,19073,1043,5.2
Erath County,2012-Oct,19814,18793,1021,5.2
Erath County,2012-Nov,19752,18723,1029,5.2
Erath County,2012-Dec,19492,18437,1055,5.4
Erath County,2013-Jan,19365,18171,1194,6.2
Erath County,2013-Feb,19571,18468,1103,5.6
Erath County,2013-Mar,19430,18400,1030,5.3
Erath County,2013-Apr,20011,19016,995,5
Erath County,2013-May,20024,18935,1089,5.4
Erath County,2013-Jun,19947,18696,1251,6.3
Erath County,2013-Jul,19803,18576,1227,6.2
Erath County,2013-Aug,19658,18546,1112,5.7
Erath County,2013-Sep,20211,19131,1080,5.3
Erath County,2013-Oct,20092,19085,1007,5
Erath County,2013-Nov,19800,18840,960,4.8
Erath County,2013-Dec,19820,18927,893,4.5
Erath County,2014-Jan,19672,18741,931,4.7
Erath County,2014-Feb,20202,19229,973,4.8
Erath County,2014-Mar,20216,19328,888,4.4
Erath County,2014-Apr,20552,19782,770,3.7
Erath County,2014-May,20580,19728,852,4.1
Erath County,2014-Jun,20376,19383,993,4.9
Erath County,2014-Jul,19829,18795,1034,5.2
Erath County,2014-Aug,19481,18575,906,4.7
Erath County,2014-Sep,20024,19188,836,4.2
Erath County,2014-Oct,20221,19449,772,3.8
Erath County,2014-Nov,20066,19312,754,3.8
Erath County,2014-Dec,19621,18950,671,3.4
Erath County,2015-Jan,19844,19062,782,3.9
Erath County,2015-Feb,20254,19506,748,3.7
Erath County,2015-Mar,20377,19613,764,3.7
Erath County,2015-Apr,20386,19677,709,3.5
Erath County,2015-May,20701,19872,829,4
Erath County,2015-Jun,20319,19355,964,4.7
Erath County,2015-Jul,19839,18905,934,4.7
Erath County,2015-Aug,19517,18692,825,4.2
Erath County,2015-Sep,20204,19420,784,3.9
Erath County,2015-Oct,20476,19717,759,3.7
Erath County,2015-Nov,20129,19387,742,3.7
Erath County,2015-Dec,19974,19248,726,3.6
Erath County,2016-Jan,19672,18901,771,3.9
Erath County,2016-Feb,20690,19898,792,3.8
Erath County,2016-Mar,20722,19932,790,3.8
Erath County,2016-Apr,21100,20346,754,3.6
Erath County,2016-May,21229,20453,776,3.7
Erath County,2016-Jun,20329,19378,951,4.7
Erath County,2016-Jul,19521,18575,946,4.8
Erath County,2016-Aug,19598,18674,924,4.7
Erath County,2016-Sep,19916,19070,846,4.2
Erath County,2016-Oct,20127,19351,776,3.9
Erath County,2016-Nov,20090,19317,773,3.8
Erath County,2016-Dec,19887,19117,770,3.9
Erath County,2017-Jan,19719,18901,818,4.1
Erath County,2017-Feb,20651,19833,818,4
Erath County,2017-Mar,21130,20395,735,3.5
Erath County,2017-Apr,21212,20575,637,3
Erath County,2017-May,21128,20470,658,3.1
Erath County,2017-Jun,20944,20133,811,3.9
Erath County,2017-Jul,19422,18639,783,4
Erath County,2017-Aug,19658,18904,754,3.8
Erath County,2017-Sep,20198,19544,654,3.2
Erath County,2017-Oct,20835,20247,588,2.8
Erath County,2017-Nov,20776,20148,628,3
Erath County,2017-Dec,20713,20110,603,2.9
Erath County,2018-Jan,19673,18996,677,3.4
Erath County,2018-Feb,20667,19997,670,3.2
Erath County,2018-Mar,21200,20563,637,3
Erath County,2018-Apr,20327,19769,558,2.7
Erath County,2018-May,20920,20352,568,2.7
Erath County,2018-Jun,20425,19680,745,3.6
Erath County,2018-Jul,19965,19240,725,3.6
Erath County,2018-Aug,20256,19577,679,3.4
Erath County,2018-Sep,20465,19834,631,3.1
Erath County,2018-Oct,21135,20550,585,2.8
Erath County,2018-Nov,20902,20322,580,2.8
Erath County,2018-Dec,20685,20064,621,3
Erath County,2019-Jan,20085,19365,720,3.6
Erath County,2019-Feb,21130,20477,653,3.1
Erath County,2019-Mar,21258,20646,612,2.9
Erath County,2019-Apr,20296,19784,512,2.5
Erath County,2019-May,20826,20270,556,2.7
Erath County,2019-Jun,20220,19512,708,3.5
Erath County,2019-Jul,19755,19010,745,3.8
Erath County,2019-Aug,20435,19739,696,3.4
Erath County,2019-Sep,20354,19693,661,3.2
Erath County,2019-Oct,21225,20573,652,3.1
Erath County,2019-Nov,20888,20221,667,3.2
Erath County,2019-Dec,20777,20156,621,3
Erath County,2020-Jan,20355,19641,714,3.5
Erath County,2020-Feb,20760,20105,655,3.2
Erath County,2020-Mar,20380,19395,985,4.8
Erath County,2020-Apr,18427,16944,1483,8
Erath County,2020-May,19014,17465,1549,8.1
Erath County,2020-Jun,19189,17634,1555,8.1
Erath County,2020-Jul,19090,17674,1416,7.4
Erath County,2020-Aug,19712,18632,1080,5.5
Erath County,2020-Sep,19768,18687,1081,5.5
Erath County,2020-Oct,20676,19689,987,4.8
Erath County,2020-Nov,20333,19268,1065,5.2
Erath County,2020-Dec,20142,19070,1072,5.3
Erath County,2021-Jan,20355,19177,1178,5.8
Erath County,2021-Feb,21116,19989,1127,5.3
Erath County,2021-Mar,21535,20518,1017,4.7
Erath County,2021-Apr,21124,20241,883,4.2
Erath County,2021-May,20650,19794,856,4.1
Erath County,2021-Jun,20109,19030,1079,5.4
Erath County,2021-Jul,19561,18601,960,4.9
Erath County,2021-Aug,20034,19164,870,4.3
Erath County,2021-Sep,20294,19471,823,4.1
Erath County,2021-Oct,20812,20006,806,3.9
Erath County,2021-Nov,20503,19763,740,3.6
Erath County,2021-Dec,20262,19569,693,3.4
Erath County,2022-Jan,20238,19435,803,4
Erath County,2022-Feb,21376,20571,805,3.8
Erath County,2022-Mar,21875,21236,639,2.9
Erath County,2022-Apr,21843,21242,601,2.8
Erath County,2022-May,21372,20723,649,3
Erath County,2022-Jun,20701,19888,813,3.9
Erath County,2022-Jul,20709(P),19941(P),768(P),3.7(P)
Falls County,2012-Jan,6880,6313,567,8.2
Falls County,2012-Feb,6863,6320,543,7.9
Falls County,2012-Mar,6867,6373,494,7.2
Falls County,2012-Apr,6878,6412,466,6.8
Falls County,2012-May,6903,6409,494,7.2
Falls County,2012-Jun,6975,6436,539,7.7
Falls County,2012-Jul,6989,6451,538,7.7
Falls County,2012-Aug,6952,6431,521,7.5
Falls County,2012-Sep,6940,6456,484,7
Falls County,2012-Oct,6859,6403,456,6.6
Falls County,2012-Nov,6858,6403,455,6.6
Falls County,2012-Dec,6833,6359,474,6.9
Falls County,2013-Jan,6669,6154,515,7.7
Falls County,2013-Feb,6659,6192,467,7
Falls County,2013-Mar,6641,6189,452,6.8
Falls County,2013-Apr,6797,6327,470,6.9
Falls County,2013-May,6840,6343,497,7.3
Falls County,2013-Jun,6903,6358,545,7.9
Falls County,2013-Jul,6918,6377,541,7.8
Falls County,2013-Aug,6843,6327,516,7.5
Falls County,2013-Sep,6846,6354,492,7.2
Falls County,2013-Oct,6724,6265,459,6.8
Falls County,2013-Nov,6676,6237,439,6.6
Falls County,2013-Dec,6676,6273,403,6
Falls County,2014-Jan,6440,6046,394,6.1
Falls County,2014-Feb,6493,6107,386,5.9
Falls County,2014-Mar,6509,6133,376,5.8
Falls County,2014-Apr,6594,6267,327,5
Falls County,2014-May,6630,6259,371,5.6
Falls County,2014-Jun,6613,6220,393,5.9
Falls County,2014-Jul,6608,6208,400,6.1
Falls County,2014-Aug,6539,6143,396,6.1
Falls County,2014-Sep,6563,6187,376,5.7
Falls County,2014-Oct,6526,6194,332,5.1
Falls County,2014-Nov,6504,6181,323,5
Falls County,2014-Dec,6453,6165,288,4.5
Falls County,2015-Jan,6401,6096,305,4.8
Falls County,2015-Feb,6443,6148,295,4.6
Falls County,2015-Mar,6438,6159,279,4.3
Falls County,2015-Apr,6424,6167,257,4
Falls County,2015-May,6464,6191,273,4.2
Falls County,2015-Jun,6480,6187,293,4.5
Falls County,2015-Jul,6497,6194,303,4.7
Falls County,2015-Aug,6450,6181,269,4.2
Falls County,2015-Sep,6455,6188,267,4.1
Falls County,2015-Oct,6481,6221,260,4
Falls County,2015-Nov,6468,6209,259,4
Falls County,2015-Dec,6483,6235,248,3.8
Falls County,2016-Jan,6423,6152,271,4.2
Falls County,2016-Feb,6580,6309,271,4.1
Falls County,2016-Mar,6623,6335,288,4.3
Falls County,2016-Apr,6634,6351,283,4.3
Falls County,2016-May,6643,6376,267,4
Falls County,2016-Jun,6644,6319,325,4.9
Falls County,2016-Jul,6598,6287,311,4.7
Falls County,2016-Aug,6653,6357,296,4.4
Falls County,2016-Sep,6660,6343,317,4.8
Falls County,2016-Oct,6638,6336,302,4.5
Falls County,2016-Nov,6642,6356,286,4.3
Falls County,2016-Dec,6617,6335,282,4.3
Falls County,2017-Jan,6540,6241,299,4.6
Falls County,2017-Feb,6621,6312,309,4.7
Falls County,2017-Mar,6700,6402,298,4.4
Falls County,2017-Apr,6663,6398,265,4
Falls County,2017-May,6654,6378,276,4.1
Falls County,2017-Jun,6634,6328,306,4.6
Falls County,2017-Jul,6581,6280,301,4.6
Falls County,2017-Aug,6621,6329,292,4.4
Falls County,2017-Sep,6579,6316,263,4
Falls County,2017-Oct,6540,6289,251,3.8
Falls County,2017-Nov,6530,6262,268,4.1
Falls County,2017-Dec,6516,6266,250,3.8
Falls County,2018-Jan,6333,6046,287,4.5
Falls County,2018-Feb,6420,6140,280,4.4
Falls County,2018-Mar,6468,6211,257,4
Falls County,2018-Apr,6435,6202,233,3.6
Falls County,2018-May,6472,6238,234,3.6
Falls County,2018-Jun,6516,6224,292,4.5
Falls County,2018-Jul,6489,6210,279,4.3
Falls County,2018-Aug,6498,6236,262,4
Falls County,2018-Sep,6465,6220,245,3.8
Falls County,2018-Oct,6452,6228,224,3.5
Falls County,2018-Nov,6462,6238,224,3.5
Falls County,2018-Dec,6397,6174,223,3.5
Falls County,2019-Jan,6319,6072,247,3.9
Falls County,2019-Feb,6374,6149,225,3.5
Falls County,2019-Mar,6416,6197,219,3.4
Falls County,2019-Apr,6368,6187,181,2.8
Falls County,2019-May,6390,6199,191,3
Falls County,2019-Jun,6415,6188,227,3.5
Falls County,2019-Jul,6457,6226,231,3.6
Falls County,2019-Aug,6478,6270,208,3.2
Falls County,2019-Sep,6431,6226,205,3.2
Falls County,2019-Oct,6449,6248,201,3.1
Falls County,2019-Nov,6376,6183,193,3
Falls County,2019-Dec,6392,6202,190,3
Falls County,2020-Jan,6326,6106,220,3.5
Falls County,2020-Feb,6385,6172,213,3.3
Falls County,2020-Mar,6317,5987,330,5.2
Falls County,2020-Apr,5919,5419,500,8.4
Falls County,2020-May,6170,5661,509,8.2
Falls County,2020-Jun,6325,5811,514,8.1
Falls County,2020-Jul,6364,5888,476,7.5
Falls County,2020-Aug,6490,6090,400,6.2
Falls County,2020-Sep,6430,6046,384,6
Falls County,2020-Oct,6485,6143,342,5.3
Falls County,2020-Nov,6468,6093,375,5.8
Falls County,2020-Dec,6470,6094,376,5.8
Falls County,2021-Jan,6458,6080,378,5.9
Falls County,2021-Feb,6548,6153,395,6
Falls County,2021-Mar,6635,6205,430,6.5
Falls County,2021-Apr,6585,6240,345,5.2
Falls County,2021-May,6529,6179,350,5.4
Falls County,2021-Jun,6508,6122,386,5.9
Falls County,2021-Jul,6571,6214,357,5.4
Falls County,2021-Aug,6618,6274,344,5.2
Falls County,2021-Sep,6630,6293,337,5.1
Falls County,2021-Oct,6643,6328,315,4.7
Falls County,2021-Nov,6606,6310,296,4.5
Falls County,2021-Dec,6588,6319,269,4.1
Falls County,2022-Jan,6632,6320,312,4.7
Falls County,2022-Feb,6797,6496,301,4.4
Falls County,2022-Mar,6860,6608,252,3.7
Falls County,2022-Apr,6807,6563,244,3.6
Falls County,2022-May,6749,6487,262,3.9
Falls County,2022-Jun,6776,6476,300,4.4
Falls County,2022-Jul,6867(P),6563(P),304(P),4.4(P)
Fannin County,2012-Jan,14916,13754,1162,7.8
Fannin County,2012-Feb,14931,13816,1115,7.5
Fannin County,2012-Mar,14905,13859,1046,7
Fannin County,2012-Apr,14973,13993,980,6.5
Fannin County,2012-May,15062,14032,1030,6.8
Fannin County,2012-Jun,15162,14039,1123,7.4
Fannin County,2012-Jul,15162,14045,1117,7.4
Fannin County,2012-Aug,15027,13962,1065,7.1
Fannin County,2012-Sep,15043,14055,988,6.6
Fannin County,2012-Oct,15048,14065,983,6.5
Fannin County,2012-Nov,14977,14031,946,6.3
Fannin County,2012-Dec,15171,14057,1114,7.3
Fannin County,2013-Jan,15138,13904,1234,8.2
Fannin County,2013-Feb,15152,13986,1166,7.7
Fannin County,2013-Mar,15138,14015,1123,7.4
Fannin County,2013-Apr,15203,14134,1069,7
Fannin County,2013-May,15265,14195,1070,7
Fannin County,2013-Jun,15387,14240,1147,7.5
Fannin County,2013-Jul,15380,14270,1110,7.2
Fannin County,2013-Aug,15312,14271,1041,6.8
Fannin County,2013-Sep,15394,14346,1048,6.8
Fannin County,2013-Oct,15252,14240,1012,6.6
Fannin County,2013-Nov,15224,14267,957,6.3
Fannin County,2013-Dec,15195,14302,893,5.9
Fannin County,2014-Jan,15205,14289,916,6
Fannin County,2014-Feb,15312,14387,925,6
Fannin County,2014-Mar,15306,14435,871,5.7
Fannin County,2014-Apr,15312,14541,771,5
Fannin County,2014-May,15328,14510,818,5.3
Fannin County,2014-Jun,15390,14529,861,5.6
Fannin County,2014-Jul,15415,14521,894,5.8
Fannin County,2014-Aug,15266,14407,859,5.6
Fannin County,2014-Sep,15259,14457,802,5.3
Fannin County,2014-Oct,15171,14417,754,5
Fannin County,2014-Nov,15099,14371,728,4.8
Fannin County,2014-Dec,15021,14351,670,4.5
Fannin County,2015-Jan,15205,14467,738,4.9
Fannin County,2015-Feb,15316,14630,686,4.5
Fannin County,2015-Mar,15255,14614,641,4.2
Fannin County,2015-Apr,15329,14736,593,3.9
Fannin County,2015-May,15403,14777,626,4.1
Fannin County,2015-Jun,15454,14786,668,4.3
Fannin County,2015-Jul,15531,14861,670,4.3
Fannin County,2015-Aug,15403,14775,628,4.1
Fannin County,2015-Sep,15405,14785,620,4
Fannin County,2015-Oct,15407,14804,603,3.9
Fannin County,2015-Nov,15408,14811,597,3.9
Fannin County,2015-Dec,15459,14901,558,3.6
Fannin County,2016-Jan,15476,14894,582,3.8
Fannin County,2016-Feb,15773,15189,584,3.7
Fannin County,2016-Mar,15751,15181,570,3.6
Fannin County,2016-Apr,15698,15168,530,3.4
Fannin County,2016-May,15718,15167,551,3.5
Fannin County,2016-Jun,15758,15124,634,4
Fannin County,2016-Jul,15834,15174,660,4.2
Fannin County,2016-Aug,15852,15224,628,4
Fannin County,2016-Sep,15877,15248,629,4
Fannin County,2016-Oct,15804,15210,594,3.8
Fannin County,2016-Nov,15935,15338,597,3.7
Fannin County,2016-Dec,15808,15227,581,3.7
Fannin County,2017-Jan,15645,15015,630,4
Fannin County,2017-Feb,15780,15151,629,4
Fannin County,2017-Mar,15887,15305,582,3.7
Fannin County,2017-Apr,15888,15368,520,3.3
Fannin County,2017-May,15871,15345,526,3.3
Fannin County,2017-Jun,15826,15272,554,3.5
Fannin County,2017-Jul,15932,15386,546,3.4
Fannin County,2017-Aug,15928,15379,549,3.4
Fannin County,2017-Sep,15902,15418,484,3
Fannin County,2017-Oct,15794,15353,441,2.8
Fannin County,2017-Nov,15801,15329,472,3
Fannin County,2017-Dec,15733,15269,464,2.9
Fannin County,2018-Jan,15908,15372,536,3.4
Fannin County,2018-Feb,16052,15512,540,3.4
Fannin County,2018-Mar,16054,15534,520,3.2
Fannin County,2018-Apr,16113,15629,484,3
Fannin County,2018-May,16192,15714,478,3
Fannin County,2018-Jun,16183,15639,544,3.4
Fannin County,2018-Jul,16378,15857,521,3.2
Fannin County,2018-Aug,16393,15871,522,3.2
Fannin County,2018-Sep,16556,16056,500,3
Fannin County,2018-Oct,16580,16103,477,2.9
Fannin County,2018-Nov,16598,16113,485,2.9
Fannin County,2018-Dec,16580,16100,480,2.9
Fannin County,2019-Jan,16824,16260,564,3.4
Fannin County,2019-Feb,16935,16431,504,3
Fannin County,2019-Mar,16978,16487,491,2.9
Fannin County,2019-Apr,16955,16548,407,2.4
Fannin County,2019-May,17076,16654,422,2.5
Fannin County,2019-Jun,17123,16625,498,2.9
Fannin County,2019-Jul,17295,16777,518,3
Fannin County,2019-Aug,17298,16811,487,2.8
Fannin County,2019-Sep,17233,16767,466,2.7
Fannin County,2019-Oct,17417,16960,457,2.6
Fannin County,2019-Nov,17341,16897,444,2.6
Fannin County,2019-Dec,17259,16853,406,2.4
Fannin County,2020-Jan,16704,16238,466,2.8
Fannin County,2020-Feb,16829,16383,446,2.7
Fannin County,2020-Mar,16514,15837,677,4.1
Fannin County,2020-Apr,15490,14424,1066,6.9
Fannin County,2020-May,16020,14944,1076,6.7
Fannin County,2020-Jun,16365,15330,1035,6.3
Fannin County,2020-Jul,16601,15647,954,5.7
Fannin County,2020-Aug,16782,16016,766,4.6
Fannin County,2020-Sep,16834,16076,758,4.5
Fannin County,2020-Oct,16995,16316,679,4
Fannin County,2020-Nov,16974,16243,731,4.3
Fannin County,2020-Dec,16965,16219,746,4.4
Fannin County,2021-Jan,17137,16344,793,4.6
Fannin County,2021-Feb,17352,16512,840,4.8
Fannin County,2021-Mar,17207,16413,794,4.6
Fannin County,2021-Apr,17164,16483,681,4
Fannin County,2021-May,17006,16331,675,4
Fannin County,2021-Jun,16997,16230,767,4.5
Fannin County,2021-Jul,17138,16455,683,4
Fannin County,2021-Aug,17128,16461,667,3.9
Fannin County,2021-Sep,17176,16546,630,3.7
Fannin County,2021-Oct,17228,16617,611,3.5
Fannin County,2021-Nov,17254,16669,585,3.4
Fannin County,2021-Dec,17196,16673,523,3
Fannin County,2022-Jan,17247,16650,597,3.5
Fannin County,2022-Feb,17520,16911,609,3.5
Fannin County,2022-Mar,17536,17031,505,2.9
Fannin County,2022-Apr,17445,16973,472,2.7
Fannin County,2022-May,17383,16875,508,2.9
Fannin County,2022-Jun,17352,16766,586,3.4
Fannin County,2022-Jul,17474(P),16910(P),564(P),3.2(P)
Fayette County,2012-Jan,12287,11639,648,5.3
Fayette County,2012-Feb,12196,11577,619,5.1
Fayette County,2012-Mar,12275,11692,583,4.7
Fayette County,2012-Apr,12352,11801,551,4.5
Fayette County,2012-May,12411,11817,594,4.8
Fayette County,2012-Jun,12707,12045,662,5.2
Fayette County,2012-Jul,12840,12164,676,5.3
Fayette County,2012-Aug,12649,12038,611,4.8
Fayette County,2012-Sep,12603,12032,571,4.5
Fayette County,2012-Oct,12575,12003,572,4.5
Fayette County,2012-Nov,12502,11948,554,4.4
Fayette County,2012-Dec,12548,11986,562,4.5
Fayette County,2013-Jan,12483,11848,635,5.1
Fayette County,2013-Feb,12452,11873,579,4.6
Fayette County,2013-Mar,12376,11802,574,4.6
Fayette County,2013-Apr,12548,12010,538,4.3
Fayette County,2013-May,12599,12035,564,4.5
Fayette County,2013-Jun,12827,12188,639,5
Fayette County,2013-Jul,12980,12361,619,4.8
Fayette County,2013-Aug,12751,12175,576,4.5
Fayette County,2013-Sep,12787,12209,578,4.5
Fayette County,2013-Oct,12573,12042,531,4.2
Fayette County,2013-Nov,12556,12057,499,4
Fayette County,2013-Dec,12672,12206,466,3.7
Fayette County,2014-Jan,12896,12417,479,3.7
Fayette County,2014-Feb,12991,12512,479,3.7
Fayette County,2014-Mar,12961,12505,456,3.5
Fayette County,2014-Apr,13034,12645,389,3
Fayette County,2014-May,13133,12692,441,3.4
Fayette County,2014-Jun,13219,12734,485,3.7
Fayette County,2014-Jul,13388,12871,517,3.9
Fayette County,2014-Aug,13161,12668,493,3.7
Fayette County,2014-Sep,13069,12607,462,3.5
Fayette County,2014-Oct,12999,12563,436,3.4
Fayette County,2014-Nov,12923,12507,416,3.2
Fayette County,2014-Dec,12856,12470,386,3
Fayette County,2015-Jan,12980,12546,434,3.3
Fayette County,2015-Feb,12956,12538,418,3.2
Fayette County,2015-Mar,12925,12538,387,3
Fayette County,2015-Apr,12909,12528,381,3
Fayette County,2015-May,12969,12561,408,3.1
Fayette County,2015-Jun,12941,12481,460,3.6
Fayette County,2015-Jul,12792,12321,471,3.7
Fayette County,2015-Aug,12644,12193,451,3.6
Fayette County,2015-Sep,12549,12100,449,3.6
Fayette County,2015-Oct,12614,12185,429,3.4
Fayette County,2015-Nov,12521,12097,424,3.4
Fayette County,2015-Dec,12527,12118,409,3.3
Fayette County,2016-Jan,12431,12013,418,3.4
Fayette County,2016-Feb,12556,12126,430,3.4
Fayette County,2016-Mar,12622,12174,448,3.5
Fayette County,2016-Apr,12642,12222,420,3.3
Fayette County,2016-May,12631,12216,415,3.3
Fayette County,2016-Jun,12688,12206,482,3.8
Fayette County,2016-Jul,12546,12040,506,4
Fayette County,2016-Aug,12520,12027,493,3.9
Fayette County,2016-Sep,12354,11862,492,4
Fayette County,2016-Oct,12323,11856,467,3.8
Fayette County,2016-Nov,12327,11875,452,3.7
Fayette County,2016-Dec,12304,11845,459,3.7
Fayette County,2017-Jan,12338,11847,491,4
Fayette County,2017-Feb,12480,12004,476,3.8
Fayette County,2017-Mar,12599,12173,426,3.4
Fayette County,2017-Apr,12623,12257,366,2.9
Fayette County,2017-May,12645,12275,370,2.9
Fayette County,2017-Jun,12735,12342,393,3.1
Fayette County,2017-Jul,12688,12283,405,3.2
Fayette County,2017-Aug,12575,12172,403,3.2
Fayette County,2017-Sep,12491,12112,379,3
Fayette County,2017-Oct,12439,12085,354,2.8
Fayette County,2017-Nov,12060,11674,386,3.2
Fayette County,2017-Dec,12122,11750,372,3.1
Fayette County,2018-Jan,12378,11982,396,3.2
Fayette County,2018-Feb,12495,12104,391,3.1
Fayette County,2018-Mar,12579,12201,378,3
Fayette County,2018-Apr,12464,12132,332,2.7
Fayette County,2018-May,12539,12211,328,2.6
Fayette County,2018-Jun,12535,12149,386,3.1
Fayette County,2018-Jul,12510,12141,369,2.9
Fayette County,2018-Aug,12472,12122,350,2.8
Fayette County,2018-Sep,12456,12114,342,2.7
Fayette County,2018-Oct,12498,12178,320,2.6
Fayette County,2018-Nov,12386,12065,321,2.6
Fayette County,2018-Dec,12394,12078,316,2.5
Fayette County,2019-Jan,12279,11918,361,2.9
Fayette County,2019-Feb,12386,12051,335,2.7
Fayette County,2019-Mar,12396,12051,345,2.8
Fayette County,2019-Apr,12247,11965,282,2.3
Fayette County,2019-May,12310,12010,300,2.4
Fayette County,2019-Jun,12383,12023,360,2.9
Fayette County,2019-Jul,12232,11867,365,3
Fayette County,2019-Aug,12262,11920,342,2.8
Fayette County,2019-Sep,12088,11777,311,2.6
Fayette County,2019-Oct,12239,11940,299,2.4
Fayette County,2019-Nov,12079,11787,292,2.4
Fayette County,2019-Dec,12079,11806,273,2.3
Fayette County,2020-Jan,11995,11676,319,2.7
Fayette County,2020-Feb,12068,11768,300,2.5
Fayette County,2020-Mar,11834,11366,468,4
Fayette County,2020-Apr,10964,10304,660,6
Fayette County,2020-May,11339,10637,702,6.2
Fayette County,2020-Jun,11604,10923,681,5.9
Fayette County,2020-Jul,11668,11014,654,5.6
Fayette County,2020-Aug,11762,11209,553,4.7
Fayette County,2020-Sep,11723,11147,576,4.9
Fayette County,2020-Oct,11729,11214,515,4.4
Fayette County,2020-Nov,11718,11134,584,5
Fayette County,2020-Dec,11687,11099,588,5
Fayette County,2021-Jan,11752,11147,605,5.1
Fayette County,2021-Feb,11804,11203,601,5.1
Fayette County,2021-Mar,11976,11398,578,4.8
Fayette County,2021-Apr,12030,11518,512,4.3
Fayette County,2021-May,11927,11427,500,4.2
Fayette County,2021-Jun,11942,11383,559,4.7
Fayette County,2021-Jul,12006,11492,514,4.3
Fayette County,2021-Aug,11883,11388,495,4.2
Fayette County,2021-Sep,11815,11354,461,3.9
Fayette County,2021-Oct,11782,11339,443,3.8
Fayette County,2021-Nov,11716,11285,431,3.7
Fayette County,2021-Dec,11652,11262,390,3.3
Fayette County,2022-Jan,11667,11225,442,3.8
Fayette County,2022-Feb,11802,11352,450,3.8
Fayette County,2022-Mar,11978,11609,369,3.1
Fayette County,2022-Apr,11699,11355,344,2.9
Fayette County,2022-May,11708,11334,374,3.2
Fayette County,2022-Jun,11749,11315,434,3.7
Fayette County,2022-Jul,11844(P),11413(P),431(P),3.6(P)
Fisher County,2012-Jan,1889,1777,112,5.9
Fisher County,2012-Feb,1880,1776,104,5.5
Fisher County,2012-Mar,1880,1784,96,5.1
Fisher County,2012-Apr,1902,1807,95,5
Fisher County,2012-May,1912,1812,100,5.2
Fisher County,2012-Jun,1950,1835,115,5.9
Fisher County,2012-Jul,1941,1826,115,5.9
Fisher County,2012-Aug,1908,1796,112,5.9
Fisher County,2012-Sep,1914,1813,101,5.3
Fisher County,2012-Oct,1903,1809,94,4.9
Fisher County,2012-Nov,1887,1796,91,4.8
Fisher County,2012-Dec,1877,1785,92,4.9
Fisher County,2013-Jan,1834,1728,106,5.8
Fisher County,2013-Feb,1829,1729,100,5.5
Fisher County,2013-Mar,1832,1732,100,5.5
Fisher County,2013-Apr,1873,1776,97,5.2
Fisher County,2013-May,1903,1797,106,5.6
Fisher County,2013-Jun,1928,1807,121,6.3
Fisher County,2013-Jul,1929,1812,117,6.1
Fisher County,2013-Aug,1890,1783,107,5.7
Fisher County,2013-Sep,1898,1793,105,5.5
Fisher County,2013-Oct,1908,1808,100,5.2
Fisher County,2013-Nov,1868,1781,87,4.7
Fisher County,2013-Dec,1886,1802,84,4.5
Fisher County,2014-Jan,1868,1776,92,4.9
Fisher County,2014-Feb,1880,1788,92,4.9
Fisher County,2014-Mar,1881,1791,90,4.8
Fisher County,2014-Apr,1868,1786,82,4.4
Fisher County,2014-May,1881,1792,89,4.7
Fisher County,2014-Jun,1881,1789,92,4.9
Fisher County,2014-Jul,1882,1787,95,5
Fisher County,2014-Aug,1864,1772,92,4.9
Fisher County,2014-Sep,1858,1774,84,4.5
Fisher County,2014-Oct,1861,1788,73,3.9
Fisher County,2014-Nov,1815,1744,71,3.9
Fisher County,2014-Dec,1788,1725,63,3.5
Fisher County,2015-Jan,1753,1681,72,4.1
Fisher County,2015-Feb,1786,1712,74,4.1
Fisher County,2015-Mar,1808,1735,73,4
Fisher County,2015-Apr,1823,1765,58,3.2
Fisher County,2015-May,1851,1787,64,3.5
Fisher County,2015-Jun,1855,1784,71,3.8
Fisher County,2015-Jul,1846,1772,74,4
Fisher County,2015-Aug,1795,1729,66,3.7
Fisher County,2015-Sep,1775,1706,69,3.9
Fisher County,2015-Oct,1784,1707,77,4.3
Fisher County,2015-Nov,1771,1697,74,4.2
Fisher County,2015-Dec,1766,1700,66,3.7
Fisher County,2016-Jan,1745,1675,70,4
Fisher County,2016-Feb,1786,1711,75,4.2
Fisher County,2016-Mar,1816,1738,78,4.3
Fisher County,2016-Apr,1808,1734,74,4.1
Fisher County,2016-May,1809,1735,74,4.1
Fisher County,2016-Jun,1805,1725,80,4.4
Fisher County,2016-Jul,1749,1668,81,4.6
Fisher County,2016-Aug,1758,1678,80,4.6
Fisher County,2016-Sep,1711,1628,83,4.9
Fisher County,2016-Oct,1707,1635,72,4.2
Fisher County,2016-Nov,1706,1633,73,4.3
Fisher County,2016-Dec,1718,1649,69,4
Fisher County,2017-Jan,1679,1605,74,4.4
Fisher County,2017-Feb,1699,1628,71,4.2
Fisher County,2017-Mar,1732,1667,65,3.8
Fisher County,2017-Apr,1708,1648,60,3.5
Fisher County,2017-May,1731,1667,64,3.7
Fisher County,2017-Jun,1712,1650,62,3.6
Fisher County,2017-Jul,1708,1645,63,3.7
Fisher County,2017-Aug,1686,1627,59,3.5
Fisher County,2017-Sep,1657,1599,58,3.5
Fisher County,2017-Oct,1679,1629,50,3
Fisher County,2017-Nov,1652,1599,53,3.2
Fisher County,2017-Dec,1647,1598,49,3
Fisher County,2018-Jan,1640,1579,61,3.7
Fisher County,2018-Feb,1634,1576,58,3.5
Fisher County,2018-Mar,1677,1622,55,3.3
Fisher County,2018-Apr,1643,1595,48,2.9
Fisher County,2018-May,1657,1609,48,2.9
Fisher County,2018-Jun,1639,1582,57,3.5
Fisher County,2018-Jul,1638,1580,58,3.5
Fisher County,2018-Aug,1651,1596,55,3.3
Fisher County,2018-Sep,1634,1582,52,3.2
Fisher County,2018-Oct,1625,1575,50,3.1
Fisher County,2018-Nov,1614,1566,48,3
Fisher County,2018-Dec,1562,1515,47,3
Fisher County,2019-Jan,1570,1518,52,3.3
Fisher County,2019-Feb,1591,1544,47,3
Fisher County,2019-Mar,1623,1575,48,3
Fisher County,2019-Apr,1600,1562,38,2.4
Fisher County,2019-May,1614,1573,41,2.5
Fisher County,2019-Jun,1637,1578,59,3.6
Fisher County,2019-Jul,1631,1573,58,3.6
Fisher County,2019-Aug,1655,1599,56,3.4
Fisher County,2019-Sep,1601,1550,51,3.2
Fisher County,2019-Oct,1633,1591,42,2.6
Fisher County,2019-Nov,1597,1556,41,2.6
Fisher County,2019-Dec,1584,1549,35,2.2
Fisher County,2020-Jan,1589,1545,44,2.8
Fisher County,2020-Feb,1596,1557,39,2.4
Fisher County,2020-Mar,1607,1547,60,3.7
Fisher County,2020-Apr,1503,1443,60,4
Fisher County,2020-May,1545,1457,88,5.7
Fisher County,2020-Jun,1551,1460,91,5.9
Fisher County,2020-Jul,1587,1495,92,5.8
Fisher County,2020-Aug,1618,1544,74,4.6
Fisher County,2020-Sep,1596,1518,78,4.9
Fisher County,2020-Oct,1619,1548,71,4.4
Fisher County,2020-Nov,1614,1540,74,4.6
Fisher County,2020-Dec,1585,1505,80,5
Fisher County,2021-Jan,1609,1525,84,5.2
Fisher County,2021-Feb,1644,1562,82,5
Fisher County,2021-Mar,1669,1583,86,5.2
Fisher County,2021-Apr,1642,1571,71,4.3
Fisher County,2021-May,1596,1529,67,4.2
Fisher County,2021-Jun,1590,1518,72,4.5
Fisher County,2021-Jul,1601,1531,70,4.4
Fisher County,2021-Aug,1620,1554,66,4.1
Fisher County,2021-Sep,1597,1534,63,3.9
Fisher County,2021-Oct,1585,1531,54,3.4
Fisher County,2021-Nov,1575,1524,51,3.2
Fisher County,2021-Dec,1539,1491,48,3.1
Fisher County,2022-Jan,1558,1500,58,3.7
Fisher County,2022-Feb,1623,1567,56,3.5
Fisher County,2022-Mar,1669,1619,50,3
Fisher County,2022-Apr,1629,1586,43,2.6
Fisher County,2022-May,1595,1544,51,3.2
Fisher County,2022-Jun,1590,1529,61,3.8
Fisher County,2022-Jul,1642(P),1584(P),58(P),3.5(P)
Floyd County,2012-Jan,3196,2952,244,7.6
Floyd County,2012-Feb,3161,2919,242,7.7
Floyd County,2012-Mar,3161,2954,207,6.5
Floyd County,2012-Apr,3241,3050,191,5.9
Floyd County,2012-May,3261,3058,203,6.2
Floyd County,2012-Jun,3317,3093,224,6.8
Floyd County,2012-Jul,3254,3035,219,6.7
Floyd County,2012-Aug,3203,3000,203,6.3
Floyd County,2012-Sep,3172,2986,186,5.9
Floyd County,2012-Oct,3142,2971,171,5.4
Floyd County,2012-Nov,3106,2942,164,5.3
Floyd County,2012-Dec,3071,2876,195,6.3
Floyd County,2013-Jan,3043,2802,241,7.9
Floyd County,2013-Feb,3114,2822,292,9.4
Floyd County,2013-Mar,3075,2817,258,8.4
Floyd County,2013-Apr,3140,2847,293,9.3
Floyd County,2013-May,3201,2900,301,9.4
Floyd County,2013-Jun,3245,2931,314,9.7
Floyd County,2013-Jul,3238,2930,308,9.5
Floyd County,2013-Aug,3123,2841,282,9
Floyd County,2013-Sep,3113,2828,285,9.2
Floyd County,2013-Oct,3103,2849,254,8.2
Floyd County,2013-Nov,3001,2742,259,8.6
Floyd County,2013-Dec,3015,2773,242,8
Floyd County,2014-Jan,3049,2779,270,8.9
Floyd County,2014-Feb,3109,2833,276,8.9
Floyd County,2014-Mar,3061,2807,254,8.3
Floyd County,2014-Apr,3063,2865,198,6.5
Floyd County,2014-May,3093,2877,216,7
Floyd County,2014-Jun,3031,2811,220,7.3
Floyd County,2014-Jul,2987,2768,219,7.3
Floyd County,2014-Aug,2921,2711,210,7.2
Floyd County,2014-Sep,2870,2675,195,6.8
Floyd County,2014-Oct,2868,2684,184,6.4
Floyd County,2014-Nov,2779,2611,168,6
Floyd County,2014-Dec,2707,2545,162,6
Floyd County,2015-Jan,2718,2521,197,7.2
Floyd County,2015-Feb,2776,2581,195,7
Floyd County,2015-Mar,2804,2617,187,6.7
Floyd County,2015-Apr,2770,2617,153,5.5
Floyd County,2015-May,2827,2665,162,5.7
Floyd County,2015-Jun,2834,2668,166,5.9
Floyd County,2015-Jul,2801,2647,154,5.5
Floyd County,2015-Aug,2724,2586,138,5.1
Floyd County,2015-Sep,2701,2564,137,5.1
Floyd County,2015-Oct,2718,2597,121,4.5
Floyd County,2015-Nov,2644,2526,118,4.5
Floyd County,2015-Dec,2636,2526,110,4.2
Floyd County,2016-Jan,2613,2468,145,5.5
Floyd County,2016-Feb,2757,2608,149,5.4
Floyd County,2016-Mar,2787,2634,153,5.5
Floyd County,2016-Apr,2803,2674,129,4.6
Floyd County,2016-May,2863,2741,122,4.3
Floyd County,2016-Jun,2840,2692,148,5.2
Floyd County,2016-Jul,2749,2600,149,5.4
Floyd County,2016-Aug,2775,2635,140,5
Floyd County,2016-Sep,2714,2575,139,5.1
Floyd County,2016-Oct,2695,2564,131,4.9
Floyd County,2016-Nov,2646,2527,119,4.5
Floyd County,2016-Dec,2618,2482,136,5.2
Floyd County,2017-Jan,2596,2443,153,5.9
Floyd County,2017-Feb,2672,2504,168,6.3
Floyd County,2017-Mar,2780,2619,161,5.8
Floyd County,2017-Apr,2744,2583,161,5.9
Floyd County,2017-May,2769,2621,148,5.3
Floyd County,2017-Jun,2747,2592,155,5.6
Floyd County,2017-Jul,2660,2501,159,6
Floyd County,2017-Aug,2695,2544,151,5.6
Floyd County,2017-Sep,2580,2451,129,5
Floyd County,2017-Oct,2695,2573,122,4.5
Floyd County,2017-Nov,2627,2497,130,4.9
Floyd County,2017-Dec,2611,2480,131,5
Floyd County,2018-Jan,2614,2465,149,5.7
Floyd County,2018-Feb,2649,2499,150,5.7
Floyd County,2018-Mar,2761,2605,156,5.7
Floyd County,2018-Apr,2690,2547,143,5.3
Floyd County,2018-May,2769,2638,131,4.7
Floyd County,2018-Jun,2691,2542,149,5.5
Floyd County,2018-Jul,2667,2520,147,5.5
Floyd County,2018-Aug,2667,2526,141,5.3
Floyd County,2018-Sep,2595,2459,136,5.2
Floyd County,2018-Oct,2589,2461,128,4.9
Floyd County,2018-Nov,2564,2454,110,4.3
Floyd County,2018-Dec,2484,2365,119,4.8
Floyd County,2019-Jan,2448,2316,132,5.4
Floyd County,2019-Feb,2531,2391,140,5.5
Floyd County,2019-Mar,2577,2450,127,4.9
Floyd County,2019-Apr,2522,2420,102,4
Floyd County,2019-May,2563,2457,106,4.1
Floyd County,2019-Jun,2559,2447,112,4.4
Floyd County,2019-Jul,2569,2448,121,4.7
Floyd County,2019-Aug,2628,2513,115,4.4
Floyd County,2019-Sep,2517,2417,100,4
Floyd County,2019-Oct,2558,2466,92,3.6
Floyd County,2019-Nov,2483,2393,90,3.6
Floyd County,2019-Dec,2489,2397,92,3.7
Floyd County,2020-Jan,2480,2348,132,5.3
Floyd County,2020-Feb,2513,2387,126,5
Floyd County,2020-Mar,2527,2335,192,7.6
Floyd County,2020-Apr,2381,2214,167,7
Floyd County,2020-May,2430,2246,184,7.6
Floyd County,2020-Jun,2459,2277,182,7.4
Floyd County,2020-Jul,2488,2311,177,7.1
Floyd County,2020-Aug,2543,2399,144,5.7
Floyd County,2020-Sep,2454,2322,132,5.4
Floyd County,2020-Oct,2512,2389,123,4.9
Floyd County,2020-Nov,2470,2336,134,5.4
Floyd County,2020-Dec,2466,2314,152,6.2
Floyd County,2021-Jan,2532,2350,182,7.2
Floyd County,2021-Feb,2584,2404,180,7
Floyd County,2021-Mar,2652,2472,180,6.8
Floyd County,2021-Apr,2582,2439,143,5.5
Floyd County,2021-May,2491,2355,136,5.5
Floyd County,2021-Jun,2489,2326,163,6.5
Floyd County,2021-Jul,2480,2332,148,6
Floyd County,2021-Aug,2496,2362,134,5.4
Floyd County,2021-Sep,2480,2353,127,5.1
Floyd County,2021-Oct,2452,2335,117,4.8
Floyd County,2021-Nov,2418,2303,115,4.8
Floyd County,2021-Dec,2379,2277,102,4.3
Floyd County,2022-Jan,2402,2280,122,5.1
Floyd County,2022-Feb,2537,2416,121,4.8
Floyd County,2022-Mar,2618,2516,102,3.9
Floyd County,2022-Apr,2581,2484,97,3.8
Floyd County,2022-May,2504,2400,104,4.2
Floyd County,2022-Jun,2488,2373,115,4.6
Floyd County,2022-Jul,2585(P),2475(P),110(P),4.3(P)
Foard County,2012-Jan,631,590,41,6.5
Foard County,2012-Feb,616,580,36,5.8
Foard County,2012-Mar,622,585,37,5.9
Foard County,2012-Apr,623,590,33,5.3
Foard County,2012-May,623,587,36,5.8
Foard County,2012-Jun,631,592,39,6.2
Foard County,2012-Jul,652,613,39,6
Foard County,2012-Aug,627,591,36,5.7
Foard County,2012-Sep,619,586,33,5.3
Foard County,2012-Oct,603,571,32,5.3
Foard County,2012-Nov,598,565,33,5.5
Foard County,2012-Dec,600,568,32,5.3
Foard County,2013-Jan,576,539,37,6.4
Foard County,2013-Feb,571,538,33,5.8
Foard County,2013-Mar,579,548,31,5.4
Foard County,2013-Apr,584,553,31,5.3
Foard County,2013-May,584,551,33,5.7
Foard County,2013-Jun,594,561,33,5.6
Foard County,2013-Jul,601,567,34,5.7
Foard County,2013-Aug,576,548,28,4.9
Foard County,2013-Sep,578,550,28,4.8
Foard County,2013-Oct,567,539,28,4.9
Foard County,2013-Nov,552,528,24,4.3
Foard County,2013-Dec,559,536,23,4.1
Foard County,2014-Jan,569,541,28,4.9
Foard County,2014-Feb,582,555,27,4.6
Foard County,2014-Mar,582,555,27,4.6
Foard County,2014-Apr,591,565,26,4.4
Foard County,2014-May,590,564,26,4.4
Foard County,2014-Jun,596,567,29,4.9
Foard County,2014-Jul,591,562,29,4.9
Foard County,2014-Aug,580,556,24,4.1
Foard County,2014-Sep,584,562,22,3.8
Foard County,2014-Oct,559,539,20,3.6
Foard County,2014-Nov,565,542,23,4.1
Foard County,2014-Dec,549,528,21,3.8
Foard County,2015-Jan,545,518,27,5
Foard County,2015-Feb,556,529,27,4.9
Foard County,2015-Mar,559,535,24,4.3
Foard County,2015-Apr,582,559,23,4
Foard County,2015-May,587,562,25,4.3
Foard County,2015-Jun,583,559,24,4.1
Foard County,2015-Jul,556,534,22,4
Foard County,2015-Aug,539,519,20,3.7
Foard County,2015-Sep,528,508,20,3.8
Foard County,2015-Oct,542,521,21,3.9
Foard County,2015-Nov,525,505,20,3.8
Foard County,2015-Dec,511,494,17,3.3
Foard County,2016-Jan,510,491,19,3.7
Foard County,2016-Feb,528,509,19,3.6
Foard County,2016-Mar,531,513,18,3.4
Foard County,2016-Apr,531,517,14,2.6
Foard County,2016-May,546,528,18,3.3
Foard County,2016-Jun,543,524,19,3.5
Foard County,2016-Jul,543,521,22,4.1
Foard County,2016-Aug,540,518,22,4.1
Foard County,2016-Sep,548,524,24,4.4
Foard County,2016-Oct,557,535,22,3.9
Foard County,2016-Nov,558,534,24,4.3
Foard County,2016-Dec,553,529,24,4.3
Foard County,2017-Jan,554,527,27,4.9
Foard County,2017-Feb,559,531,28,5
Foard County,2017-Mar,586,563,23,3.9
Foard County,2017-Apr,592,571,21,3.5
Foard County,2017-May,608,585,23,3.8
Foard County,2017-Jun,596,577,19,3.2
Foard County,2017-Jul,605,585,20,3.3
Foard County,2017-Aug,609,590,19,3.1
Foard County,2017-Sep,608,590,18,3
Foard County,2017-Oct,604,586,18,3
Foard County,2017-Nov,576,559,17,3
Foard County,2017-Dec,579,564,15,2.6
Foard County,2018-Jan,584,568,16,2.7
Foard County,2018-Feb,583,564,19,3.3
Foard County,2018-Mar,582,566,16,2.7
Foard County,2018-Apr,587,572,15,2.6
Foard County,2018-May,595,579,16,2.7
Foard County,2018-Jun,596,575,21,3.5
Foard County,2018-Jul,576,559,17,3
Foard County,2018-Aug,558,542,16,2.9
Foard County,2018-Sep,557,541,16,2.9
Foard County,2018-Oct,581,565,16,2.8
Foard County,2018-Nov,577,562,15,2.6
Foard County,2018-Dec,562,545,17,3
Foard County,2019-Jan,552,532,20,3.6
Foard County,2019-Feb,575,556,19,3.3
Foard County,2019-Mar,574,559,15,2.6
Foard County,2019-Apr,572,558,14,2.4
Foard County,2019-May,564,549,15,2.7
Foard County,2019-Jun,559,540,19,3.4
Foard County,2019-Jul,591,573,18,3
Foard County,2019-Aug,596,577,19,3.2
Foard County,2019-Sep,582,564,18,3.1
Foard County,2019-Oct,579,562,17,2.9
Foard County,2019-Nov,563,547,16,2.8
Foard County,2019-Dec,562,549,13,2.3
Foard County,2020-Jan,589,575,14,2.4
Foard County,2020-Feb,577,563,14,2.4
Foard County,2020-Mar,568,547,21,3.7
Foard County,2020-Apr,542,508,34,6.3
Foard County,2020-May,553,517,36,6.5
Foard County,2020-Jun,567,535,32,5.6
Foard County,2020-Jul,570,548,22,3.9
Foard County,2020-Aug,588,568,20,3.4
Foard County,2020-Sep,570,549,21,3.7
Foard County,2020-Oct,577,557,20,3.5
Foard County,2020-Nov,571,548,23,4
Foard County,2020-Dec,585,562,23,3.9
Foard County,2021-Jan,582,559,23,4
Foard County,2021-Feb,585,565,20,3.4
Foard County,2021-Mar,598,579,19,3.2
Foard County,2021-Apr,579,563,16,2.8
Foard County,2021-May,569,551,18,3.2
Foard County,2021-Jun,590,568,22,3.7
Foard County,2021-Jul,601,580,21,3.5
Foard County,2021-Aug,603,582,21,3.5
Foard County,2021-Sep,594,574,20,3.4
Foard County,2021-Oct,589,570,19,3.2
Foard County,2021-Nov,588,568,20,3.4
Foard County,2021-Dec,592,574,18,3
Foard County,2022-Jan,598,579,19,3.2
Foard County,2022-Feb,611,590,21,3.4
Foard County,2022-Mar,626,611,15,2.4
Foard County,2022-Apr,608,594,14,2.3
Foard County,2022-May,594,581,13,2.2
Foard County,2022-Jun,613,597,16,2.6
Foard County,2022-Jul,640(P),623(P),17(P),2.7(P)
Fort Bend County,2012-Jan,312806,292503,20303,6.5
Fort Bend County,2012-Feb,315083,295219,19864,6.3
Fort Bend County,2012-Mar,315358,296896,18462,5.9
Fort Bend County,2012-Apr,315591,298050,17541,5.6
Fort Bend County,2012-May,317464,298867,18597,5.9
Fort Bend County,2012-Jun,319326,298643,20683,6.5
Fort Bend County,2012-Jul,320605,299954,20651,6.4
Fort Bend County,2012-Aug,318706,299405,19301,6.1
Fort Bend County,2012-Sep,320274,302204,18070,5.6
Fort Bend County,2012-Oct,321584,303827,17757,5.5
Fort Bend County,2012-Nov,321478,304241,17237,5.4
Fort Bend County,2012-Dec,321942,304387,17555,5.5
Fort Bend County,2013-Jan,328553,308633,19920,6.1
Fort Bend County,2013-Feb,330419,311421,18998,5.7
Fort Bend County,2013-Mar,330364,312230,18134,5.5
Fort Bend County,2013-Apr,331340,313920,17420,5.3
Fort Bend County,2013-May,332403,314096,18307,5.5
Fort Bend County,2013-Jun,333764,313457,20307,6.1
Fort Bend County,2013-Jul,334855,315067,19788,5.9
Fort Bend County,2013-Aug,333148,314340,18808,5.6
Fort Bend County,2013-Sep,334086,315495,18591,5.6
Fort Bend County,2013-Oct,332683,314981,17702,5.3
Fort Bend County,2013-Nov,334907,317931,16976,5.1
Fort Bend County,2013-Dec,334536,318608,15928,4.8
Fort Bend County,2014-Jan,341730,324615,17115,5
Fort Bend County,2014-Feb,344211,326893,17318,5
Fort Bend County,2014-Mar,345246,328736,16510,4.8
Fort Bend County,2014-Apr,344510,330039,14471,4.2
Fort Bend County,2014-May,345678,330039,15639,4.5
Fort Bend County,2014-Jun,346720,329757,16963,4.9
Fort Bend County,2014-Jul,348775,331249,17526,5
Fort Bend County,2014-Aug,347290,330445,16845,4.9
Fort Bend County,2014-Sep,347721,332099,15622,4.5
Fort Bend County,2014-Oct,348968,334249,14719,4.2
Fort Bend County,2014-Nov,349424,334929,14495,4.1
Fort Bend County,2014-Dec,348185,335042,13143,3.8
Fort Bend County,2015-Jan,354873,339726,15147,4.3
Fort Bend County,2015-Feb,355537,340921,14616,4.1
Fort Bend County,2015-Mar,354616,340458,14158,4
Fort Bend County,2015-Apr,355497,341982,13515,3.8
Fort Bend County,2015-May,355827,341299,14528,4.1
Fort Bend County,2015-Jun,356046,340019,16027,4.5
Fort Bend County,2015-Jul,356983,340462,16521,4.6
Fort Bend County,2015-Aug,355860,339896,15964,4.5
Fort Bend County,2015-Sep,355234,339349,15885,4.5
Fort Bend County,2015-Oct,356347,340665,15682,4.4
Fort Bend County,2015-Nov,357625,341611,16014,4.5
Fort Bend County,2015-Dec,357583,342249,15334,4.3
Fort Bend County,2016-Jan,363947,347465,16482,4.5
Fort Bend County,2016-Feb,366493,349839,16654,4.5
Fort Bend County,2016-Mar,366600,349456,17144,4.7
Fort Bend County,2016-Apr,366457,349643,16814,4.6
Fort Bend County,2016-May,365534,348604,16930,4.6
Fort Bend County,2016-Jun,367518,347781,19737,5.4
Fort Bend County,2016-Jul,369336,348985,20351,5.5
Fort Bend County,2016-Aug,367692,347484,20208,5.5
Fort Bend County,2016-Sep,368297,348055,20242,5.5
Fort Bend County,2016-Oct,367519,348648,18871,5.1
Fort Bend County,2016-Nov,367976,349534,18442,5
Fort Bend County,2016-Dec,367223,348709,18514,5
Fort Bend County,2017-Jan,369677,349645,20032,5.4
Fort Bend County,2017-Feb,372645,352576,20069,5.4
Fort Bend County,2017-Mar,372768,354224,18544,5
Fort Bend County,2017-Apr,373258,356040,17218,4.6
Fort Bend County,2017-May,371755,354944,16811,4.5
Fort Bend County,2017-Jun,373300,355198,18102,4.8
Fort Bend County,2017-Jul,374106,356367,17739,4.7
Fort Bend County,2017-Aug,372999,355043,17956,4.8
Fort Bend County,2017-Sep,373660,356709,16951,4.5
Fort Bend County,2017-Oct,372097,356864,15233,4.1
Fort Bend County,2017-Nov,374298,358558,15740,4.2
Fort Bend County,2017-Dec,373684,358408,15276,4.1
Fort Bend County,2018-Jan,378021,361093,16928,4.5
Fort Bend County,2018-Feb,383084,366312,16772,4.4
Fort Bend County,2018-Mar,381957,366110,15847,4.1
Fort Bend County,2018-Apr,382185,367457,14728,3.9
Fort Bend County,2018-May,381301,366949,14352,3.8
Fort Bend County,2018-Jun,383871,367250,16621,4.3
Fort Bend County,2018-Jul,384642,368589,16053,4.2
Fort Bend County,2018-Aug,381441,365873,15568,4.1
Fort Bend County,2018-Sep,382372,367465,14907,3.9
Fort Bend County,2018-Oct,384368,370311,14057,3.7
Fort Bend County,2018-Nov,385243,371365,13878,3.6
Fort Bend County,2018-Dec,385709,371640,14069,3.6
Fort Bend County,2019-Jan,392290,376325,15965,4.1
Fort Bend County,2019-Feb,395227,380413,14814,3.7
Fort Bend County,2019-Mar,393469,379720,13749,3.5
Fort Bend County,2019-Apr,392220,380275,11945,3
Fort Bend County,2019-May,392257,380049,12208,3.1
Fort Bend County,2019-Jun,395342,380780,14562,3.7
Fort Bend County,2019-Jul,396590,381674,14916,3.8
Fort Bend County,2019-Aug,394940,380553,14387,3.6
Fort Bend County,2019-Sep,396847,383228,13619,3.4
Fort Bend County,2019-Oct,397605,384453,13152,3.3
Fort Bend County,2019-Nov,398570,385586,12984,3.3
Fort Bend County,2019-Dec,397383,385067,12316,3.1
Fort Bend County,2020-Jan,406048,391892,14156,3.5
Fort Bend County,2020-Feb,409754,396301,13453,3.3
Fort Bend County,2020-Mar,402419,381439,20980,5.2
Fort Bend County,2020-Apr,380278,335871,44407,11.7
Fort Bend County,2020-May,394205,348529,45676,11.6
Fort Bend County,2020-Jun,399607,358126,41481,10.4
Fort Bend County,2020-Jul,399435,360216,39219,9.8
Fort Bend County,2020-Aug,399514,367444,32070,8
Fort Bend County,2020-Sep,400762,369728,31034,7.7
Fort Bend County,2020-Oct,403303,375863,27440,6.8
Fort Bend County,2020-Nov,406068,377554,28514,7
Fort Bend County,2020-Dec,404710,376696,28014,6.9
Fort Bend County,2021-Jan,402828,373542,29286,7.3
Fort Bend County,2021-Feb,406052,377191,28861,7.1
Fort Bend County,2021-Mar,405536,377986,27550,6.8
Fort Bend County,2021-Apr,405264,379947,25317,6.2
Fort Bend County,2021-May,404520,380508,24012,5.9
Fort Bend County,2021-Jun,407480,380463,27017,6.6
Fort Bend County,2021-Jul,409225,383931,25294,6.2
Fort Bend County,2021-Aug,408244,384359,23885,5.9
Fort Bend County,2021-Sep,408506,386857,21649,5.3
Fort Bend County,2021-Oct,409556,388984,20572,5
Fort Bend County,2021-Nov,411908,392502,19406,4.7
Fort Bend County,2021-Dec,412114,394068,18046,4.4
Fort Bend County,2022-Jan,411556,391177,20379,5
Fort Bend County,2022-Feb,415233,395072,20161,4.9
Fort Bend County,2022-Mar,413875,397350,16525,4
Fort Bend County,2022-Apr,413149,397460,15689,3.8
Fort Bend County,2022-May,415730,399453,16277,3.9
Fort Bend County,2022-Jun,419709,401110,18599,4.4
Fort Bend County,2022-Jul,419630(P),401363(P),18267(P),4.4(P)
Franklin County,2012-Jan,4587,4233,354,7.7
Franklin County,2012-Feb,4664,4300,364,7.8
Franklin County,2012-Mar,4643,4303,340,7.3
Franklin County,2012-Apr,4625,4311,314,6.8
Franklin County,2012-May,4631,4292,339,7.3
Franklin County,2012-Jun,4686,4322,364,7.8
Franklin County,2012-Jul,4613,4249,364,7.9
Franklin County,2012-Aug,4574,4240,334,7.3
Franklin County,2012-Sep,4616,4299,317,6.9
Franklin County,2012-Oct,4577,4248,329,7.2
Franklin County,2012-Nov,4611,4285,326,7.1
Franklin County,2012-Dec,4601,4264,337,7.3
Franklin County,2013-Jan,4636,4282,354,7.6
Franklin County,2013-Feb,4662,4328,334,7.2
Franklin County,2013-Mar,4638,4328,310,6.7
Franklin County,2013-Apr,4682,4383,299,6.4
Franklin County,2013-May,4692,4388,304,6.5
Franklin County,2013-Jun,4699,4360,339,7.2
Franklin County,2013-Jul,4695,4359,336,7.2
Franklin County,2013-Aug,4699,4387,312,6.6
Franklin County,2013-Sep,4750,4452,298,6.3
Franklin County,2013-Oct,4678,4388,290,6.2
Franklin County,2013-Nov,4656,4393,263,5.6
Franklin County,2013-Dec,4688,4432,256,5.5
Franklin County,2014-Jan,4591,4330,261,5.7
Franklin County,2014-Feb,4693,4427,266,5.7
Franklin County,2014-Mar,4690,4439,251,5.4
Franklin County,2014-Apr,4688,4468,220,4.7
Franklin County,2014-May,4711,4474,237,5
Franklin County,2014-Jun,4737,4477,260,5.5
Franklin County,2014-Jul,4689,4421,268,5.7
Franklin County,2014-Aug,4665,4397,268,5.7
Franklin County,2014-Sep,4679,4429,250,5.3
Franklin County,2014-Oct,4588,4362,226,4.9
Franklin County,2014-Nov,4569,4354,215,4.7
Franklin County,2014-Dec,4521,4331,190,4.2
Franklin County,2015-Jan,4563,4343,220,4.8
Franklin County,2015-Feb,4598,4378,220,4.8
Franklin County,2015-Mar,4565,4361,204,4.5
Franklin County,2015-Apr,4592,4390,202,4.4
Franklin County,2015-May,4633,4408,225,4.9
Franklin County,2015-Jun,4671,4429,242,5.2
Franklin County,2015-Jul,4569,4321,248,5.4
Franklin County,2015-Aug,4565,4331,234,5.1
Franklin County,2015-Sep,4495,4264,231,5.1
Franklin County,2015-Oct,4500,4275,225,5
Franklin County,2015-Nov,4489,4268,221,4.9
Franklin County,2015-Dec,4460,4247,213,4.8
Franklin County,2016-Jan,4431,4214,217,4.9
Franklin County,2016-Feb,4567,4354,213,4.7
Franklin County,2016-Mar,4599,4391,208,4.5
Franklin County,2016-Apr,4557,4363,194,4.3
Franklin County,2016-May,4572,4371,201,4.4
Franklin County,2016-Jun,4594,4355,239,5.2
Franklin County,2016-Jul,4509,4272,237,5.3
Franklin County,2016-Aug,4520,4278,242,5.4
Franklin County,2016-Sep,4470,4229,241,5.4
Franklin County,2016-Oct,4445,4227,218,4.9
Franklin County,2016-Nov,4453,4228,225,5.1
Franklin County,2016-Dec,4430,4201,229,5.2
Franklin County,2017-Jan,4485,4228,257,5.7
Franklin County,2017-Feb,4561,4311,250,5.5
Franklin County,2017-Mar,4620,4394,226,4.9
Franklin County,2017-Apr,4603,4405,198,4.3
Franklin County,2017-May,4574,4378,196,4.3
Franklin County,2017-Jun,4555,4336,219,4.8
Franklin County,2017-Jul,4485,4264,221,4.9
Franklin County,2017-Aug,4493,4267,226,5
Franklin County,2017-Sep,4454,4261,193,4.3
Franklin County,2017-Oct,4446,4267,179,4
Franklin County,2017-Nov,4424,4237,187,4.2
Franklin County,2017-Dec,4429,4245,184,4.2
Franklin County,2018-Jan,4468,4261,207,4.6
Franklin County,2018-Feb,4564,4349,215,4.7
Franklin County,2018-Mar,4598,4397,201,4.4
Franklin County,2018-Apr,4559,4378,181,4
Franklin County,2018-May,4547,4377,170,3.7
Franklin County,2018-Jun,4579,4380,199,4.3
Franklin County,2018-Jul,4540,4347,193,4.3
Franklin County,2018-Aug,4517,4330,187,4.1
Franklin County,2018-Sep,4500,4311,189,4.2
Franklin County,2018-Oct,4473,4301,172,3.8
Franklin County,2018-Nov,4476,4307,169,3.8
Franklin County,2018-Dec,4438,4264,174,3.9
Franklin County,2019-Jan,4504,4298,206,4.6
Franklin County,2019-Feb,4551,4372,179,3.9
Franklin County,2019-Mar,4565,4391,174,3.8
Franklin County,2019-Apr,4577,4430,147,3.2
Franklin County,2019-May,4605,4459,146,3.2
Franklin County,2019-Jun,4669,4493,176,3.8
Franklin County,2019-Jul,4660,4474,186,4
Franklin County,2019-Aug,4649,4471,178,3.8
Franklin County,2019-Sep,4599,4439,160,3.5
Franklin County,2019-Oct,4671,4519,152,3.3
Franklin County,2019-Nov,4671,4515,156,3.3
Franklin County,2019-Dec,4606,4466,140,3
Franklin County,2020-Jan,4673,4514,159,3.4
Franklin County,2020-Feb,4772,4620,152,3.2
Franklin County,2020-Mar,4674,4450,224,4.8
Franklin County,2020-Apr,4480,4149,331,7.4
Franklin County,2020-May,4669,4345,324,6.9
Franklin County,2020-Jun,4776,4452,324,6.8
Franklin County,2020-Jul,4843,4545,298,6.2
Franklin County,2020-Aug,4896,4644,252,5.1
Franklin County,2020-Sep,4825,4579,246,5.1
Franklin County,2020-Oct,4933,4704,229,4.6
Franklin County,2020-Nov,4918,4659,259,5.3
Franklin County,2020-Dec,4955,4687,268,5.4
Franklin County,2021-Jan,5182,4906,276,5.3
Franklin County,2021-Feb,5289,5022,267,5
Franklin County,2021-Mar,5396,5125,271,5
Franklin County,2021-Apr,5326,5084,242,4.5
Franklin County,2021-May,5226,5004,222,4.2
Franklin County,2021-Jun,5188,4938,250,4.8
Franklin County,2021-Jul,5279,5045,234,4.4
Franklin County,2021-Aug,5226,4998,228,4.4
Franklin County,2021-Sep,5143,4933,210,4.1
Franklin County,2021-Oct,5165,4968,197,3.8
Franklin County,2021-Nov,5149,4966,183,3.6
Franklin County,2021-Dec,5115,4943,172,3.4
Franklin County,2022-Jan,5161,4968,193,3.7
Franklin County,2022-Feb,5244,5049,195,3.7
Franklin County,2022-Mar,5280,5124,156,3
Franklin County,2022-Apr,5191,5055,136,2.6
Franklin County,2022-May,5170,5021,149,2.9
Franklin County,2022-Jun,5170,4987,183,3.5
Franklin County,2022-Jul,5229(P),5050(P),179(P),3.4(P)
Freestone County,2012-Jan,7963,7387,576,7.2
Freestone County,2012-Feb,7920,7358,562,7.1
Freestone County,2012-Mar,7895,7379,516,6.5
Freestone County,2012-Apr,8011,7531,480,6
Freestone County,2012-May,8074,7560,514,6.4
Freestone County,2012-Jun,8220,7640,580,7.1
Freestone County,2012-Jul,8197,7607,590,7.2
Freestone County,2012-Aug,8144,7592,552,6.8
Freestone County,2012-Sep,8157,7629,528,6.5
Freestone County,2012-Oct,8004,7504,500,6.2
Freestone County,2012-Nov,7957,7450,507,6.4
Freestone County,2012-Dec,7957,7411,546,6.9
Freestone County,2013-Jan,7869,7256,613,7.8
Freestone County,2013-Feb,7842,7275,567,7.2
Freestone County,2013-Mar,7783,7247,536,6.9
Freestone County,2013-Apr,7871,7358,513,6.5
Freestone County,2013-May,7949,7413,536,6.7
Freestone County,2013-Jun,8075,7468,607,7.5
Freestone County,2013-Jul,7989,7405,584,7.3
Freestone County,2013-Aug,7924,7348,576,7.3
Freestone County,2013-Sep,7885,7327,558,7.1
Freestone County,2013-Oct,7660,7143,517,6.7
Freestone County,2013-Nov,7621,7135,486,6.4
Freestone County,2013-Dec,7663,7210,453,5.9
Freestone County,2014-Jan,7763,7271,492,6.3
Freestone County,2014-Feb,7882,7382,500,6.3
Freestone County,2014-Mar,7847,7389,458,5.8
Freestone County,2014-Apr,7733,7317,416,5.4
Freestone County,2014-May,7798,7352,446,5.7
Freestone County,2014-Jun,7887,7403,484,6.1
Freestone County,2014-Jul,8009,7517,492,6.1
Freestone County,2014-Aug,7952,7470,482,6.1
Freestone County,2014-Sep,7924,7491,433,5.5
Freestone County,2014-Oct,7797,7394,403,5.2
Freestone County,2014-Nov,7743,7350,393,5.1
Freestone County,2014-Dec,7668,7307,361,4.7
Freestone County,2015-Jan,7842,7449,393,5
Freestone County,2015-Feb,7830,7439,391,5
Freestone County,2015-Mar,7782,7402,380,4.9
Freestone County,2015-Apr,7659,7279,380,5
Freestone County,2015-May,7616,7210,406,5.3
Freestone County,2015-Jun,7613,7174,439,5.8
Freestone County,2015-Jul,7304,6885,419,5.7
Freestone County,2015-Aug,7193,6780,413,5.7
Freestone County,2015-Sep,7142,6734,408,5.7
Freestone County,2015-Oct,7042,6640,402,5.7
Freestone County,2015-Nov,6968,6557,411,5.9
Freestone County,2015-Dec,6976,6560,416,6
Freestone County,2016-Jan,6865,6429,436,6.4
Freestone County,2016-Feb,6998,6548,450,6.4
Freestone County,2016-Mar,7009,6553,456,6.5
Freestone County,2016-Apr,7049,6611,438,6.2
Freestone County,2016-May,7053,6611,442,6.3
Freestone County,2016-Jun,7027,6512,515,7.3
Freestone County,2016-Jul,6921,6412,509,7.4
Freestone County,2016-Aug,6900,6411,489,7.1
Freestone County,2016-Sep,6744,6270,474,7
Freestone County,2016-Oct,6635,6204,431,6.5
Freestone County,2016-Nov,6652,6217,435,6.5
Freestone County,2016-Dec,6609,6168,441,6.7
Freestone County,2017-Jan,6734,6207,527,7.8
Freestone County,2017-Feb,6824,6298,526,7.7
Freestone County,2017-Mar,6894,6400,494,7.2
Freestone County,2017-Apr,6847,6402,445,6.5
Freestone County,2017-May,6803,6388,415,6.1
Freestone County,2017-Jun,6795,6341,454,6.7
Freestone County,2017-Jul,6661,6230,431,6.5
Freestone County,2017-Aug,6672,6249,423,6.3
Freestone County,2017-Sep,6599,6216,383,5.8
Freestone County,2017-Oct,6581,6230,351,5.3
Freestone County,2017-Nov,6542,6174,368,5.6
Freestone County,2017-Dec,6521,6173,348,5.3
Freestone County,2018-Jan,6480,6086,394,6.1
Freestone County,2018-Feb,6610,6229,381,5.8
Freestone County,2018-Mar,6731,6305,426,6.3
Freestone County,2018-Apr,6547,6138,409,6.2
Freestone County,2018-May,6518,6138,380,5.8
Freestone County,2018-Jun,6558,6131,427,6.5
Freestone County,2018-Jul,6466,6057,409,6.3
Freestone County,2018-Aug,6500,6109,391,6
Freestone County,2018-Sep,6432,6053,379,5.9
Freestone County,2018-Oct,6363,6012,351,5.5
Freestone County,2018-Nov,6352,6019,333,5.2
Freestone County,2018-Dec,6336,6007,329,5.2
Freestone County,2019-Jan,6257,5902,355,5.7
Freestone County,2019-Feb,6312,5984,328,5.2
Freestone County,2019-Mar,6332,6030,302,4.8
Freestone County,2019-Apr,6222,5965,257,4.1
Freestone County,2019-May,6251,5989,262,4.2
Freestone County,2019-Jun,6332,6017,315,5
Freestone County,2019-Jul,6371,6042,329,5.2
Freestone County,2019-Aug,6443,6140,303,4.7
Freestone County,2019-Sep,6365,6065,300,4.7
Freestone County,2019-Oct,6309,6013,296,4.7
Freestone County,2019-Nov,6270,5968,302,4.8
Freestone County,2019-Dec,6271,5990,281,4.5
Freestone County,2020-Jan,6324,5986,338,5.3
Freestone County,2020-Feb,6361,6054,307,4.8
Freestone County,2020-Mar,6390,5912,478,7.5
Freestone County,2020-Apr,5970,5400,570,9.5
Freestone County,2020-May,6196,5529,667,10.8
Freestone County,2020-Jun,6294,5584,710,11.3
Freestone County,2020-Jul,6362,5692,670,10.5
Freestone County,2020-Aug,6406,5864,542,8.5
Freestone County,2020-Sep,6306,5768,538,8.5
Freestone County,2020-Oct,6315,5841,474,7.5
Freestone County,2020-Nov,6204,5706,498,8
Freestone County,2020-Dec,6210,5712,498,8
Freestone County,2021-Jan,6255,5722,533,8.5
Freestone County,2021-Feb,6342,5791,551,8.7
Freestone County,2021-Mar,6457,5903,554,8.6
Freestone County,2021-Apr,6442,5965,477,7.4
Freestone County,2021-May,6383,5930,453,7.1
Freestone County,2021-Jun,6430,5907,523,8.1
Freestone County,2021-Jul,6416,5948,468,7.3
Freestone County,2021-Aug,6392,5933,459,7.2
Freestone County,2021-Sep,6294,5891,403,6.4
Freestone County,2021-Oct,6223,5836,387,6.2
Freestone County,2021-Nov,6137,5771,366,6
Freestone County,2021-Dec,6103,5778,325,5.3
Freestone County,2022-Jan,6154,5757,397,6.5
Freestone County,2022-Feb,6286,5881,405,6.4
Freestone County,2022-Mar,6402,6053,349,5.5
Freestone County,2022-Apr,6273,5939,334,5.3
Freestone County,2022-May,6247,5904,343,5.5
Freestone County,2022-Jun,6264,5869,395,6.3
Freestone County,2022-Jul,6355(P),5978(P),377(P),5.9(P)
Frio County,2012-Jan,8456,7988,468,5.5
Frio County,2012-Feb,8455,7996,459,5.4
Frio County,2012-Mar,8596,8174,422,4.9
Frio County,2012-Apr,8497,8096,401,4.7
Frio County,2012-May,8732,8316,416,4.8
Frio County,2012-Jun,8775,8292,483,5.5
Frio County,2012-Jul,8892,8400,492,5.5
Frio County,2012-Aug,8699,8251,448,5.2
Frio County,2012-Sep,8585,8182,403,4.7
Frio County,2012-Oct,8747,8348,399,4.6
Frio County,2012-Nov,8746,8348,398,4.6
Frio County,2012-Dec,8652,8240,412,4.8
Frio County,2013-Jan,8700,8238,462,5.3
Frio County,2013-Feb,8805,8367,438,5
Frio County,2013-Mar,8838,8433,405,4.6
Frio County,2013-Apr,9008,8618,390,4.3
Frio County,2013-May,9198,8755,443,4.8
Frio County,2013-Jun,9306,8797,509,5.5
Frio County,2013-Jul,9464,8967,497,5.3
Frio County,2013-Aug,9211,8745,466,5.1
Frio County,2013-Sep,9521,9080,441,4.6
Frio County,2013-Oct,9597,9188,409,4.3
Frio County,2013-Nov,9802,9406,396,4
Frio County,2013-Dec,9764,9382,382,3.9
Frio County,2014-Jan,9878,9476,402,4.1
Frio County,2014-Feb,10042,9636,406,4
Frio County,2014-Mar,10152,9781,371,3.7
Frio County,2014-Apr,10452,10118,334,3.2
Frio County,2014-May,10390,10020,370,3.6
Frio County,2014-Jun,10374,9957,417,4
Frio County,2014-Jul,10511,10087,424,4
Frio County,2014-Aug,10252,9858,394,3.8
Frio County,2014-Sep,10522,10163,359,3.4
Frio County,2014-Oct,10573,10224,349,3.3
Frio County,2014-Nov,10449,10105,344,3.3
Frio County,2014-Dec,10309,9993,316,3.1
Frio County,2015-Jan,10449,10096,353,3.4
Frio County,2015-Feb,10523,10168,355,3.4
Frio County,2015-Mar,10337,9992,345,3.3
Frio County,2015-Apr,10301,9979,322,3.1
Frio County,2015-May,10123,9773,350,3.5
Frio County,2015-Jun,10012,9603,409,4.1
Frio County,2015-Jul,9805,9383,422,4.3
Frio County,2015-Aug,9524,9121,403,4.2
Frio County,2015-Sep,9424,9027,397,4.2
Frio County,2015-Oct,9203,8813,390,4.2
Frio County,2015-Nov,9007,8605,402,4.5
Frio County,2015-Dec,8959,8565,394,4.4
Frio County,2016-Jan,8859,8450,409,4.6
Frio County,2016-Feb,9133,8713,420,4.6
Frio County,2016-Mar,8957,8518,439,4.9
Frio County,2016-Apr,8872,8460,412,4.6
Frio County,2016-May,8914,8506,408,4.6
Frio County,2016-Jun,8714,8252,462,5.3
Frio County,2016-Jul,8602,8130,472,5.5
Frio County,2016-Aug,8710,8251,459,5.3
Frio County,2016-Sep,8707,8267,440,5.1
Frio County,2016-Oct,8627,8221,406,4.7
Frio County,2016-Nov,8668,8266,402,4.6
Frio County,2016-Dec,8640,8230,410,4.7
Frio County,2017-Jan,8978,8529,449,5
Frio County,2017-Feb,9077,8637,440,4.8
Frio County,2017-Mar,9451,9039,412,4.4
Frio County,2017-Apr,9475,9098,377,4
Frio County,2017-May,9519,9158,361,3.8
Frio County,2017-Jun,9391,8986,405,4.3
Frio County,2017-Jul,9220,8827,393,4.3
Frio County,2017-Aug,9338,8961,377,4
Frio County,2017-Sep,9297,8988,309,3.3
Frio County,2017-Oct,9351,9056,295,3.2
Frio County,2017-Nov,9226,8916,310,3.4
Frio County,2017-Dec,9208,8909,299,3.2
Frio County,2018-Jan,9517,9186,331,3.5
Frio County,2018-Feb,9592,9266,326,3.4
Frio County,2018-Mar,9821,9524,297,3
Frio County,2018-Apr,10163,9903,260,2.6
Frio County,2018-May,10247,10003,244,2.4
Frio County,2018-Jun,10280,9965,315,3.1
Frio County,2018-Jul,10368,10046,322,3.1
Frio County,2018-Aug,10355,10062,293,2.8
Frio County,2018-Sep,10344,10058,286,2.8
Frio County,2018-Oct,10156,9892,264,2.6
Frio County,2018-Nov,10150,9886,264,2.6
Frio County,2018-Dec,10068,9795,273,2.7
Frio County,2019-Jan,10224,9918,306,3
Frio County,2019-Feb,10381,10083,298,2.9
Frio County,2019-Mar,10434,10171,263,2.5
Frio County,2019-Apr,10375,10147,228,2.2
Frio County,2019-May,10418,10180,238,2.3
Frio County,2019-Jun,10369,10050,319,3.1
Frio County,2019-Jul,10393,10072,321,3.1
Frio County,2019-Aug,10402,10130,272,2.6
Frio County,2019-Sep,10266,10022,244,2.4
Frio County,2019-Oct,10343,10092,251,2.4
Frio County,2019-Nov,10079,9819,260,2.6
Frio County,2019-Dec,10033,9787,246,2.5
Frio County,2020-Jan,10102,9798,304,3
Frio County,2020-Feb,10065,9789,276,2.7
Frio County,2020-Mar,9930,9514,416,4.2
Frio County,2020-Apr,9016,8455,561,6.2
Frio County,2020-May,9158,8446,712,7.8
Frio County,2020-Jun,9251,8519,732,7.9
Frio County,2020-Jul,9301,8582,719,7.7
Frio County,2020-Aug,9385,8815,570,6.1
Frio County,2020-Sep,9350,8779,571,6.1
Frio County,2020-Oct,9382,8869,513,5.5
Frio County,2020-Nov,9321,8797,524,5.6
Frio County,2020-Dec,9344,8800,544,5.8
Frio County,2021-Jan,9401,8835,566,6
Frio County,2021-Feb,9586,9017,569,5.9
Frio County,2021-Mar,9745,9223,522,5.4
Frio County,2021-Apr,9645,9179,466,4.8
Frio County,2021-May,9475,9022,453,4.8
Frio County,2021-Jun,9478,8959,519,5.5
Frio County,2021-Jul,9414,8954,460,4.9
Frio County,2021-Aug,9403,8978,425,4.5
Frio County,2021-Sep,9384,9003,381,4.1
Frio County,2021-Oct,9107,8728,379,4.2
Frio County,2021-Nov,9062,8706,356,3.9
Frio County,2021-Dec,9055,8722,333,3.7
Frio County,2022-Jan,9144,8760,384,4.2
Frio County,2022-Feb,9442,9054,388,4.1
Frio County,2022-Mar,9683,9366,317,3.3
Frio County,2022-Apr,9593,9309,284,3
Frio County,2022-May,9443,9133,310,3.3
Frio County,2022-Jun,9400,9042,358,3.8
Frio County,2022-Jul,9567(P),9204(P),363(P),3.8(P)
Gaines County,2012-Jan,8524,8122,402,4.7
Gaines County,2012-Feb,8422,8034,388,4.6
Gaines County,2012-Mar,8553,8194,359,4.2
Gaines County,2012-Apr,8672,8331,341,3.9
Gaines County,2012-May,8832,8463,369,4.2
Gaines County,2012-Jun,9030,8606,424,4.7
Gaines County,2012-Jul,8890,8469,421,4.7
Gaines County,2012-Aug,8820,8434,386,4.4
Gaines County,2012-Sep,8917,8569,348,3.9
Gaines County,2012-Oct,8830,8494,336,3.8
Gaines County,2012-Nov,8850,8521,329,3.7
Gaines County,2012-Dec,8845,8508,337,3.8
Gaines County,2013-Jan,8621,8224,397,4.6
Gaines County,2013-Feb,8722,8341,381,4.4
Gaines County,2013-Mar,8577,8213,364,4.2
Gaines County,2013-Apr,8770,8422,348,4
Gaines County,2013-May,8869,8499,370,4.2
Gaines County,2013-Jun,9048,8609,439,4.9
Gaines County,2013-Jul,9004,8571,433,4.8
Gaines County,2013-Aug,8848,8451,397,4.5
Gaines County,2013-Sep,9069,8686,383,4.2
Gaines County,2013-Oct,9169,8828,341,3.7
Gaines County,2013-Nov,8996,8670,326,3.6
Gaines County,2013-Dec,9063,8754,309,3.4
Gaines County,2014-Jan,9045,8716,329,3.6
Gaines County,2014-Feb,9322,8977,345,3.7
Gaines County,2014-Mar,9182,8863,319,3.5
Gaines County,2014-Apr,9331,9056,275,2.9
Gaines County,2014-May,9524,9214,310,3.3
Gaines County,2014-Jun,9515,9167,348,3.7
Gaines County,2014-Jul,9572,9216,356,3.7
Gaines County,2014-Aug,9341,9013,328,3.5
Gaines County,2014-Sep,9434,9138,296,3.1
Gaines County,2014-Oct,9438,9159,279,3
Gaines County,2014-Nov,9296,9024,272,2.9
Gaines County,2014-Dec,9210,8964,246,2.7
Gaines County,2015-Jan,9285,8998,287,3.1
Gaines County,2015-Feb,9374,9079,295,3.1
Gaines County,2015-Mar,9381,9102,279,3
Gaines County,2015-Apr,9334,9057,277,3
Gaines County,2015-May,9487,9174,313,3.3
Gaines County,2015-Jun,9562,9220,342,3.6
Gaines County,2015-Jul,9532,9191,341,3.6
Gaines County,2015-Aug,9414,9102,312,3.3
Gaines County,2015-Sep,9442,9130,312,3.3
Gaines County,2015-Oct,9462,9151,311,3.3
Gaines County,2015-Nov,9283,8970,313,3.4
Gaines County,2015-Dec,9338,9038,300,3.2
Gaines County,2016-Jan,9189,8854,335,3.6
Gaines County,2016-Feb,9461,9111,350,3.7
Gaines County,2016-Mar,9374,9028,346,3.7
Gaines County,2016-Apr,9366,9032,334,3.6
Gaines County,2016-May,9568,9238,330,3.4
Gaines County,2016-Jun,9458,9082,376,4
Gaines County,2016-Jul,9017,8657,360,4
Gaines County,2016-Aug,9104,8749,355,3.9
Gaines County,2016-Sep,8940,8588,352,3.9
Gaines County,2016-Oct,8898,8565,333,3.7
Gaines County,2016-Nov,8871,8554,317,3.6
Gaines County,2016-Dec,8987,8664,323,3.6
Gaines County,2017-Jan,8948,8606,342,3.8
Gaines County,2017-Feb,9160,8823,337,3.7
Gaines County,2017-Mar,9302,8994,308,3.3
Gaines County,2017-Apr,9296,9025,271,2.9
Gaines County,2017-May,9274,8997,277,3
Gaines County,2017-Jun,9334,9034,300,3.2
Gaines County,2017-Jul,9134,8843,291,3.2
Gaines County,2017-Aug,9259,8974,285,3.1
Gaines County,2017-Sep,9110,8860,250,2.7
Gaines County,2017-Oct,9164,8936,228,2.5
Gaines County,2017-Nov,9056,8807,249,2.7
Gaines County,2017-Dec,9106,8873,233,2.6
Gaines County,2018-Jan,9226,8979,247,2.7
Gaines County,2018-Feb,9398,9148,250,2.7
Gaines County,2018-Mar,9495,9251,244,2.6
Gaines County,2018-Apr,9305,9083,222,2.4
Gaines County,2018-May,9375,9151,224,2.4
Gaines County,2018-Jun,9271,8988,283,3.1
Gaines County,2018-Jul,9335,9077,258,2.8
Gaines County,2018-Aug,9392,9145,247,2.6
Gaines County,2018-Sep,9391,9155,236,2.5
Gaines County,2018-Oct,9299,9070,229,2.5
Gaines County,2018-Nov,9291,9071,220,2.4
Gaines County,2018-Dec,9240,9011,229,2.5
Gaines County,2019-Jan,9492,9231,261,2.7
Gaines County,2019-Feb,9677,9431,246,2.5
Gaines County,2019-Mar,9733,9504,229,2.4
Gaines County,2019-Apr,9673,9477,196,2
Gaines County,2019-May,9818,9612,206,2.1
Gaines County,2019-Jun,9770,9503,267,2.7
Gaines County,2019-Jul,9754,9485,269,2.8
Gaines County,2019-Aug,9957,9698,259,2.6
Gaines County,2019-Sep,9747,9512,235,2.4
Gaines County,2019-Oct,9948,9718,230,2.3
Gaines County,2019-Nov,9704,9471,233,2.4
Gaines County,2019-Dec,9841,9627,214,2.2
Gaines County,2020-Jan,9789,9528,261,2.7
Gaines County,2020-Feb,10006,9756,250,2.5
Gaines County,2020-Mar,9706,9318,388,4
Gaines County,2020-Apr,9124,8555,569,6.2
Gaines County,2020-May,9438,8705,733,7.8
Gaines County,2020-Jun,9601,8863,738,7.7
Gaines County,2020-Jul,9656,8964,692,7.2
Gaines County,2020-Aug,9783,9207,576,5.9
Gaines County,2020-Sep,9632,9049,583,6.1
Gaines County,2020-Oct,9783,9229,554,5.7
Gaines County,2020-Nov,9594,9003,591,6.2
Gaines County,2020-Dec,9610,9032,578,6
Gaines County,2021-Jan,9766,9149,617,6.3
Gaines County,2021-Feb,9867,9296,571,5.8
Gaines County,2021-Mar,10028,9480,548,5.5
Gaines County,2021-Apr,9870,9384,486,4.9
Gaines County,2021-May,9675,9231,444,4.6
Gaines County,2021-Jun,9621,9113,508,5.3
Gaines County,2021-Jul,9691,9250,441,4.6
Gaines County,2021-Aug,9841,9445,396,4
Gaines County,2021-Sep,9779,9407,372,3.8
Gaines County,2021-Oct,9744,9378,366,3.8
Gaines County,2021-Nov,9537,9209,328,3.4
Gaines County,2021-Dec,9561,9260,301,3.1
Gaines County,2022-Jan,9613,9265,348,3.6
Gaines County,2022-Feb,10008,9659,349,3.5
Gaines County,2022-Mar,10180,9896,284,2.8
Gaines County,2022-Apr,9920,9654,266,2.7
Gaines County,2022-May,9803,9519,284,2.9
Gaines County,2022-Jun,9755,9424,331,3.4
Gaines County,2022-Jul,10008(P),9700(P),308(P),3.1(P)
Galveston County,2012-Jan,150458,137836,12622,8.4
Galveston County,2012-Feb,151202,139076,12126,8
Galveston County,2012-Mar,151343,139907,11436,7.6
Galveston County,2012-Apr,151314,140497,10817,7.1
Galveston County,2012-May,152322,140889,11433,7.5
Galveston County,2012-Jun,153489,140830,12659,8.2
Galveston County,2012-Jul,154088,141435,12653,8.2
Galveston County,2012-Aug,153065,141143,11922,7.8
Galveston County,2012-Sep,153627,142461,11166,7.3
Galveston County,2012-Oct,154005,143182,10823,7
Galveston County,2012-Nov,153860,143362,10498,6.8
Galveston County,2012-Dec,154396,143387,11009,7.1
Galveston County,2013-Jan,153971,142053,11918,7.7
Galveston County,2013-Feb,154459,143340,11119,7.2
Galveston County,2013-Mar,154497,143699,10798,7
Galveston County,2013-Apr,154863,144544,10319,6.7
Galveston County,2013-May,155455,144672,10783,6.9
Galveston County,2013-Jun,156198,144424,11774,7.5
Galveston County,2013-Jul,156642,145176,11466,7.3
Galveston County,2013-Aug,155804,144766,11038,7.1
Galveston County,2013-Sep,156056,145320,10736,6.9
Galveston County,2013-Oct,155327,145090,10237,6.6
Galveston County,2013-Nov,156133,146339,9794,6.3
Galveston County,2013-Dec,155910,146702,9208,5.9
Galveston County,2014-Jan,155366,145692,9674,6.2
Galveston County,2014-Feb,156329,146778,9551,6.1
Galveston County,2014-Mar,156935,147610,9325,5.9
Galveston County,2014-Apr,156466,148227,8239,5.3
Galveston County,2014-May,156907,148255,8652,5.5
Galveston County,2014-Jun,157724,148127,9597,6.1
Galveston County,2014-Jul,158689,148768,9921,6.3
Galveston County,2014-Aug,157947,148348,9599,6.1
Galveston County,2014-Sep,157893,149106,8787,5.6
Galveston County,2014-Oct,158152,150051,8101,5.1
Galveston County,2014-Nov,158525,150294,8231,5.2
Galveston County,2014-Dec,157994,150319,7675,4.9
Galveston County,2015-Jan,158019,149601,8418,5.3
Galveston County,2015-Feb,158327,150203,8124,5.1
Galveston County,2015-Mar,157809,150052,7757,4.9
Galveston County,2015-Apr,157846,150670,7176,4.5
Galveston County,2015-May,157939,150409,7530,4.8
Galveston County,2015-Jun,158156,149841,8315,5.3
Galveston County,2015-Jul,158490,149971,8519,5.4
Galveston County,2015-Aug,157776,149661,8115,5.1
Galveston County,2015-Sep,157367,149455,7912,5
Galveston County,2015-Oct,157678,150028,7650,4.9
Galveston County,2015-Nov,158366,150363,8003,5.1
Galveston County,2015-Dec,158368,150665,7703,4.9
Galveston County,2016-Jan,159035,150997,8038,5.1
Galveston County,2016-Feb,160016,152171,7845,4.9
Galveston County,2016-Mar,160041,152054,7987,5
Galveston County,2016-Apr,159735,152132,7603,4.8
Galveston County,2016-May,159359,151742,7617,4.8
Galveston County,2016-Jun,160302,151299,9003,5.6
Galveston County,2016-Jul,161092,151704,9388,5.8
Galveston County,2016-Aug,160486,151100,9386,5.8
Galveston County,2016-Sep,160699,151309,9390,5.8
Galveston County,2016-Oct,160177,151547,8630,5.4
Galveston County,2016-Nov,160539,151904,8635,5.4
Galveston County,2016-Dec,160563,151536,9027,5.6
Galveston County,2017-Jan,159404,149739,9665,6.1
Galveston County,2017-Feb,160384,151046,9338,5.8
Galveston County,2017-Mar,160618,151883,8735,5.4
Galveston County,2017-Apr,160733,152632,8101,5
Galveston County,2017-May,160171,152178,7993,5
Galveston County,2017-Jun,161091,152237,8854,5.5
Galveston County,2017-Jul,161311,152613,8698,5.4
Galveston County,2017-Aug,161012,152108,8904,5.5
Galveston County,2017-Sep,161432,152754,8678,5.4
Galveston County,2017-Oct,160506,152900,7606,4.7
Galveston County,2017-Nov,161436,153547,7889,4.9
Galveston County,2017-Dec,161304,153501,7803,4.8
Galveston County,2018-Jan,159910,151369,8541,5.3
Galveston County,2018-Feb,161817,153596,8221,5.1
Galveston County,2018-Mar,161312,153633,7679,4.8
Galveston County,2018-Apr,161308,154125,7183,4.5
Galveston County,2018-May,161084,153988,7096,4.4
Galveston County,2018-Jun,162265,154061,8204,5.1
Galveston County,2018-Jul,162495,154561,7934,4.9
Galveston County,2018-Aug,161156,153511,7645,4.7
Galveston County,2018-Sep,161501,154134,7367,4.6
Galveston County,2018-Oct,162013,155294,6719,4.1
Galveston County,2018-Nov,162570,155700,6870,4.2
Galveston County,2018-Dec,162924,155760,7164,4.4
Galveston County,2019-Jan,163036,155022,8014,4.9
Galveston County,2019-Feb,163897,156764,7133,4.4
Galveston County,2019-Mar,163011,156561,6450,4
Galveston County,2019-Apr,162416,156753,5663,3.5
Galveston County,2019-May,162492,156706,5786,3.6
Galveston County,2019-Jun,163914,156965,6949,4.2
Galveston County,2019-Jul,164571,157326,7245,4.4
Galveston County,2019-Aug,164034,156960,7074,4.3
Galveston County,2019-Sep,164476,157970,6506,4
Galveston County,2019-Oct,164765,158527,6238,3.8
Galveston County,2019-Nov,165188,158887,6301,3.8
Galveston County,2019-Dec,165001,158703,6298,3.8
Galveston County,2020-Jan,164469,157461,7008,4.3
Galveston County,2020-Feb,165635,159257,6378,3.9
Galveston County,2020-Mar,163183,153323,9860,6
Galveston County,2020-Apr,157996,135038,22958,14.5
Galveston County,2020-May,161917,140092,21825,13.5
Galveston County,2020-Jun,162604,143925,18679,11.5
Galveston County,2020-Jul,162652,144773,17879,11
Galveston County,2020-Aug,162317,147721,14596,9
Galveston County,2020-Sep,162742,148575,14167,8.7
Galveston County,2020-Oct,163317,151099,12218,7.5
Galveston County,2020-Nov,164577,151688,12889,7.8
Galveston County,2020-Dec,164350,151347,13003,7.9
Galveston County,2021-Jan,163830,150131,13699,8.4
Galveston County,2021-Feb,164776,151654,13122,8
Galveston County,2021-Mar,164186,152064,12122,7.4
Galveston County,2021-Apr,164111,152796,11315,6.9
Galveston County,2021-May,163802,152936,10866,6.6
Galveston County,2021-Jun,164986,152879,12107,7.3
Galveston County,2021-Jul,165571,154263,11308,6.8
Galveston County,2021-Aug,165219,154468,10751,6.5
Galveston County,2021-Sep,165301,155454,9847,6
Galveston County,2021-Oct,165603,156280,9323,5.6
Galveston County,2021-Nov,166529,157616,8913,5.4
Galveston County,2021-Dec,166713,158244,8469,5.1
Galveston County,2022-Jan,166746,157109,9637,5.8
Galveston County,2022-Feb,168136,158837,9299,5.5
Galveston County,2022-Mar,167520,159856,7664,4.6
Galveston County,2022-Apr,167096,159886,7210,4.3
Galveston County,2022-May,168088,160587,7501,4.5
Galveston County,2022-Jun,169858,161204,8654,5.1
Galveston County,2022-Jul,170050(P),161435(P),8615(P),5.1(P)
Garza County,2012-Jan,2186,2064,122,5.6
Garza County,2012-Feb,2177,2058,119,5.5
Garza County,2012-Mar,2169,2060,109,5
Garza County,2012-Apr,2153,2051,102,4.7
Garza County,2012-May,2167,2059,108,5
Garza County,2012-Jun,2206,2088,118,5.3
Garza County,2012-Jul,2218,2102,116,5.2
Garza County,2012-Aug,2204,2095,109,4.9
Garza County,2012-Sep,2178,2082,96,4.4
Garza County,2012-Oct,2219,2120,99,4.5
Garza County,2012-Nov,2204,2110,94,4.3
Garza County,2012-Dec,2196,2099,97,4.4
Garza County,2013-Jan,2191,2079,112,5.1
Garza County,2013-Feb,2174,2071,103,4.7
Garza County,2013-Mar,2161,2067,94,4.3
Garza County,2013-Apr,2220,2124,96,4.3
Garza County,2013-May,2219,2113,106,4.8
Garza County,2013-Jun,2243,2125,118,5.3
Garza County,2013-Jul,2308,2193,115,5
Garza County,2013-Aug,2277,2173,104,4.6
Garza County,2013-Sep,2288,2187,101,4.4
Garza County,2013-Oct,2242,2150,92,4.1
Garza County,2013-Nov,2238,2146,92,4.1
Garza County,2013-Dec,2236,2148,88,3.9
Garza County,2014-Jan,2186,2100,86,3.9
Garza County,2014-Feb,2219,2122,97,4.4
Garza County,2014-Mar,2244,2153,91,4.1
Garza County,2014-Apr,2258,2177,81,3.6
Garza County,2014-May,2261,2181,80,3.5
Garza County,2014-Jun,2288,2201,87,3.8
Garza County,2014-Jul,2298,2207,91,4
Garza County,2014-Aug,2262,2173,89,3.9
Garza County,2014-Sep,2249,2170,79,3.5
Garza County,2014-Oct,2234,2159,75,3.4
Garza County,2014-Nov,2206,2136,70,3.2
Garza County,2014-Dec,2173,2110,63,2.9
Garza County,2015-Jan,2149,2072,77,3.6
Garza County,2015-Feb,2160,2084,76,3.5
Garza County,2015-Mar,2160,2085,75,3.5
Garza County,2015-Apr,2165,2086,79,3.6
Garza County,2015-May,2158,2077,81,3.8
Garza County,2015-Jun,2152,2066,86,4
Garza County,2015-Jul,2122,2038,84,4
Garza County,2015-Aug,2098,2023,75,3.6
Garza County,2015-Sep,2099,2024,75,3.6
Garza County,2015-Oct,2110,2032,78,3.7
Garza County,2015-Nov,2099,2016,83,4
Garza County,2015-Dec,2106,2030,76,3.6
Garza County,2016-Jan,2095,2004,91,4.3
Garza County,2016-Feb,2138,2046,92,4.3
Garza County,2016-Mar,2153,2059,94,4.4
Garza County,2016-Apr,2130,2047,83,3.9
Garza County,2016-May,2163,2083,80,3.7
Garza County,2016-Jun,2166,2084,82,3.8
Garza County,2016-Jul,2141,2051,90,4.2
Garza County,2016-Aug,2114,2036,78,3.7
Garza County,2016-Sep,2126,2045,81,3.8
Garza County,2016-Oct,2110,2034,76,3.6
Garza County,2016-Nov,2108,2031,77,3.7
Garza County,2016-Dec,2126,2051,75,3.5
Garza County,2017-Jan,2104,2017,87,4.1
Garza County,2017-Feb,2124,2034,90,4.2
Garza County,2017-Mar,2139,2060,79,3.7
Garza County,2017-Apr,2124,2058,66,3.1
Garza County,2017-May,2095,2030,65,3.1
Garza County,2017-Jun,2087,2014,73,3.5
Garza County,2017-Jul,2114,2040,74,3.5
Garza County,2017-Aug,2123,2050,73,3.4
Garza County,2017-Sep,2100,2038,62,3
Garza County,2017-Oct,2084,2030,54,2.6
Garza County,2017-Nov,2071,2010,61,2.9
Garza County,2017-Dec,2099,2041,58,2.8
Garza County,2018-Jan,2135,2073,62,2.9
Garza County,2018-Feb,2149,2080,69,3.2
Garza County,2018-Mar,2158,2090,68,3.2
Garza County,2018-Apr,2115,2052,63,3
Garza County,2018-May,2117,2059,58,2.7
Garza County,2018-Jun,2126,2056,70,3.3
Garza County,2018-Jul,2092,2027,65,3.1
Garza County,2018-Aug,2085,2022,63,3
Garza County,2018-Sep,2083,2021,62,3
Garza County,2018-Oct,2089,2035,54,2.6
Garza County,2018-Nov,2116,2060,56,2.6
Garza County,2018-Dec,2109,2055,54,2.6
Garza County,2019-Jan,2102,2041,61,2.9
Garza County,2019-Feb,2136,2074,62,2.9
Garza County,2019-Mar,2126,2070,56,2.6
Garza County,2019-Apr,2131,2080,51,2.4
Garza County,2019-May,2118,2073,45,2.1
Garza County,2019-Jun,2127,2067,60,2.8
Garza County,2019-Jul,2139,2081,58,2.7
Garza County,2019-Aug,2151,2096,55,2.6
Garza County,2019-Sep,2102,2050,52,2.5
Garza County,2019-Oct,2086,2039,47,2.3
Garza County,2019-Nov,2057,2004,53,2.6
Garza County,2019-Dec,2057,2002,55,2.7
Garza County,2020-Jan,2041,1973,68,3.3
Garza County,2020-Feb,2050,1990,60,2.9
Garza County,2020-Mar,2039,1944,95,4.7
Garza County,2020-Apr,1880,1740,140,7.4
Garza County,2020-May,1934,1746,188,9.7
Garza County,2020-Jun,1965,1771,194,9.9
Garza County,2020-Jul,2002,1821,181,9
Garza County,2020-Aug,2052,1895,157,7.7
Garza County,2020-Sep,2014,1865,149,7.4
Garza County,2020-Oct,2009,1878,131,6.5
Garza County,2020-Nov,1986,1846,140,7
Garza County,2020-Dec,1963,1836,127,6.5
Garza County,2021-Jan,1992,1861,131,6.6
Garza County,2021-Feb,2021,1897,124,6.1
Garza County,2021-Mar,2023,1906,117,5.8
Garza County,2021-Apr,1999,1895,104,5.2
Garza County,2021-May,1992,1890,102,5.1
Garza County,2021-Jun,2004,1889,115,5.7
Garza County,2021-Jul,2009,1910,99,4.9
Garza County,2021-Aug,1999,1908,91,4.6
Garza County,2021-Sep,1986,1898,88,4.4
Garza County,2021-Oct,1960,1879,81,4.1
Garza County,2021-Nov,1939,1864,75,3.9
Garza County,2021-Dec,1932,1861,71,3.7
Garza County,2022-Jan,1932,1856,76,3.9
Garza County,2022-Feb,1976,1902,74,3.7
Garza County,2022-Mar,2000,1938,62,3.1
Garza County,2022-Apr,1960,1908,52,2.7
Garza County,2022-May,1965,1900,65,3.3
Garza County,2022-Jun,1983,1905,78,3.9
Garza County,2022-Jul,2046(P),1933(P),113(P),5.5(P)
Gillespie County,2012-Jan,12281,11652,629,5.1
Gillespie County,2012-Feb,12218,11618,600,4.9
Gillespie County,2012-Mar,12287,11734,553,4.5
Gillespie County,2012-Apr,12215,11690,525,4.3
Gillespie County,2012-May,12232,11655,577,4.7
Gillespie County,2012-Jun,12479,11841,638,5.1
Gillespie County,2012-Jul,12443,11791,652,5.2
Gillespie County,2012-Aug,12372,11773,599,4.8
Gillespie County,2012-Sep,12314,11760,554,4.5
Gillespie County,2012-Oct,12204,11681,523,4.3
Gillespie County,2012-Nov,12247,11735,512,4.2
Gillespie County,2012-Dec,12333,11808,525,4.3
Gillespie County,2013-Jan,12177,11562,615,5.1
Gillespie County,2013-Feb,12136,11570,566,4.7
Gillespie County,2013-Mar,12194,11654,540,4.4
Gillespie County,2013-Apr,12317,11799,518,4.2
Gillespie County,2013-May,12468,11907,561,4.5
Gillespie County,2013-Jun,12627,12010,617,4.9
Gillespie County,2013-Jul,12675,12066,609,4.8
Gillespie County,2013-Aug,12430,11872,558,4.5
Gillespie County,2013-Sep,12452,11889,563,4.5
Gillespie County,2013-Oct,12320,11808,512,4.2
Gillespie County,2013-Nov,12437,11947,490,3.9
Gillespie County,2013-Dec,12554,12099,455,3.6
Gillespie County,2014-Jan,12253,11771,482,3.9
Gillespie County,2014-Feb,12328,11836,492,4
Gillespie County,2014-Mar,12409,11943,466,3.8
Gillespie County,2014-Apr,12438,12060,378,3
Gillespie County,2014-May,12457,12014,443,3.6
Gillespie County,2014-Jun,12565,12091,474,3.8
Gillespie County,2014-Jul,12657,12152,505,4
Gillespie County,2014-Aug,12556,12085,471,3.8
Gillespie County,2014-Sep,12505,12051,454,3.6
Gillespie County,2014-Oct,12579,12161,418,3.3
Gillespie County,2014-Nov,12596,12187,409,3.2
Gillespie County,2014-Dec,12652,12289,363,2.9
Gillespie County,2015-Jan,12474,12050,424,3.4
Gillespie County,2015-Feb,12451,12057,394,3.2
Gillespie County,2015-Mar,12657,12298,359,2.8
Gillespie County,2015-Apr,12582,12258,324,2.6
Gillespie County,2015-May,12726,12366,360,2.8
Gillespie County,2015-Jun,12785,12393,392,3.1
Gillespie County,2015-Jul,12830,12431,399,3.1
Gillespie County,2015-Aug,12653,12307,346,2.7
Gillespie County,2015-Sep,12511,12147,364,2.9
Gillespie County,2015-Oct,12592,12232,360,2.9
Gillespie County,2015-Nov,12651,12298,353,2.8
Gillespie County,2015-Dec,12854,12528,326,2.5
Gillespie County,2016-Jan,12647,12296,351,2.8
Gillespie County,2016-Feb,12890,12530,360,2.8
Gillespie County,2016-Mar,13034,12674,360,2.8
Gillespie County,2016-Apr,12968,12645,323,2.5
Gillespie County,2016-May,13127,12789,338,2.6
Gillespie County,2016-Jun,13190,12802,388,2.9
Gillespie County,2016-Jul,13190,12773,417,3.2
Gillespie County,2016-Aug,13103,12713,390,3
Gillespie County,2016-Sep,12877,12480,397,3.1
Gillespie County,2016-Oct,12916,12536,380,2.9
Gillespie County,2016-Nov,13046,12675,371,2.8
Gillespie County,2016-Dec,13023,12658,365,2.8
Gillespie County,2017-Jan,12678,12280,398,3.1
Gillespie County,2017-Feb,12918,12519,399,3.1
Gillespie County,2017-Mar,13069,12705,364,2.8
Gillespie County,2017-Apr,13033,12727,306,2.3
Gillespie County,2017-May,13083,12751,332,2.5
Gillespie County,2017-Jun,13234,12887,347,2.6
Gillespie County,2017-Jul,13148,12781,367,2.8
Gillespie County,2017-Aug,13095,12749,346,2.6
Gillespie County,2017-Sep,12948,12623,325,2.5
Gillespie County,2017-Oct,12913,12618,295,2.3
Gillespie County,2017-Nov,13100,12784,316,2.4
Gillespie County,2017-Dec,13215,12917,298,2.3
Gillespie County,2018-Jan,12996,12652,344,2.6
Gillespie County,2018-Feb,13107,12761,346,2.6
Gillespie County,2018-Mar,13316,12963,353,2.7
Gillespie County,2018-Apr,13281,12969,312,2.3
Gillespie County,2018-May,13335,13028,307,2.3
Gillespie County,2018-Jun,13437,13078,359,2.7
Gillespie County,2018-Jul,13401,13054,347,2.6
Gillespie County,2018-Aug,13260,12908,352,2.7
Gillespie County,2018-Sep,13130,12788,342,2.6
Gillespie County,2018-Oct,13140,12812,328,2.5
Gillespie County,2018-Nov,13338,12996,342,2.6
Gillespie County,2018-Dec,13252,12913,339,2.6
Gillespie County,2019-Jan,13126,12734,392,3
Gillespie County,2019-Feb,13273,12901,372,2.8
Gillespie County,2019-Mar,13331,12984,347,2.6
Gillespie County,2019-Apr,13268,12980,288,2.2
Gillespie County,2019-May,13344,13048,296,2.2
Gillespie County,2019-Jun,13566,13214,352,2.6
Gillespie County,2019-Jul,13547,13194,353,2.6
Gillespie County,2019-Aug,13447,13113,334,2.5
Gillespie County,2019-Sep,13310,12995,315,2.4
Gillespie County,2019-Oct,13392,13096,296,2.2
Gillespie County,2019-Nov,13494,13192,302,2.2
Gillespie County,2019-Dec,13649,13375,274,2
Gillespie County,2020-Jan,13356,13025,331,2.5
Gillespie County,2020-Feb,13508,13185,323,2.4
Gillespie County,2020-Mar,13274,12774,500,3.8
Gillespie County,2020-Apr,11766,10626,1140,9.7
Gillespie County,2020-May,12540,11540,1000,8
Gillespie County,2020-Jun,13061,12234,827,6.3
Gillespie County,2020-Jul,13114,12396,718,5.5
Gillespie County,2020-Aug,13229,12636,593,4.5
Gillespie County,2020-Sep,13178,12615,563,4.3
Gillespie County,2020-Oct,13539,13045,494,3.6
Gillespie County,2020-Nov,13618,13112,506,3.7
Gillespie County,2020-Dec,13641,13138,503,3.7
Gillespie County,2021-Jan,13428,12879,549,4.1
Gillespie County,2021-Feb,13398,12862,536,4
Gillespie County,2021-Mar,13765,13251,514,3.7
Gillespie County,2021-Apr,13692,13256,436,3.2
Gillespie County,2021-May,13810,13361,449,3.3
Gillespie County,2021-Jun,14159,13641,518,3.7
Gillespie County,2021-Jul,14251,13785,466,3.3
Gillespie County,2021-Aug,14160,13703,457,3.2
Gillespie County,2021-Sep,13950,13514,436,3.1
Gillespie County,2021-Oct,14139,13727,412,2.9
Gillespie County,2021-Nov,14245,13848,397,2.8
Gillespie County,2021-Dec,14268,13906,362,2.5
Gillespie County,2022-Jan,13945,13526,419,3
Gillespie County,2022-Feb,14051,13626,425,3
Gillespie County,2022-Mar,14420,14073,347,2.4
Gillespie County,2022-Apr,14421,14095,326,2.3
Gillespie County,2022-May,14548,14199,349,2.4
Gillespie County,2022-Jun,14910,14512,398,2.7
Gillespie County,2022-Jul,15030(P),14654(P),376(P),2.5(P)
Glasscock County,2012-Jan,723,693,30,4.1
Glasscock County,2012-Feb,711,680,31,4.4
Glasscock County,2012-Mar,734,704,30,4.1
Glasscock County,2012-Apr,760,730,30,3.9
Glasscock County,2012-May,778,746,32,4.1
Glasscock County,2012-Jun,817,782,35,4.3
Glasscock County,2012-Jul,818,782,36,4.4
Glasscock County,2012-Aug,780,748,32,4.1
Glasscock County,2012-Sep,777,749,28,3.6
Glasscock County,2012-Oct,756,730,26,3.4
Glasscock County,2012-Nov,753,725,28,3.7
Glasscock County,2012-Dec,724,699,25,3.5
Glasscock County,2013-Jan,686,657,29,4.2
Glasscock County,2013-Feb,686,660,26,3.8
Glasscock County,2013-Mar,683,658,25,3.7
Glasscock County,2013-Apr,730,705,25,3.4
Glasscock County,2013-May,751,723,28,3.7
Glasscock County,2013-Jun,781,749,32,4.1
Glasscock County,2013-Jul,791,759,32,4
Glasscock County,2013-Aug,753,727,26,3.5
Glasscock County,2013-Sep,766,740,26,3.4
Glasscock County,2013-Oct,782,757,25,3.2
Glasscock County,2013-Nov,729,705,24,3.3
Glasscock County,2013-Dec,763,740,23,3
Glasscock County,2014-Jan,764,739,25,3.3
Glasscock County,2014-Feb,793,768,25,3.2
Glasscock County,2014-Mar,803,780,23,2.9
Glasscock County,2014-Apr,828,807,21,2.5
Glasscock County,2014-May,860,838,22,2.6
Glasscock County,2014-Jun,861,836,25,2.9
Glasscock County,2014-Jul,862,836,26,3
Glasscock County,2014-Aug,835,812,23,2.8
Glasscock County,2014-Sep,840,818,22,2.6
Glasscock County,2014-Oct,849,829,20,2.4
Glasscock County,2014-Nov,823,804,19,2.3
Glasscock County,2014-Dec,825,808,17,2.1
Glasscock County,2015-Jan,820,798,22,2.7
Glasscock County,2015-Feb,850,829,21,2.5
Glasscock County,2015-Mar,868,849,19,2.2
Glasscock County,2015-Apr,843,825,18,2.1
Glasscock County,2015-May,864,842,22,2.5
Glasscock County,2015-Jun,851,826,25,2.9
Glasscock County,2015-Jul,831,804,27,3.2
Glasscock County,2015-Aug,801,778,23,2.9
Glasscock County,2015-Sep,811,788,23,2.8
Glasscock County,2015-Oct,798,774,24,3
Glasscock County,2015-Nov,762,737,25,3.3
Glasscock County,2015-Dec,764,735,29,3.8
Glasscock County,2016-Jan,731,700,31,4.2
Glasscock County,2016-Feb,784,758,26,3.3
Glasscock County,2016-Mar,785,759,26,3.3
Glasscock County,2016-Apr,803,773,30,3.7
Glasscock County,2016-May,822,794,28,3.4
Glasscock County,2016-Jun,793,758,35,4.4
Glasscock County,2016-Jul,740,706,34,4.6
Glasscock County,2016-Aug,762,731,31,4.1
Glasscock County,2016-Sep,734,705,29,4
Glasscock County,2016-Oct,681,653,28,4.1
Glasscock County,2016-Nov,673,651,22,3.3
Glasscock County,2016-Dec,675,652,23,3.4
Glasscock County,2017-Jan,650,627,23,3.5
Glasscock County,2017-Feb,684,662,22,3.2
Glasscock County,2017-Mar,730,710,20,2.7
Glasscock County,2017-Apr,716,698,18,2.5
Glasscock County,2017-May,728,711,17,2.3
Glasscock County,2017-Jun,716,695,21,2.9
Glasscock County,2017-Jul,674,656,18,2.7
Glasscock County,2017-Aug,704,685,19,2.7
Glasscock County,2017-Sep,677,661,16,2.4
Glasscock County,2017-Oct,733,718,15,2
Glasscock County,2017-Nov,702,685,17,2.4
Glasscock County,2017-Dec,726,710,16,2.2
Glasscock County,2018-Jan,779,761,18,2.3
Glasscock County,2018-Feb,796,778,18,2.3
Glasscock County,2018-Mar,864,846,18,2.1
Glasscock County,2018-Apr,843,828,15,1.8
Glasscock County,2018-May,866,850,16,1.8
Glasscock County,2018-Jun,849,830,19,2.2
Glasscock County,2018-Jul,839,819,20,2.4
Glasscock County,2018-Aug,901,882,19,2.1
Glasscock County,2018-Sep,895,877,18,2
Glasscock County,2018-Oct,879,862,17,1.9
Glasscock County,2018-Nov,819,801,18,2.2
Glasscock County,2018-Dec,796,780,16,2
Glasscock County,2019-Jan,729,709,20,2.7
Glasscock County,2019-Feb,765,746,19,2.5
Glasscock County,2019-Mar,800,782,18,2.3
Glasscock County,2019-Apr,781,767,14,1.8
Glasscock County,2019-May,797,782,15,1.9
Glasscock County,2019-Jun,804,785,19,2.4
Glasscock County,2019-Jul,790,769,21,2.7
Glasscock County,2019-Aug,818,799,19,2.3
Glasscock County,2019-Sep,789,772,17,2.2
Glasscock County,2019-Oct,831,814,17,2
Glasscock County,2019-Nov,781,765,16,2
Glasscock County,2019-Dec,788,774,14,1.8
Glasscock County,2020-Jan,841,825,16,1.9
Glasscock County,2020-Feb,868,852,16,1.8
Glasscock County,2020-Mar,878,852,26,3
Glasscock County,2020-Apr,763,732,31,4.1
Glasscock County,2020-May,754,717,37,4.9
Glasscock County,2020-Jun,759,722,37,4.9
Glasscock County,2020-Jul,775,742,33,4.3
Glasscock County,2020-Aug,794,764,30,3.8
Glasscock County,2020-Sep,773,739,34,4.4
Glasscock County,2020-Oct,809,780,29,3.6
Glasscock County,2020-Nov,774,744,30,3.9
Glasscock County,2020-Dec,783,755,28,3.6
Glasscock County,2021-Jan,802,776,26,3.2
Glasscock County,2021-Feb,815,789,26,3.2
Glasscock County,2021-Mar,867,839,28,3.2
Glasscock County,2021-Apr,851,828,23,2.7
Glasscock County,2021-May,846,820,26,3.1
Glasscock County,2021-Jun,822,793,29,3.5
Glasscock County,2021-Jul,811,783,28,3.5
Glasscock County,2021-Aug,816,791,25,3.1
Glasscock County,2021-Sep,808,786,22,2.7
Glasscock County,2021-Oct,806,786,20,2.5
Glasscock County,2021-Nov,772,751,21,2.7
Glasscock County,2021-Dec,771,752,19,2.5
Glasscock County,2022-Jan,788,766,22,2.8
Glasscock County,2022-Feb,847,821,26,3.1
Glasscock County,2022-Mar,908,883,25,2.8
Glasscock County,2022-Apr,879,858,21,2.4
Glasscock County,2022-May,849,828,21,2.5
Glasscock County,2022-Jun,831,806,25,3
Glasscock County,2022-Jul,878(P),855(P),23(P),2.6(P)
Goliad County,2012-Jan,3407,3204,203,6
Goliad County,2012-Feb,3416,3222,194,5.7
Goliad County,2012-Mar,3425,3244,181,5.3
Goliad County,2012-Apr,3439,3264,175,5.1
Goliad County,2012-May,3452,3263,189,5.5
Goliad County,2012-Jun,3496,3287,209,6
Goliad County,2012-Jul,3502,3294,208,5.9
Goliad County,2012-Aug,3484,3287,197,5.7
Goliad County,2012-Sep,3518,3336,182,5.2
Goliad County,2012-Oct,3506,3332,174,5
Goliad County,2012-Nov,3508,3329,179,5.1
Goliad County,2012-Dec,3511,3325,186,5.3
Goliad County,2013-Jan,3476,3262,214,6.2
Goliad County,2013-Feb,3470,3281,189,5.4
Goliad County,2013-Mar,3459,3280,179,5.2
Goliad County,2013-Apr,3511,3334,177,5
Goliad County,2013-May,3552,3352,200,5.6
Goliad County,2013-Jun,3568,3355,213,6
Goliad County,2013-Jul,3576,3375,201,5.6
Goliad County,2013-Aug,3561,3381,180,5.1
Goliad County,2013-Sep,3574,3387,187,5.2
Goliad County,2013-Oct,3541,3366,175,4.9
Goliad County,2013-Nov,3538,3379,159,4.5
Goliad County,2013-Dec,3538,3391,147,4.2
Goliad County,2014-Jan,3508,3346,162,4.6
Goliad County,2014-Feb,3544,3378,166,4.7
Goliad County,2014-Mar,3544,3397,147,4.1
Goliad County,2014-Apr,3548,3417,131,3.7
Goliad County,2014-May,3569,3420,149,4.2
Goliad County,2014-Jun,3582,3419,163,4.6
Goliad County,2014-Jul,3580,3412,168,4.7
Goliad County,2014-Aug,3584,3423,161,4.5
Goliad County,2014-Sep,3595,3448,147,4.1
Goliad County,2014-Oct,3594,3461,133,3.7
Goliad County,2014-Nov,3583,3453,130,3.6
Goliad County,2014-Dec,3557,3440,117,3.3
Goliad County,2015-Jan,3465,3330,135,3.9
Goliad County,2015-Feb,3476,3337,139,4
Goliad County,2015-Mar,3465,3327,138,4
Goliad County,2015-Apr,3480,3347,133,3.8
Goliad County,2015-May,3492,3342,150,4.3
Goliad County,2015-Jun,3478,3307,171,4.9
Goliad County,2015-Jul,3459,3282,177,5.1
Goliad County,2015-Aug,3443,3272,171,5
Goliad County,2015-Sep,3428,3263,165,4.8
Goliad County,2015-Oct,3414,3250,164,4.8
Goliad County,2015-Nov,3411,3245,166,4.9
Goliad County,2015-Dec,3377,3233,144,4.3
Goliad County,2016-Jan,3330,3169,161,4.8
Goliad County,2016-Feb,3355,3188,167,5
Goliad County,2016-Mar,3362,3175,187,5.6
Goliad County,2016-Apr,3360,3165,195,5.8
Goliad County,2016-May,3349,3154,195,5.8
Goliad County,2016-Jun,3319,3109,210,6.3
Goliad County,2016-Jul,3317,3108,209,6.3
Goliad County,2016-Aug,3316,3109,207,6.2
Goliad County,2016-Sep,3301,3098,203,6.1
Goliad County,2016-Oct,3274,3082,192,5.9
Goliad County,2016-Nov,3283,3088,195,5.9
Goliad County,2016-Dec,3266,3076,190,5.8
Goliad County,2017-Jan,3260,3054,206,6.3
Goliad County,2017-Feb,3291,3089,202,6.1
Goliad County,2017-Mar,3306,3120,186,5.6
Goliad County,2017-Apr,3300,3129,171,5.2
Goliad County,2017-May,3275,3118,157,4.8
Goliad County,2017-Jun,3263,3107,156,4.8
Goliad County,2017-Jul,3236,3081,155,4.8
Goliad County,2017-Aug,3232,3078,154,4.8
Goliad County,2017-Sep,3211,3063,148,4.6
Goliad County,2017-Oct,3205,3072,133,4.1
Goliad County,2017-Nov,3223,3084,139,4.3
Goliad County,2017-Dec,3219,3095,124,3.9
Goliad County,2018-Jan,3222,3082,140,4.3
Goliad County,2018-Feb,3263,3120,143,4.4
Goliad County,2018-Mar,3280,3140,140,4.3
Goliad County,2018-Apr,3270,3149,121,3.7
Goliad County,2018-May,3265,3148,117,3.6
Goliad County,2018-Jun,3259,3127,132,4.1
Goliad County,2018-Jul,3254,3126,128,3.9
Goliad County,2018-Aug,3243,3118,125,3.9
Goliad County,2018-Sep,3244,3126,118,3.6
Goliad County,2018-Oct,3230,3118,112,3.5
Goliad County,2018-Nov,3243,3129,114,3.5
Goliad County,2018-Dec,3233,3124,109,3.4
Goliad County,2019-Jan,3263,3131,132,4
Goliad County,2019-Feb,3275,3156,119,3.6
Goliad County,2019-Mar,3268,3159,109,3.3
Goliad County,2019-Apr,3221,3126,95,2.9
Goliad County,2019-May,3222,3132,90,2.8
Goliad County,2019-Jun,3230,3119,111,3.4
Goliad County,2019-Jul,3234,3118,116,3.6
Goliad County,2019-Aug,3243,3132,111,3.4
Goliad County,2019-Sep,3224,3122,102,3.2
Goliad County,2019-Oct,3199,3097,102,3.2
Goliad County,2019-Nov,3187,3073,114,3.6
Goliad County,2019-Dec,3187,3082,105,3.3
Goliad County,2020-Jan,3164,3041,123,3.9
Goliad County,2020-Feb,3158,3043,115,3.6
Goliad County,2020-Mar,3123,2942,181,5.8
Goliad County,2020-Apr,2912,2627,285,9.8
Goliad County,2020-May,3013,2709,304,10.1
Goliad County,2020-Jun,3092,2776,316,10.2
Goliad County,2020-Jul,3110,2785,325,10.5
Goliad County,2020-Aug,3137,2859,278,8.9
Goliad County,2020-Sep,3134,2879,255,8.1
Goliad County,2020-Oct,3142,2910,232,7.4
Goliad County,2020-Nov,3141,2898,243,7.7
Goliad County,2020-Dec,3155,2913,242,7.7
Goliad County,2021-Jan,3175,2908,267,8.4
Goliad County,2021-Feb,3191,2931,260,8.1
Goliad County,2021-Mar,3186,2950,236,7.4
Goliad County,2021-Apr,3142,2924,218,6.9
Goliad County,2021-May,3118,2915,203,6.5
Goliad County,2021-Jun,3120,2899,221,7.1
Goliad County,2021-Jul,3124,2922,202,6.5
Goliad County,2021-Aug,3125,2935,190,6.1
Goliad County,2021-Sep,3162,2979,183,5.8
Goliad County,2021-Oct,3166,2987,179,5.7
Goliad County,2021-Nov,3167,2994,173,5.5
Goliad County,2021-Dec,3158,3004,154,4.9
Goliad County,2022-Jan,3126,2949,177,5.7
Goliad County,2022-Feb,3168,2996,172,5.4
Goliad County,2022-Mar,3189,3047,142,4.5
Goliad County,2022-Apr,3147,3018,129,4.1
Goliad County,2022-May,3120,2984,136,4.4
Goliad County,2022-Jun,3122,2964,158,5.1
Goliad County,2022-Jul,3148(P),2989(P),159(P),5.1(P)
Gonzales County,2012-Jan,9202,8696,506,5.5
Gonzales County,2012-Feb,9205,8707,498,5.4
Gonzales County,2012-Mar,9309,8835,474,5.1
Gonzales County,2012-Apr,9487,9048,439,4.6
Gonzales County,2012-May,9507,9043,464,4.9
Gonzales County,2012-Jun,9769,9231,538,5.5
Gonzales County,2012-Jul,9636,9093,543,5.6
Gonzales County,2012-Aug,9497,9010,487,5.1
Gonzales County,2012-Sep,9486,9033,453,4.8
Gonzales County,2012-Oct,9435,8994,441,4.7
Gonzales County,2012-Nov,9416,8989,427,4.5
Gonzales County,2012-Dec,9269,8829,440,4.7
Gonzales County,2013-Jan,9193,8686,507,5.5
Gonzales County,2013-Feb,9198,8684,514,5.6
Gonzales County,2013-Mar,9125,8636,489,5.4
Gonzales County,2013-Apr,9358,8882,476,5.1
Gonzales County,2013-May,9538,9043,495,5.2
Gonzales County,2013-Jun,9743,9190,553,5.7
Gonzales County,2013-Jul,9733,9204,529,5.4
Gonzales County,2013-Aug,9606,9114,492,5.1
Gonzales County,2013-Sep,9708,9222,486,5
Gonzales County,2013-Oct,9672,9204,468,4.8
Gonzales County,2013-Nov,9515,9061,454,4.8
Gonzales County,2013-Dec,9571,9155,416,4.3
Gonzales County,2014-Jan,9652,9221,431,4.5
Gonzales County,2014-Feb,9763,9324,439,4.5
Gonzales County,2014-Mar,9822,9415,407,4.1
Gonzales County,2014-Apr,9919,9561,358,3.6
Gonzales County,2014-May,10132,9747,385,3.8
Gonzales County,2014-Jun,10123,9705,418,4.1
Gonzales County,2014-Jul,10046,9612,434,4.3
Gonzales County,2014-Aug,9912,9510,402,4.1
Gonzales County,2014-Sep,9973,9596,377,3.8
Gonzales County,2014-Oct,10091,9740,351,3.5
Gonzales County,2014-Nov,9879,9534,345,3.5
Gonzales County,2014-Dec,9750,9444,306,3.1
Gonzales County,2015-Jan,9578,9230,348,3.6
Gonzales County,2015-Feb,9717,9377,340,3.5
Gonzales County,2015-Mar,9774,9449,325,3.3
Gonzales County,2015-Apr,9789,9482,307,3.1
Gonzales County,2015-May,9910,9566,344,3.5
Gonzales County,2015-Jun,9872,9500,372,3.8
Gonzales County,2015-Jul,9669,9277,392,4.1
Gonzales County,2015-Aug,9585,9221,364,3.8
Gonzales County,2015-Sep,9712,9318,394,4.1
Gonzales County,2015-Oct,9678,9297,381,3.9
Gonzales County,2015-Nov,9565,9180,385,4
Gonzales County,2015-Dec,9586,9231,355,3.7
Gonzales County,2016-Jan,9363,8974,389,4.2
Gonzales County,2016-Feb,9692,9298,394,4.1
Gonzales County,2016-Mar,9805,9390,415,4.2
Gonzales County,2016-Apr,9695,9313,382,3.9
Gonzales County,2016-May,9818,9427,391,4
Gonzales County,2016-Jun,9664,9211,453,4.7
Gonzales County,2016-Jul,9480,9032,448,4.7
Gonzales County,2016-Aug,9622,9191,431,4.5
Gonzales County,2016-Sep,9527,9094,433,4.5
Gonzales County,2016-Oct,9467,9075,392,4.1
Gonzales County,2016-Nov,9381,9011,370,3.9
Gonzales County,2016-Dec,9374,8998,376,4
Gonzales County,2017-Jan,9311,8919,392,4.2
Gonzales County,2017-Feb,9418,9024,394,4.2
Gonzales County,2017-Mar,9668,9309,359,3.7
Gonzales County,2017-Apr,9452,9144,308,3.3
Gonzales County,2017-May,9452,9140,312,3.3
Gonzales County,2017-Jun,9388,9043,345,3.7
Gonzales County,2017-Jul,9125,8783,342,3.7
Gonzales County,2017-Aug,9225,8892,333,3.6
Gonzales County,2017-Sep,9100,8797,303,3.3
Gonzales County,2017-Oct,9254,8977,277,3
Gonzales County,2017-Nov,9077,8791,286,3.2
Gonzales County,2017-Dec,9161,8888,273,3
Gonzales County,2018-Jan,9117,8804,313,3.4
Gonzales County,2018-Feb,9286,8982,304,3.3
Gonzales County,2018-Mar,9579,9272,307,3.2
Gonzales County,2018-Apr,9392,9123,269,2.9
Gonzales County,2018-May,9559,9295,264,2.8
Gonzales County,2018-Jun,9450,9128,322,3.4
Gonzales County,2018-Jul,9443,9136,307,3.3
Gonzales County,2018-Aug,9614,9311,303,3.2
Gonzales County,2018-Sep,9559,9280,279,2.9
Gonzales County,2018-Oct,9323,9059,264,2.8
Gonzales County,2018-Nov,9269,9009,260,2.8
Gonzales County,2018-Dec,9134,8877,257,2.8
Gonzales County,2019-Jan,9266,8970,296,3.2
Gonzales County,2019-Feb,9415,9140,275,2.9
Gonzales County,2019-Mar,9545,9287,258,2.7
Gonzales County,2019-Apr,9380,9166,214,2.3
Gonzales County,2019-May,9476,9255,221,2.3
Gonzales County,2019-Jun,9440,9172,268,2.8
Gonzales County,2019-Jul,9428,9146,282,3
Gonzales County,2019-Aug,9566,9293,273,2.9
Gonzales County,2019-Sep,9488,9241,247,2.6
Gonzales County,2019-Oct,9711,9462,249,2.6
Gonzales County,2019-Nov,9512,9263,249,2.6
Gonzales County,2019-Dec,9537,9302,235,2.5
Gonzales County,2020-Jan,9573,9288,285,3
Gonzales County,2020-Feb,9667,9403,264,2.7
Gonzales County,2020-Mar,9630,9223,407,4.2
Gonzales County,2020-Apr,8840,8278,562,6.4
Gonzales County,2020-May,9065,8355,710,7.8
Gonzales County,2020-Jun,9164,8504,660,7.2
Gonzales County,2020-Jul,9395,8745,650,6.9
Gonzales County,2020-Aug,9623,9090,533,5.5
Gonzales County,2020-Sep,9566,9031,535,5.6
Gonzales County,2020-Oct,9678,9187,491,5.1
Gonzales County,2020-Nov,9545,9011,534,5.6
Gonzales County,2020-Dec,9552,9052,500,5.2
Gonzales County,2021-Jan,9675,9156,519,5.4
Gonzales County,2021-Feb,9713,9207,506,5.2
Gonzales County,2021-Mar,10096,9607,489,4.8
Gonzales County,2021-Apr,9805,9387,418,4.3
Gonzales County,2021-May,9546,9139,407,4.3
Gonzales County,2021-Jun,9481,9019,462,4.9
Gonzales County,2021-Jul,9477,9079,398,4.2
Gonzales County,2021-Aug,9500,9118,382,4
Gonzales County,2021-Sep,9603,9234,369,3.8
Gonzales County,2021-Oct,9511,9170,341,3.6
Gonzales County,2021-Nov,9365,9037,328,3.5
Gonzales County,2021-Dec,9354,9052,302,3.2
Gonzales County,2022-Jan,9473,9129,344,3.6
Gonzales County,2022-Feb,9775,9440,335,3.4
Gonzales County,2022-Mar,10153,9877,276,2.7
Gonzales County,2022-Apr,10046,9789,257,2.6
Gonzales County,2022-May,9678,9399,279,2.9
Gonzales County,2022-Jun,9586,9257,329,3.4
Gonzales County,2022-Jul,9884(P),9571(P),313(P),3.2(P)
Gray County,2012-Jan,9638,9057,581,6
Gray County,2012-Feb,9581,9010,571,6
Gray County,2012-Mar,9634,9106,528,5.5
Gray County,2012-Apr,9610,9107,503,5.2
Gray County,2012-May,9606,9072,534,5.6
Gray County,2012-Jun,9856,9254,602,6.1
Gray County,2012-Jul,9870,9264,606,6.1
Gray County,2012-Aug,9673,9103,570,5.9
Gray County,2012-Sep,9699,9174,525,5.4
Gray County,2012-Oct,9651,9137,514,5.3
Gray County,2012-Nov,9638,9166,472,4.9
Gray County,2012-Dec,9676,9191,485,5
Gray County,2013-Jan,9629,9078,551,5.7
Gray County,2013-Feb,9622,9086,536,5.6
Gray County,2013-Mar,9592,9090,502,5.2
Gray County,2013-Apr,9806,9311,495,5
Gray County,2013-May,9788,9269,519,5.3
Gray County,2013-Jun,9952,9381,571,5.7
Gray County,2013-Jul,9993,9452,541,5.4
Gray County,2013-Aug,9888,9378,510,5.2
Gray County,2013-Sep,9872,9366,506,5.1
Gray County,2013-Oct,9695,9214,481,5
Gray County,2013-Nov,9664,9214,450,4.7
Gray County,2013-Dec,9691,9266,425,4.4
Gray County,2014-Jan,9723,9266,457,4.7
Gray County,2014-Feb,9738,9274,464,4.8
Gray County,2014-Mar,9733,9307,426,4.4
Gray County,2014-Apr,9647,9269,378,3.9
Gray County,2014-May,9738,9345,393,4
Gray County,2014-Jun,9873,9455,418,4.2
Gray County,2014-Jul,9838,9408,430,4.4
Gray County,2014-Aug,9877,9464,413,4.2
Gray County,2014-Sep,9859,9471,388,3.9
Gray County,2014-Oct,9809,9454,355,3.6
Gray County,2014-Nov,9749,9403,346,3.5
Gray County,2014-Dec,9676,9366,310,3.2
Gray County,2015-Jan,9612,9214,398,4.1
Gray County,2015-Feb,9597,9161,436,4.5
Gray County,2015-Mar,9593,9142,451,4.7
Gray County,2015-Apr,9458,8970,488,5.2
Gray County,2015-May,9443,8924,519,5.5
Gray County,2015-Jun,9513,8953,560,5.9
Gray County,2015-Jul,9324,8751,573,6.1
Gray County,2015-Aug,9183,8631,552,6
Gray County,2015-Sep,9055,8481,574,6.3
Gray County,2015-Oct,8938,8351,587,6.6
Gray County,2015-Nov,8822,8221,601,6.8
Gray County,2015-Dec,8810,8252,558,6.3
Gray County,2016-Jan,8597,8019,578,6.7
Gray County,2016-Feb,8645,8067,578,6.7
Gray County,2016-Mar,8693,8097,596,6.9
Gray County,2016-Apr,8656,8078,578,6.7
Gray County,2016-May,8616,8030,586,6.8
Gray County,2016-Jun,8626,7971,655,7.6
Gray County,2016-Jul,8528,7896,632,7.4
Gray County,2016-Aug,8442,7834,608,7.2
Gray County,2016-Sep,8387,7773,614,7.3
Gray County,2016-Oct,8251,7704,547,6.6
Gray County,2016-Nov,8222,7697,525,6.4
Gray County,2016-Dec,8203,7674,529,6.4
Gray County,2017-Jan,8166,7606,560,6.9
Gray County,2017-Feb,8242,7697,545,6.6
Gray County,2017-Mar,8308,7808,500,6
Gray County,2017-Apr,8287,7836,451,5.4
Gray County,2017-May,8248,7805,443,5.4
Gray County,2017-Jun,8294,7848,446,5.4
Gray County,2017-Jul,8173,7748,425,5.2
Gray County,2017-Aug,8154,7747,407,5
Gray County,2017-Sep,8082,7708,374,4.6
Gray County,2017-Oct,8048,7710,338,4.2
Gray County,2017-Nov,8022,7671,351,4.4
Gray County,2017-Dec,8055,7707,348,4.3
Gray County,2018-Jan,8026,7651,375,4.7
Gray County,2018-Feb,8073,7695,378,4.7
Gray County,2018-Mar,8099,7761,338,4.2
Gray County,2018-Apr,8081,7789,292,3.6
Gray County,2018-May,8090,7807,283,3.5
Gray County,2018-Jun,8224,7897,327,4
Gray County,2018-Jul,8158,7843,315,3.9
Gray County,2018-Aug,8043,7734,309,3.8
Gray County,2018-Sep,8036,7732,304,3.8
Gray County,2018-Oct,7911,7620,291,3.7
Gray County,2018-Nov,7919,7631,288,3.6
Gray County,2018-Dec,7920,7640,280,3.5
Gray County,2019-Jan,7873,7547,326,4.1
Gray County,2019-Feb,7970,7661,309,3.9
Gray County,2019-Mar,7910,7622,288,3.6
Gray County,2019-Apr,7897,7645,252,3.2
Gray County,2019-May,7919,7670,249,3.1
Gray County,2019-Jun,8020,7726,294,3.7
Gray County,2019-Jul,8062,7756,306,3.8
Gray County,2019-Aug,8078,7786,292,3.6
Gray County,2019-Sep,8009,7729,280,3.5
Gray County,2019-Oct,7952,7692,260,3.3
Gray County,2019-Nov,7877,7591,286,3.6
Gray County,2019-Dec,7852,7582,270,3.4
Gray County,2020-Jan,7816,7496,320,4.1
Gray County,2020-Feb,7822,7524,298,3.8
Gray County,2020-Mar,7720,7263,457,5.9
Gray County,2020-Apr,7401,6710,691,9.3
Gray County,2020-May,7616,6861,755,9.9
Gray County,2020-Jun,7750,6871,879,11.3
Gray County,2020-Jul,7774,6958,816,10.5
Gray County,2020-Aug,7768,7075,693,8.9
Gray County,2020-Sep,7656,6995,661,8.6
Gray County,2020-Oct,7715,7112,603,7.8
Gray County,2020-Nov,7718,7053,665,8.6
Gray County,2020-Dec,7704,7028,676,8.8
Gray County,2021-Jan,7660,7000,660,8.6
Gray County,2021-Feb,7728,7093,635,8.2
Gray County,2021-Mar,7748,7157,591,7.6
Gray County,2021-Apr,7734,7204,530,6.9
Gray County,2021-May,7713,7207,506,6.6
Gray County,2021-Jun,7773,7209,564,7.3
Gray County,2021-Jul,7659,7154,505,6.6
Gray County,2021-Aug,7682,7192,490,6.4
Gray County,2021-Sep,7662,7199,463,6
Gray County,2021-Oct,7655,7225,430,5.6
Gray County,2021-Nov,7607,7205,402,5.3
Gray County,2021-Dec,7556,7184,372,4.9
Gray County,2022-Jan,7559,7132,427,5.6
Gray County,2022-Feb,7666,7237,429,5.6
Gray County,2022-Mar,7741,7391,350,4.5
Gray County,2022-Apr,7713,7388,325,4.2
Gray County,2022-May,7730,7383,347,4.5
Gray County,2022-Jun,7779,7383,396,5.1
Gray County,2022-Jul,7747(P),7359(P),388(P),5.0(P)
Grayson County,2012-Jan,59252,54857,4395,7.4
Grayson County,2012-Feb,59377,55004,4373,7.4
Grayson County,2012-Mar,59444,55344,4100,6.9
Grayson County,2012-Apr,59526,55652,3874,6.5
Grayson County,2012-May,60040,55978,4062,6.8
Grayson County,2012-Jun,60540,56156,4384,7.2
Grayson County,2012-Jul,60570,56212,4358,7.2
Grayson County,2012-Aug,59926,55825,4101,6.8
Grayson County,2012-Sep,59750,55941,3809,6.4
Grayson County,2012-Oct,59802,56025,3777,6.3
Grayson County,2012-Nov,59885,56208,3677,6.1
Grayson County,2012-Dec,60393,56411,3982,6.6
Grayson County,2013-Jan,59819,55451,4368,7.3
Grayson County,2013-Feb,59791,55677,4114,6.9
Grayson County,2013-Mar,59742,55846,3896,6.5
Grayson County,2013-Apr,59821,56075,3746,6.3
Grayson County,2013-May,60158,56321,3837,6.4
Grayson County,2013-Jun,60867,56674,4193,6.9
Grayson County,2013-Jul,61242,57219,4023,6.6
Grayson County,2013-Aug,61033,57293,3740,6.1
Grayson County,2013-Sep,60839,57072,3767,6.2
Grayson County,2013-Oct,60284,56759,3525,5.8
Grayson County,2013-Nov,60827,57462,3365,5.5
Grayson County,2013-Dec,60435,57257,3178,5.3
Grayson County,2014-Jan,60124,56802,3322,5.5
Grayson County,2014-Feb,60577,57235,3342,5.5
Grayson County,2014-Mar,60702,57513,3189,5.3
Grayson County,2014-Apr,60216,57497,2719,4.5
Grayson County,2014-May,60405,57450,2955,4.9
Grayson County,2014-Jun,60641,57505,3136,5.2
Grayson County,2014-Jul,60730,57514,3216,5.3
Grayson County,2014-Aug,60330,57243,3087,5.1
Grayson County,2014-Sep,60045,57160,2885,4.8
Grayson County,2014-Oct,59898,57192,2706,4.5
Grayson County,2014-Nov,60085,57445,2640,4.4
Grayson County,2014-Dec,59475,57073,2402,4
Grayson County,2015-Jan,59150,56427,2723,4.6
Grayson County,2015-Feb,59480,56912,2568,4.3
Grayson County,2015-Mar,59305,56891,2414,4.1
Grayson County,2015-Apr,59903,57701,2202,3.7
Grayson County,2015-May,60313,57967,2346,3.9
Grayson County,2015-Jun,60477,57906,2571,4.3
Grayson County,2015-Jul,60784,58161,2623,4.3
Grayson County,2015-Aug,60424,57871,2553,4.2
Grayson County,2015-Sep,59795,57407,2388,4
Grayson County,2015-Oct,59985,57650,2335,3.9
Grayson County,2015-Nov,60330,57991,2339,3.9
Grayson County,2015-Dec,60298,58077,2221,3.7
Grayson County,2016-Jan,60070,57684,2386,4
Grayson County,2016-Feb,60868,58489,2379,3.9
Grayson County,2016-Mar,60710,58310,2400,4
Grayson County,2016-Apr,61074,58887,2187,3.6
Grayson County,2016-May,61185,59011,2174,3.6
Grayson County,2016-Jun,61378,58871,2507,4.1
Grayson County,2016-Jul,61785,59180,2605,4.2
Grayson County,2016-Aug,61577,59115,2462,4
Grayson County,2016-Sep,61243,58785,2458,4
Grayson County,2016-Oct,61566,59253,2313,3.8
Grayson County,2016-Nov,61715,59453,2262,3.7
Grayson County,2016-Dec,61606,59375,2231,3.6
Grayson County,2017-Jan,60605,58138,2467,4.1
Grayson County,2017-Feb,61306,58774,2532,4.1
Grayson County,2017-Mar,61643,59279,2364,3.8
Grayson County,2017-Apr,61501,59371,2130,3.5
Grayson County,2017-May,61395,59235,2160,3.5
Grayson County,2017-Jun,61462,59141,2321,3.8
Grayson County,2017-Jul,61937,59666,2271,3.7
Grayson County,2017-Aug,61744,59469,2275,3.7
Grayson County,2017-Sep,61579,59520,2059,3.3
Grayson County,2017-Oct,61393,59511,1882,3.1
Grayson County,2017-Nov,61751,59737,2014,3.3
Grayson County,2017-Dec,61458,59538,1920,3.1
Grayson County,2018-Jan,61596,59405,2191,3.6
Grayson County,2018-Feb,62268,60066,2202,3.5
Grayson County,2018-Mar,62099,59941,2158,3.5
Grayson County,2018-Apr,62563,60613,1950,3.1
Grayson County,2018-May,62514,60568,1946,3.1
Grayson County,2018-Jun,62763,60465,2298,3.7
Grayson County,2018-Jul,63342,61160,2182,3.4
Grayson County,2018-Aug,62868,60769,2099,3.3
Grayson County,2018-Sep,62561,60523,2038,3.3
Grayson County,2018-Oct,63020,61066,1954,3.1
Grayson County,2018-Nov,63258,61314,1944,3.1
Grayson County,2018-Dec,63016,61086,1930,3.1
Grayson County,2019-Jan,62638,60430,2208,3.5
Grayson County,2019-Feb,63325,61278,2047,3.2
Grayson County,2019-Mar,63212,61263,1949,3.1
Grayson County,2019-Apr,62916,61265,1651,2.6
Grayson County,2019-May,63088,61341,1747,2.8
Grayson County,2019-Jun,63525,61434,2091,3.3
Grayson County,2019-Jul,64141,62023,2118,3.3
Grayson County,2019-Aug,63770,61685,2085,3.3
Grayson County,2019-Sep,63643,61679,1964,3.1
Grayson County,2019-Oct,63914,62026,1888,3
Grayson County,2019-Nov,63990,62092,1898,3
Grayson County,2019-Dec,63984,62191,1793,2.8
Grayson County,2020-Jan,63677,61626,2051,3.2
Grayson County,2020-Feb,64173,62212,1961,3.1
Grayson County,2020-Mar,63014,59985,3029,4.8
Grayson County,2020-Apr,59432,53722,5710,9.6
Grayson County,2020-May,61740,56255,5485,8.9
Grayson County,2020-Jun,62822,57812,5010,8
Grayson County,2020-Jul,63728,59283,4445,7
Grayson County,2020-Aug,64367,60719,3648,5.7
Grayson County,2020-Sep,64331,60750,3581,5.6
Grayson County,2020-Oct,65068,61873,3195,4.9
Grayson County,2020-Nov,65266,61893,3373,5.2
Grayson County,2020-Dec,65205,61832,3373,5.2
Grayson County,2021-Jan,64812,61238,3574,5.5
Grayson County,2021-Feb,65258,61695,3563,5.5
Grayson County,2021-Mar,65396,62005,3391,5.2
Grayson County,2021-Apr,65688,62761,2927,4.5
Grayson County,2021-May,65654,62728,2926,4.5
Grayson County,2021-Jun,65895,62566,3329,5.1
Grayson County,2021-Jul,65766,62753,3013,4.6
Grayson County,2021-Aug,65847,62961,2886,4.4
Grayson County,2021-Sep,65847,63031,2816,4.3
Grayson County,2021-Oct,66014,63361,2653,4
Grayson County,2021-Nov,66202,63684,2518,3.8
Grayson County,2021-Dec,66158,63869,2289,3.5
Grayson County,2022-Jan,66122,63500,2622,4
Grayson County,2022-Feb,67159,64490,2669,4
Grayson County,2022-Mar,67173,64979,2194,3.3
Grayson County,2022-Apr,66759,64741,2018,3
Grayson County,2022-May,66843,64654,2189,3.3
Grayson County,2022-Jun,67007,64469,2538,3.8
Grayson County,2022-Jul,67176(P),64700(P),2476(P),3.7(P)
Gregg County,2012-Jan,61305,57286,4019,6.6
Gregg County,2012-Feb,61617,57714,3903,6.3
Gregg County,2012-Mar,61874,58253,3621,5.9
Gregg County,2012-Apr,62013,58588,3425,5.5
Gregg County,2012-May,61766,58075,3691,6
Gregg County,2012-Jun,61658,57522,4136,6.7
Gregg County,2012-Jul,61554,57405,4149,6.7
Gregg County,2012-Aug,61092,57164,3928,6.4
Gregg County,2012-Sep,61228,57497,3731,6.1
Gregg County,2012-Oct,61520,57852,3668,6
Gregg County,2012-Nov,61364,57831,3533,5.8
Gregg County,2012-Dec,60961,57311,3650,6
Gregg County,2013-Jan,61563,57507,4056,6.6
Gregg County,2013-Feb,61916,58101,3815,6.2
Gregg County,2013-Mar,61954,58314,3640,5.9
Gregg County,2013-Apr,61862,58357,3505,5.7
Gregg County,2013-May,61566,57862,3704,6
Gregg County,2013-Jun,61742,57703,4039,6.5
Gregg County,2013-Jul,61605,57661,3944,6.4
Gregg County,2013-Aug,61213,57483,3730,6.1
Gregg County,2013-Sep,61208,57526,3682,6
Gregg County,2013-Oct,60656,57153,3503,5.8
Gregg County,2013-Nov,61071,57677,3394,5.6
Gregg County,2013-Dec,60845,57638,3207,5.3
Gregg County,2014-Jan,60455,57022,3433,5.7
Gregg County,2014-Feb,60712,57299,3413,5.6
Gregg County,2014-Mar,60696,57465,3231,5.3
Gregg County,2014-Apr,60969,58100,2869,4.7
Gregg County,2014-May,61043,58021,3022,5
Gregg County,2014-Jun,61362,58181,3181,5.2
Gregg County,2014-Jul,61370,58129,3241,5.3
Gregg County,2014-Aug,61304,58194,3110,5.1
Gregg County,2014-Sep,61427,58552,2875,4.7
Gregg County,2014-Oct,61318,58625,2693,4.4
Gregg County,2014-Nov,61318,58670,2648,4.3
Gregg County,2014-Dec,60812,58405,2407,4
Gregg County,2015-Jan,60364,57641,2723,4.5
Gregg County,2015-Feb,60053,57421,2632,4.4
Gregg County,2015-Mar,59535,56868,2667,4.5
Gregg County,2015-Apr,59445,56747,2698,4.5
Gregg County,2015-May,59253,56330,2923,4.9
Gregg County,2015-Jun,59087,55850,3237,5.5
Gregg County,2015-Jul,59117,55798,3319,5.6
Gregg County,2015-Aug,59053,55897,3156,5.3
Gregg County,2015-Sep,58769,55635,3134,5.3
Gregg County,2015-Oct,58868,55830,3038,5.2
Gregg County,2015-Nov,59327,56268,3059,5.2
Gregg County,2015-Dec,58821,55876,2945,5
Gregg County,2016-Jan,58370,55204,3166,5.4
Gregg County,2016-Feb,58717,55529,3188,5.4
Gregg County,2016-Mar,58817,55578,3239,5.5
Gregg County,2016-Apr,58399,55157,3242,5.6
Gregg County,2016-May,58072,54823,3249,5.6
Gregg County,2016-Jun,58548,54514,4034,6.9
Gregg County,2016-Jul,58570,54441,4129,7
Gregg County,2016-Aug,58450,54414,4036,6.9
Gregg County,2016-Sep,58479,54529,3950,6.8
Gregg County,2016-Oct,58303,54747,3556,6.1
Gregg County,2016-Nov,58137,54665,3472,6
Gregg County,2016-Dec,57731,54311,3420,5.9
Gregg County,2017-Jan,57243,53435,3808,6.7
Gregg County,2017-Feb,57339,53723,3616,6.3
Gregg County,2017-Mar,57337,54023,3314,5.8
Gregg County,2017-Apr,57130,54122,3008,5.3
Gregg County,2017-May,56587,53724,2863,5.1
Gregg County,2017-Jun,57072,53969,3103,5.4
Gregg County,2017-Jul,57095,54115,2980,5.2
Gregg County,2017-Aug,56958,54014,2944,5.2
Gregg County,2017-Sep,57030,54410,2620,4.6
Gregg County,2017-Oct,56604,54161,2443,4.3
Gregg County,2017-Nov,56697,54198,2499,4.4
Gregg County,2017-Dec,56691,54294,2397,4.2
Gregg County,2018-Jan,56286,53645,2641,4.7
Gregg County,2018-Feb,56802,54217,2585,4.6
Gregg County,2018-Mar,57063,54604,2459,4.3
Gregg County,2018-Apr,57167,54898,2269,4
Gregg County,2018-May,56956,54754,2202,3.9
Gregg County,2018-Jun,57156,54619,2537,4.4
Gregg County,2018-Jul,57156,54693,2463,4.3
Gregg County,2018-Aug,56807,54430,2377,4.2
Gregg County,2018-Sep,56907,54625,2282,4
Gregg County,2018-Oct,57003,54782,2221,3.9
Gregg County,2018-Nov,56945,54769,2176,3.8
Gregg County,2018-Dec,56863,54659,2204,3.9
Gregg County,2019-Jan,57082,54633,2449,4.3
Gregg County,2019-Feb,57371,55105,2266,3.9
Gregg County,2019-Mar,57310,55143,2167,3.8
Gregg County,2019-Apr,57416,55504,1912,3.3
Gregg County,2019-May,57193,55295,1898,3.3
Gregg County,2019-Jun,57291,55032,2259,3.9
Gregg County,2019-Jul,57546,55187,2359,4.1
Gregg County,2019-Aug,57511,55255,2256,3.9
Gregg County,2019-Sep,57617,55455,2162,3.8
Gregg County,2019-Oct,57530,55449,2081,3.6
Gregg County,2019-Nov,57486,55439,2047,3.6
Gregg County,2019-Dec,57218,55229,1989,3.5
Gregg County,2020-Jan,57009,54681,2328,4.1
Gregg County,2020-Feb,57127,54926,2201,3.9
Gregg County,2020-Mar,56479,53136,3343,5.9
Gregg County,2020-Apr,53924,47383,6541,12.1
Gregg County,2020-May,55101,48541,6560,11.9
Gregg County,2020-Jun,55583,49288,6295,11.3
Gregg County,2020-Jul,55590,49713,5877,10.6
Gregg County,2020-Aug,55838,50962,4876,8.7
Gregg County,2020-Sep,55929,51141,4788,8.6
Gregg County,2020-Oct,56271,51975,4296,7.6
Gregg County,2020-Nov,56515,52135,4380,7.8
Gregg County,2020-Dec,56247,51943,4304,7.7
Gregg County,2021-Jan,55828,51385,4443,8
Gregg County,2021-Feb,56204,51870,4334,7.7
Gregg County,2021-Mar,56111,52017,4094,7.3
Gregg County,2021-Apr,55959,52236,3723,6.7
Gregg County,2021-May,55842,52246,3596,6.4
Gregg County,2021-Jun,56133,52066,4067,7.2
Gregg County,2021-Jul,56279,52519,3760,6.7
Gregg County,2021-Aug,56381,52846,3535,6.3
Gregg County,2021-Sep,56544,53315,3229,5.7
Gregg County,2021-Oct,56497,53348,3149,5.6
Gregg County,2021-Nov,56431,53508,2923,5.2
Gregg County,2021-Dec,56101,53400,2701,4.8
Gregg County,2022-Jan,56616,53527,3089,5.5
Gregg County,2022-Feb,56980,53914,3066,5.4
Gregg County,2022-Mar,56613,54098,2515,4.4
Gregg County,2022-Apr,56088,53727,2361,4.2
Gregg County,2022-May,56244,53800,2444,4.3
Gregg County,2022-Jun,56706,53943,2763,4.9
Gregg County,2022-Jul,56758(P),53978(P),2780(P),4.9(P)
Grimes County,2012-Jan,11462,10622,840,7.3
Grimes County,2012-Feb,11550,10750,800,6.9
Grimes County,2012-Mar,11604,10848,756,6.5
Grimes County,2012-Apr,11748,11048,700,6
Grimes County,2012-May,11847,11097,750,6.3
Grimes County,2012-Jun,11980,11143,837,7
Grimes County,2012-Jul,11933,11101,832,7
Grimes County,2012-Aug,11806,11029,777,6.6
Grimes County,2012-Sep,11861,11133,728,6.1
Grimes County,2012-Oct,11907,11220,687,5.8
Grimes County,2012-Nov,11919,11245,674,5.7
Grimes County,2012-Dec,11839,11144,695,5.9
Grimes County,2013-Jan,11656,10878,778,6.7
Grimes County,2013-Feb,11696,10983,713,6.1
Grimes County,2013-Mar,11716,11002,714,6.1
Grimes County,2013-Apr,11796,11121,675,5.7
Grimes County,2013-May,11905,11180,725,6.1
Grimes County,2013-Jun,11971,11153,818,6.8
Grimes County,2013-Jul,11865,11099,766,6.5
Grimes County,2013-Aug,11766,11021,745,6.3
Grimes County,2013-Sep,11912,11189,723,6.1
Grimes County,2013-Oct,11830,11163,667,5.6
Grimes County,2013-Nov,11714,11077,637,5.4
Grimes County,2013-Dec,11727,11122,605,5.2
Grimes County,2014-Jan,11634,10991,643,5.5
Grimes County,2014-Feb,11756,11130,626,5.3
Grimes County,2014-Mar,11790,11166,624,5.3
Grimes County,2014-Apr,11805,11284,521,4.4
Grimes County,2014-May,11927,11365,562,4.7
Grimes County,2014-Jun,11874,11246,628,5.3
Grimes County,2014-Jul,11881,11237,644,5.4
Grimes County,2014-Aug,11803,11205,598,5.1
Grimes County,2014-Sep,11831,11298,533,4.5
Grimes County,2014-Oct,11927,11411,516,4.3
Grimes County,2014-Nov,11813,11308,505,4.3
Grimes County,2014-Dec,11648,11193,455,3.9
Grimes County,2015-Jan,11650,11105,545,4.7
Grimes County,2015-Feb,11740,11219,521,4.4
Grimes County,2015-Mar,11735,11220,515,4.4
Grimes County,2015-Apr,11628,11038,590,5.1
Grimes County,2015-May,11638,10999,639,5.5
Grimes County,2015-Jun,11572,10871,701,6.1
Grimes County,2015-Jul,11451,10730,721,6.3
Grimes County,2015-Aug,11345,10679,666,5.9
Grimes County,2015-Sep,11370,10742,628,5.5
Grimes County,2015-Oct,11457,10841,616,5.4
Grimes County,2015-Nov,11427,10778,649,5.7
Grimes County,2015-Dec,11194,10578,616,5.5
Grimes County,2016-Jan,11010,10367,643,5.8
Grimes County,2016-Feb,11239,10601,638,5.7
Grimes County,2016-Mar,11253,10609,644,5.7
Grimes County,2016-Apr,11131,10443,688,6.2
Grimes County,2016-May,11186,10462,724,6.5
Grimes County,2016-Jun,11052,10216,836,7.6
Grimes County,2016-Jul,10949,10105,844,7.7
Grimes County,2016-Aug,10950,10122,828,7.6
Grimes County,2016-Sep,11032,10237,795,7.2
Grimes County,2016-Oct,11043,10317,726,6.6
Grimes County,2016-Nov,11017,10303,714,6.5
Grimes County,2016-Dec,10823,10125,698,6.4
Grimes County,2017-Jan,10618,9880,738,7
Grimes County,2017-Feb,10763,10066,697,6.5
Grimes County,2017-Mar,10935,10277,658,6
Grimes County,2017-Apr,10870,10291,579,5.3
Grimes County,2017-May,10851,10288,563,5.2
Grimes County,2017-Jun,10729,10113,616,5.7
Grimes County,2017-Jul,10686,10082,604,5.7
Grimes County,2017-Aug,10739,10137,602,5.6
Grimes County,2017-Sep,10796,10287,509,4.7
Grimes County,2017-Oct,11030,10559,471,4.3
Grimes County,2017-Nov,10901,10416,485,4.4
Grimes County,2017-Dec,10737,10265,472,4.4
Grimes County,2018-Jan,10752,10235,517,4.8
Grimes County,2018-Feb,10943,10449,494,4.5
Grimes County,2018-Mar,11076,10582,494,4.5
Grimes County,2018-Apr,10986,10557,429,3.9
Grimes County,2018-May,11038,10620,418,3.8
Grimes County,2018-Jun,10972,10451,521,4.7
Grimes County,2018-Jul,10912,10411,501,4.6
Grimes County,2018-Aug,10993,10506,487,4.4
Grimes County,2018-Sep,11032,10593,439,4
Grimes County,2018-Oct,11208,10809,399,3.6
Grimes County,2018-Nov,11195,10801,394,3.5
Grimes County,2018-Dec,10965,10575,390,3.6
Grimes County,2019-Jan,10961,10491,470,4.3
Grimes County,2019-Feb,11148,10727,421,3.8
Grimes County,2019-Mar,11224,10780,444,4
Grimes County,2019-Apr,11125,10747,378,3.4
Grimes County,2019-May,11159,10768,391,3.5
Grimes County,2019-Jun,11093,10594,499,4.5
Grimes County,2019-Jul,11009,10499,510,4.6
Grimes County,2019-Aug,11111,10628,483,4.3
Grimes County,2019-Sep,11104,10660,444,4
Grimes County,2019-Oct,11309,10865,444,3.9
Grimes County,2019-Nov,11242,10802,440,3.9
Grimes County,2019-Dec,10964,10558,406,3.7
Grimes County,2020-Jan,11008,10514,494,4.5
Grimes County,2020-Feb,11183,10733,450,4
Grimes County,2020-Mar,11124,10372,752,6.8
Grimes County,2020-Apr,10494,9454,1040,9.9
Grimes County,2020-May,10849,9669,1180,10.9
Grimes County,2020-Jun,10846,9683,1163,10.7
Grimes County,2020-Jul,10876,9772,1104,10.2
Grimes County,2020-Aug,10979,10049,930,8.5
Grimes County,2020-Sep,11054,10136,918,8.3
Grimes County,2020-Oct,11305,10458,847,7.5
Grimes County,2020-Nov,11257,10360,897,8
Grimes County,2020-Dec,11107,10210,897,8.1
Grimes County,2021-Jan,11134,10201,933,8.4
Grimes County,2021-Feb,11272,10385,887,7.9
Grimes County,2021-Mar,11323,10502,821,7.3
Grimes County,2021-Apr,11281,10547,734,6.5
Grimes County,2021-May,11062,10358,704,6.4
Grimes County,2021-Jun,11044,10207,837,7.6
Grimes County,2021-Jul,11036,10245,791,7.2
Grimes County,2021-Aug,11048,10317,731,6.6
Grimes County,2021-Sep,11084,10407,677,6.1
Grimes County,2021-Oct,11201,10549,652,5.8
Grimes County,2021-Nov,11151,10534,617,5.5
Grimes County,2021-Dec,10960,10379,581,5.3
Grimes County,2022-Jan,11049,10384,665,6
Grimes County,2022-Feb,11333,10680,653,5.8
Grimes County,2022-Mar,11387,10860,527,4.6
Grimes County,2022-Apr,11213,10725,488,4.4
Grimes County,2022-May,11100,10576,524,4.7
Grimes County,2022-Jun,11032,10414,618,5.6
Grimes County,2022-Jul,11118(P),10514(P),604(P),5.4(P)
Guadalupe County,2012-Jan,67144,63001,4143,6.2
Guadalupe County,2012-Feb,67583,63612,3971,5.9
Guadalupe County,2012-Mar,67601,63909,3692,5.5
Guadalupe County,2012-Apr,67735,64241,3494,5.2
Guadalupe County,2012-May,68118,64385,3733,5.5
Guadalupe County,2012-Jun,68561,64338,4223,6.2
Guadalupe County,2012-Jul,68697,64420,4277,6.2
Guadalupe County,2012-Aug,68292,64344,3948,5.8
Guadalupe County,2012-Sep,68375,64676,3699,5.4
Guadalupe County,2012-Oct,68607,64908,3699,5.4
Guadalupe County,2012-Nov,68510,64910,3600,5.3
Guadalupe County,2012-Dec,68566,64922,3644,5.3
Guadalupe County,2013-Jan,68983,64814,4169,6
Guadalupe County,2013-Feb,69291,65340,3951,5.7
Guadalupe County,2013-Mar,69549,65540,4009,5.8
Guadalupe County,2013-Apr,69814,66048,3766,5.4
Guadalupe County,2013-May,70086,66160,3926,5.6
Guadalupe County,2013-Jun,70573,66263,4310,6.1
Guadalupe County,2013-Jul,70703,66505,4198,5.9
Guadalupe County,2013-Aug,70225,66315,3910,5.6
Guadalupe County,2013-Sep,70285,66459,3826,5.4
Guadalupe County,2013-Oct,69743,66124,3619,5.2
Guadalupe County,2013-Nov,70173,66700,3473,4.9
Guadalupe County,2013-Dec,70022,66762,3260,4.7
Guadalupe County,2014-Jan,70404,66970,3434,4.9
Guadalupe County,2014-Feb,70891,67412,3479,4.9
Guadalupe County,2014-Mar,71215,67916,3299,4.6
Guadalupe County,2014-Apr,71200,68364,2836,4
Guadalupe County,2014-May,71464,68411,3053,4.3
Guadalupe County,2014-Jun,71880,68543,3337,4.6
Guadalupe County,2014-Jul,72162,68678,3484,4.8
Guadalupe County,2014-Aug,71765,68425,3340,4.7
Guadalupe County,2014-Sep,71577,68480,3097,4.3
Guadalupe County,2014-Oct,71792,68892,2900,4
Guadalupe County,2014-Nov,71867,69046,2821,3.9
Guadalupe County,2014-Dec,71422,68901,2521,3.5
Guadalupe County,2015-Jan,71988,69129,2859,4
Guadalupe County,2015-Feb,72327,69659,2668,3.7
Guadalupe County,2015-Mar,72219,69733,2486,3.4
Guadalupe County,2015-Apr,72634,70334,2300,3.2
Guadalupe County,2015-May,72991,70441,2550,3.5
Guadalupe County,2015-Jun,73089,70260,2829,3.9
Guadalupe County,2015-Jul,73202,70418,2784,3.8
Guadalupe County,2015-Aug,73003,70439,2564,3.5
Guadalupe County,2015-Sep,73118,70533,2585,3.5
Guadalupe County,2015-Oct,73341,70786,2555,3.5
Guadalupe County,2015-Nov,73886,71317,2569,3.5
Guadalupe County,2015-Dec,73799,71398,2401,3.3
Guadalupe County,2016-Jan,74514,71901,2613,3.5
Guadalupe County,2016-Feb,75317,72714,2603,3.5
Guadalupe County,2016-Mar,75503,72899,2604,3.4
Guadalupe County,2016-Apr,75501,73084,2417,3.2
Guadalupe County,2016-May,75535,73096,2439,3.2
Guadalupe County,2016-Jun,75929,72981,2948,3.9
Guadalupe County,2016-Jul,76498,73446,3052,4
Guadalupe County,2016-Aug,76410,73450,2960,3.9
Guadalupe County,2016-Sep,76655,73731,2924,3.8
Guadalupe County,2016-Oct,76502,73709,2793,3.7
Guadalupe County,2016-Nov,76872,74189,2683,3.5
Guadalupe County,2016-Dec,76665,73953,2712,3.5
Guadalupe County,2017-Jan,76986,74028,2958,3.8
Guadalupe County,2017-Feb,77471,74458,3013,3.9
Guadalupe County,2017-Mar,77638,74869,2769,3.6
Guadalupe County,2017-Apr,77701,75286,2415,3.1
Guadalupe County,2017-May,77430,74947,2483,3.2
Guadalupe County,2017-Jun,77892,75141,2751,3.5
Guadalupe County,2017-Jul,78367,75613,2754,3.5
Guadalupe County,2017-Aug,78143,75413,2730,3.5
Guadalupe County,2017-Sep,78640,76137,2503,3.2
Guadalupe County,2017-Oct,77847,75574,2273,2.9
Guadalupe County,2017-Nov,78173,75741,2432,3.1
Guadalupe County,2017-Dec,77960,75627,2333,3
Guadalupe County,2018-Jan,78326,75697,2629,3.4
Guadalupe County,2018-Feb,79216,76561,2655,3.4
Guadalupe County,2018-Mar,79133,76597,2536,3.2
Guadalupe County,2018-Apr,79514,77207,2307,2.9
Guadalupe County,2018-May,79290,77003,2287,2.9
Guadalupe County,2018-Jun,79916,77158,2758,3.5
Guadalupe County,2018-Jul,80039,77366,2673,3.3
Guadalupe County,2018-Aug,79583,76966,2617,3.3
Guadalupe County,2018-Sep,79672,77168,2504,3.1
Guadalupe County,2018-Oct,79765,77375,2390,3
Guadalupe County,2018-Nov,79951,77559,2392,3
Guadalupe County,2018-Dec,79883,77446,2437,3.1
Guadalupe County,2019-Jan,80000,77181,2819,3.5
Guadalupe County,2019-Feb,80393,77816,2577,3.2
Guadalupe County,2019-Mar,80317,77886,2431,3
Guadalupe County,2019-Apr,80221,78180,2041,2.5
Guadalupe County,2019-May,80156,78044,2112,2.6
Guadalupe County,2019-Jun,80959,78372,2587,3.2
Guadalupe County,2019-Jul,81230,78561,2669,3.3
Guadalupe County,2019-Aug,81073,78512,2561,3.2
Guadalupe County,2019-Sep,81238,78888,2350,2.9
Guadalupe County,2019-Oct,81386,79125,2261,2.8
Guadalupe County,2019-Nov,81507,79260,2247,2.8
Guadalupe County,2019-Dec,81427,79345,2082,2.6
Guadalupe County,2020-Jan,81665,79272,2393,2.9
Guadalupe County,2020-Feb,82137,79883,2254,2.7
Guadalupe County,2020-Mar,80508,76990,3518,4.4
Guadalupe County,2020-Apr,74722,67217,7505,10
Guadalupe County,2020-May,78630,70042,8588,10.9
Guadalupe County,2020-Jun,79549,72882,6667,8.4
Guadalupe County,2020-Jul,79518,73390,6128,7.7
Guadalupe County,2020-Aug,80121,75324,4797,6
Guadalupe County,2020-Sep,80567,75923,4644,5.8
Guadalupe County,2020-Oct,81230,77165,4065,5
Guadalupe County,2020-Nov,81680,77406,4274,5.2
Guadalupe County,2020-Dec,81640,77487,4153,5.1
Guadalupe County,2021-Jan,81039,76627,4412,5.4
Guadalupe County,2021-Feb,81537,77184,4353,5.3
Guadalupe County,2021-Mar,81535,77390,4145,5.1
Guadalupe County,2021-Apr,81725,78064,3661,4.5
Guadalupe County,2021-May,81800,78232,3568,4.4
Guadalupe County,2021-Jun,82624,78464,4160,5
Guadalupe County,2021-Jul,82493,78746,3747,4.5
Guadalupe County,2021-Aug,82165,78650,3515,4.3
Guadalupe County,2021-Sep,82532,79213,3319,4
Guadalupe County,2021-Oct,82877,79676,3201,3.9
Guadalupe County,2021-Nov,83197,80198,2999,3.6
Guadalupe County,2021-Dec,82983,80241,2742,3.3
Guadalupe County,2022-Jan,83486,80326,3160,3.8
Guadalupe County,2022-Feb,84524,81332,3192,3.8
Guadalupe County,2022-Mar,83996,81389,2607,3.1
Guadalupe County,2022-Apr,83616,81196,2420,2.9
Guadalupe County,2022-May,83821,81237,2584,3.1
Guadalupe County,2022-Jun,84388,81325,3063,3.6
Guadalupe County,2022-Jul,84308(P),81295(P),3013(P),3.6(P)
Hale County,2012-Jan,15878,14712,1166,7.3
Hale County,2012-Feb,15832,14688,1144,7.2
Hale County,2012-Mar,15762,14627,1135,7.2
Hale County,2012-Apr,16063,15047,1016,6.3
Hale County,2012-May,16027,14951,1076,6.7
Hale County,2012-Jun,16140,14848,1292,8
Hale County,2012-Jul,16049,14785,1264,7.9
Hale County,2012-Aug,15797,14677,1120,7.1
Hale County,2012-Sep,15861,14891,970,6.1
Hale County,2012-Oct,15650,14718,932,6
Hale County,2012-Nov,15504,14576,928,6
Hale County,2012-Dec,15300,14301,999,6.5
Hale County,2013-Jan,15152,14016,1136,7.5
Hale County,2013-Feb,16051,13995,2056,12.8
Hale County,2013-Mar,15896,13772,2124,13.4
Hale County,2013-Apr,14729,12494,2235,15.2
Hale County,2013-May,14747,12510,2237,15.2
Hale County,2013-Jun,14874,12455,2419,16.3
Hale County,2013-Jul,14777,12507,2270,15.4
Hale County,2013-Aug,14444,12330,2114,14.6
Hale County,2013-Sep,14534,12544,1990,13.7
Hale County,2013-Oct,14381,12523,1858,12.9
Hale County,2013-Nov,13968,12252,1716,12.3
Hale County,2013-Dec,13936,12328,1608,11.5
Hale County,2014-Jan,13664,12062,1602,11.7
Hale County,2014-Feb,13857,12224,1633,11.8
Hale County,2014-Mar,13830,12230,1600,11.6
Hale County,2014-Apr,13749,12435,1314,9.6
Hale County,2014-May,13735,12440,1295,9.4
Hale County,2014-Jun,13729,12325,1404,10.2
Hale County,2014-Jul,13543,12164,1379,10.2
Hale County,2014-Aug,13307,12041,1266,9.5
Hale County,2014-Sep,13429,12338,1091,8.1
Hale County,2014-Oct,13282,12295,987,7.4
Hale County,2014-Nov,13157,12178,979,7.4
Hale County,2014-Dec,12884,12010,874,6.8
Hale County,2015-Jan,12842,11867,975,7.6
Hale County,2015-Feb,12993,12041,952,7.3
Hale County,2015-Mar,13056,12167,889,6.8
Hale County,2015-Apr,13012,12224,788,6.1
Hale County,2015-May,13094,12266,828,6.3
Hale County,2015-Jun,13101,12145,956,7.3
Hale County,2015-Jul,12932,12013,919,7.1
Hale County,2015-Aug,12793,11990,803,6.3
Hale County,2015-Sep,12895,12150,745,5.8
Hale County,2015-Oct,12795,12092,703,5.5
Hale County,2015-Nov,12617,11924,693,5.5
Hale County,2015-Dec,12600,11949,651,5.2
Hale County,2016-Jan,12251,11554,697,5.7
Hale County,2016-Feb,12664,11969,695,5.5
Hale County,2016-Mar,12792,12095,697,5.4
Hale County,2016-Apr,12808,12149,659,5.1
Hale County,2016-May,12912,12258,654,5.1
Hale County,2016-Jun,12768,11928,840,6.6
Hale County,2016-Jul,12518,11676,842,6.7
Hale County,2016-Aug,12640,11868,772,6.1
Hale County,2016-Sep,12603,11887,716,5.7
Hale County,2016-Oct,12446,11783,663,5.3
Hale County,2016-Nov,12427,11792,635,5.1
Hale County,2016-Dec,12313,11681,632,5.1
Hale County,2017-Jan,12265,11563,702,5.7
Hale County,2017-Feb,12422,11707,715,5.8
Hale County,2017-Mar,12728,11993,735,5.8
Hale County,2017-Apr,12607,12000,607,4.8
Hale County,2017-May,12539,11926,613,4.9
Hale County,2017-Jun,12391,11622,769,6.2
Hale County,2017-Jul,12217,11466,751,6.1
Hale County,2017-Aug,12342,11670,672,5.4
Hale County,2017-Sep,12265,11693,572,4.7
Hale County,2017-Oct,12426,11901,525,4.2
Hale County,2017-Nov,12468,11945,523,4.2
Hale County,2017-Dec,12393,11885,508,4.1
Hale County,2018-Jan,12237,11679,558,4.6
Hale County,2018-Feb,12393,11813,580,4.7
Hale County,2018-Mar,12698,12038,660,5.2
Hale County,2018-Apr,12438,11902,536,4.3
Hale County,2018-May,12641,12085,556,4.4
Hale County,2018-Jun,12498,11749,749,6
Hale County,2018-Jul,12354,11639,715,5.8
Hale County,2018-Aug,12301,11691,610,5
Hale County,2018-Sep,12325,11743,582,4.7
Hale County,2018-Oct,12309,11766,543,4.4
Hale County,2018-Nov,12253,11728,525,4.3
Hale County,2018-Dec,12021,11482,539,4.5
Hale County,2019-Jan,12045,11457,588,4.9
Hale County,2019-Feb,12209,11648,561,4.6
Hale County,2019-Mar,12197,11609,588,4.8
Hale County,2019-Apr,12144,11684,460,3.8
Hale County,2019-May,12176,11677,499,4.1
Hale County,2019-Jun,12063,11413,650,5.4
Hale County,2019-Jul,12013,11363,650,5.4
Hale County,2019-Aug,12098,11562,536,4.4
Hale County,2019-Sep,11936,11436,500,4.2
Hale County,2019-Oct,12029,11547,482,4
Hale County,2019-Nov,11796,11315,481,4.1
Hale County,2019-Dec,11783,11335,448,3.8
Hale County,2020-Jan,11665,11141,524,4.5
Hale County,2020-Feb,11764,11275,489,4.2
Hale County,2020-Mar,11711,10974,737,6.3
Hale County,2020-Apr,11106,10187,919,8.3
Hale County,2020-May,11475,10450,1025,8.9
Hale County,2020-Jun,11521,10438,1083,9.4
Hale County,2020-Jul,11648,10635,1013,8.7
Hale County,2020-Aug,11739,10981,758,6.5
Hale County,2020-Sep,11654,10947,707,6.1
Hale County,2020-Oct,11879,11208,671,5.6
Hale County,2020-Nov,11770,11055,715,6.1
Hale County,2020-Dec,11702,10913,789,6.7
Hale County,2021-Jan,11954,11097,857,7.2
Hale County,2021-Feb,12174,11331,843,6.9
Hale County,2021-Mar,12277,11481,796,6.5
Hale County,2021-Apr,12129,11426,703,5.8
Hale County,2021-May,11914,11204,710,6
Hale County,2021-Jun,11897,11004,893,7.5
Hale County,2021-Jul,11795,10993,802,6.8
Hale County,2021-Aug,11801,11103,698,5.9
Hale County,2021-Sep,11924,11261,663,5.6
Hale County,2021-Oct,11838,11232,606,5.1
Hale County,2021-Nov,11706,11134,572,4.9
Hale County,2021-Dec,11564,11025,539,4.7
Hale County,2022-Jan,11716,11080,636,5.4
Hale County,2022-Feb,12101,11467,634,5.2
Hale County,2022-Mar,12256,11726,530,4.3
Hale County,2022-Apr,12153,11657,496,4.1
Hale County,2022-May,11995,11477,518,4.3
Hale County,2022-Jun,11970,11278,692,5.8
Hale County,2022-Jul,12162(P),11487(P),675(P),5.6(P)
Hall County,2012-Jan,1329,1214,115,8.7
Hall County,2012-Feb,1324,1211,113,8.5
Hall County,2012-Mar,1337,1231,106,7.9
Hall County,2012-Apr,1339,1237,102,7.6
Hall County,2012-May,1343,1240,103,7.7
Hall County,2012-Jun,1379,1264,115,8.3
Hall County,2012-Jul,1375,1262,113,8.2
Hall County,2012-Aug,1352,1247,105,7.8
Hall County,2012-Sep,1345,1249,96,7.1
Hall County,2012-Oct,1327,1233,94,7.1
Hall County,2012-Nov,1314,1222,92,7
Hall County,2012-Dec,1319,1225,94,7.1
Hall County,2013-Jan,1283,1181,102,8
Hall County,2013-Feb,1276,1179,97,7.6
Hall County,2013-Mar,1277,1184,93,7.3
Hall County,2013-Apr,1293,1201,92,7.1
Hall County,2013-May,1317,1224,93,7.1
Hall County,2013-Jun,1349,1249,100,7.4
Hall County,2013-Jul,1326,1231,95,7.2
Hall County,2013-Aug,1285,1196,89,6.9
Hall County,2013-Sep,1297,1208,89,6.9
Hall County,2013-Oct,1272,1185,87,6.8
Hall County,2013-Nov,1235,1150,85,6.9
Hall County,2013-Dec,1243,1161,82,6.6
Hall County,2014-Jan,1234,1145,89,7.2
Hall County,2014-Feb,1267,1171,96,7.6
Hall County,2014-Mar,1268,1178,90,7.1
Hall County,2014-Apr,1293,1214,79,6.1
Hall County,2014-May,1292,1210,82,6.3
Hall County,2014-Jun,1310,1222,88,6.7
Hall County,2014-Jul,1280,1192,88,6.9
Hall County,2014-Aug,1258,1175,83,6.6
Hall County,2014-Sep,1269,1192,77,6.1
Hall County,2014-Oct,1240,1173,67,5.4
Hall County,2014-Nov,1220,1156,64,5.2
Hall County,2014-Dec,1210,1156,54,4.5
Hall County,2015-Jan,1208,1146,62,5.1
Hall County,2015-Feb,1241,1178,63,5.1
Hall County,2015-Mar,1252,1189,63,5
Hall County,2015-Apr,1235,1175,60,4.9
Hall County,2015-May,1238,1173,65,5.3
Hall County,2015-Jun,1234,1164,70,5.7
Hall County,2015-Jul,1219,1148,71,5.8
Hall County,2015-Aug,1182,1109,73,6.2
Hall County,2015-Sep,1187,1117,70,5.9
Hall County,2015-Oct,1167,1103,64,5.5
Hall County,2015-Nov,1146,1088,58,5.1
Hall County,2015-Dec,1137,1082,55,4.8
Hall County,2016-Jan,1124,1063,61,5.4
Hall County,2016-Feb,1170,1110,60,5.1
Hall County,2016-Mar,1208,1133,75,6.2
Hall County,2016-Apr,1209,1131,78,6.5
Hall County,2016-May,1223,1142,81,6.6
Hall County,2016-Jun,1206,1120,86,7.1
Hall County,2016-Jul,1157,1071,86,7.4
Hall County,2016-Aug,1164,1076,88,7.6
Hall County,2016-Sep,1162,1078,84,7.2
Hall County,2016-Oct,1148,1070,78,6.8
Hall County,2016-Nov,1122,1044,78,7
Hall County,2016-Dec,1096,1019,77,7
Hall County,2017-Jan,1089,1003,86,7.9
Hall County,2017-Feb,1117,1031,86,7.7
Hall County,2017-Mar,1155,1075,80,6.9
Hall County,2017-Apr,1162,1083,79,6.8
Hall County,2017-May,1161,1092,69,5.9
Hall County,2017-Jun,1147,1078,69,6
Hall County,2017-Jul,1098,1032,66,6
Hall County,2017-Aug,1115,1046,69,6.2
Hall County,2017-Sep,1097,1035,62,5.7
Hall County,2017-Oct,1119,1064,55,4.9
Hall County,2017-Nov,1095,1041,54,4.9
Hall County,2017-Dec,1097,1044,53,4.8
Hall County,2018-Jan,1075,1022,53,4.9
Hall County,2018-Feb,1083,1029,54,5
Hall County,2018-Mar,1129,1070,59,5.2
Hall County,2018-Apr,1124,1069,55,4.9
Hall County,2018-May,1141,1092,49,4.3
Hall County,2018-Jun,1125,1072,53,4.7
Hall County,2018-Jul,1097,1048,49,4.5
Hall County,2018-Aug,1107,1059,48,4.3
Hall County,2018-Sep,1104,1060,44,4
Hall County,2018-Oct,1089,1046,43,3.9
Hall County,2018-Nov,1077,1034,43,4
Hall County,2018-Dec,1043,1002,41,3.9
Hall County,2019-Jan,1019,973,46,4.5
Hall County,2019-Feb,1056,1006,50,4.7
Hall County,2019-Mar,1077,1031,46,4.3
Hall County,2019-Apr,1061,1023,38,3.6
Hall County,2019-May,1068,1031,37,3.5
Hall County,2019-Jun,1067,1022,45,4.2
Hall County,2019-Jul,1045,1002,43,4.1
Hall County,2019-Aug,1072,1029,43,4
Hall County,2019-Sep,1044,1002,42,4
Hall County,2019-Oct,1068,1026,42,3.9
Hall County,2019-Nov,1045,997,48,4.6
Hall County,2019-Dec,1046,1004,42,4
Hall County,2020-Jan,1030,988,42,4.1
Hall County,2020-Feb,1055,1011,44,4.2
Hall County,2020-Mar,1064,997,67,6.3
Hall County,2020-Apr,1042,975,67,6.4
Hall County,2020-May,1042,968,74,7.1
Hall County,2020-Jun,1042,965,77,7.4
Hall County,2020-Jul,1060,991,69,6.5
Hall County,2020-Aug,1093,1031,62,5.7
Hall County,2020-Sep,1078,1015,63,5.8
Hall County,2020-Oct,1087,1029,58,5.3
Hall County,2020-Nov,1054,996,58,5.5
Hall County,2020-Dec,1043,987,56,5.4
Hall County,2021-Jan,1077,1009,68,6.3
Hall County,2021-Feb,1100,1031,69,6.3
Hall County,2021-Mar,1129,1060,69,6.1
Hall County,2021-Apr,1106,1046,60,5.4
Hall County,2021-May,1090,1031,59,5.4
Hall County,2021-Jun,1079,1016,63,5.8
Hall County,2021-Jul,1081,1019,62,5.7
Hall County,2021-Aug,1102,1040,62,5.6
Hall County,2021-Sep,1099,1044,55,5
Hall County,2021-Oct,1080,1031,49,4.5
Hall County,2021-Nov,1054,1008,46,4.4
Hall County,2021-Dec,1041,999,42,4
Hall County,2022-Jan,1052,1003,49,4.7
Hall County,2022-Feb,1104,1053,51,4.6
Hall County,2022-Mar,1139,1100,39,3.4
Hall County,2022-Apr,1128,1090,38,3.4
Hall County,2022-May,1104,1062,42,3.8
Hall County,2022-Jun,1085,1040,45,4.1
Hall County,2022-Jul,1127(P),1081(P),46(P),4.1(P)
Hamilton County,2012-Jan,3768,3538,230,6.1
Hamilton County,2012-Feb,3854,3627,227,5.9
Hamilton County,2012-Mar,3795,3588,207,5.5
Hamilton County,2012-Apr,3759,3560,199,5.3
Hamilton County,2012-May,3824,3609,215,5.6
Hamilton County,2012-Jun,3809,3571,238,6.2
Hamilton County,2012-Jul,3767,3528,239,6.3
Hamilton County,2012-Aug,3680,3467,213,5.8
Hamilton County,2012-Sep,3691,3491,200,5.4
Hamilton County,2012-Oct,3683,3469,214,5.8
Hamilton County,2012-Nov,3641,3436,205,5.6
Hamilton County,2012-Dec,3627,3413,214,5.9
Hamilton County,2013-Jan,3606,3369,237,6.6
Hamilton County,2013-Feb,3579,3363,216,6
Hamilton County,2013-Mar,3578,3369,209,5.8
Hamilton County,2013-Apr,3637,3429,208,5.7
Hamilton County,2013-May,3672,3453,219,6
Hamilton County,2013-Jun,3715,3465,250,6.7
Hamilton County,2013-Jul,3700,3459,241,6.5
Hamilton County,2013-Aug,3660,3438,222,6.1
Hamilton County,2013-Sep,3641,3418,223,6.1
Hamilton County,2013-Oct,3533,3325,208,5.9
Hamilton County,2013-Nov,3539,3340,199,5.6
Hamilton County,2013-Dec,3518,3334,184,5.2
Hamilton County,2014-Jan,3533,3354,179,5.1
Hamilton County,2014-Feb,3544,3357,187,5.3
Hamilton County,2014-Mar,3570,3396,174,4.9
Hamilton County,2014-Apr,3554,3403,151,4.2
Hamilton County,2014-May,3601,3434,167,4.6
Hamilton County,2014-Jun,3631,3446,185,5.1
Hamilton County,2014-Jul,3613,3431,182,5
Hamilton County,2014-Aug,3604,3428,176,4.9
Hamilton County,2014-Sep,3565,3401,164,4.6
Hamilton County,2014-Oct,3527,3374,153,4.3
Hamilton County,2014-Nov,3522,3373,149,4.2
Hamilton County,2014-Dec,3477,3344,133,3.8
Hamilton County,2015-Jan,3451,3308,143,4.1
Hamilton County,2015-Feb,3472,3329,143,4.1
Hamilton County,2015-Mar,3473,3323,150,4.3
Hamilton County,2015-Apr,3469,3312,157,4.5
Hamilton County,2015-May,3499,3336,163,4.7
Hamilton County,2015-Jun,3530,3355,175,5
Hamilton County,2015-Jul,3516,3331,185,5.3
Hamilton County,2015-Aug,3501,3325,176,5
Hamilton County,2015-Sep,3492,3320,172,4.9
Hamilton County,2015-Oct,3466,3297,169,4.9
Hamilton County,2015-Nov,3456,3288,168,4.9
Hamilton County,2015-Dec,3490,3328,162,4.6
Hamilton County,2016-Jan,3560,3371,189,5.3
Hamilton County,2016-Feb,3598,3421,177,4.9
Hamilton County,2016-Mar,3649,3473,176,4.8
Hamilton County,2016-Apr,3607,3453,154,4.3
Hamilton County,2016-May,3641,3484,157,4.3
Hamilton County,2016-Jun,3674,3486,188,5.1
Hamilton County,2016-Jul,3645,3448,197,5.4
Hamilton County,2016-Aug,3647,3458,189,5.2
Hamilton County,2016-Sep,3602,3416,186,5.2
Hamilton County,2016-Oct,3548,3375,173,4.9
Hamilton County,2016-Nov,3535,3368,167,4.7
Hamilton County,2016-Dec,3510,3343,167,4.8
Hamilton County,2017-Jan,3610,3434,176,4.9
Hamilton County,2017-Feb,3642,3471,171,4.7
Hamilton County,2017-Mar,3656,3502,154,4.2
Hamilton County,2017-Apr,3632,3503,129,3.6
Hamilton County,2017-May,3646,3509,137,3.8
Hamilton County,2017-Jun,3640,3486,154,4.2
Hamilton County,2017-Jul,3613,3464,149,4.1
Hamilton County,2017-Aug,3559,3414,145,4.1
Hamilton County,2017-Sep,3537,3408,129,3.6
Hamilton County,2017-Oct,3539,3422,117,3.3
Hamilton County,2017-Nov,3509,3383,126,3.6
Hamilton County,2017-Dec,3548,3422,126,3.6
Hamilton County,2018-Jan,3522,3386,136,3.9
Hamilton County,2018-Feb,3549,3415,134,3.8
Hamilton County,2018-Mar,3579,3454,125,3.5
Hamilton County,2018-Apr,3553,3443,110,3.1
Hamilton County,2018-May,3589,3475,114,3.2
Hamilton County,2018-Jun,3621,3483,138,3.8
Hamilton County,2018-Jul,3648,3523,125,3.4
Hamilton County,2018-Aug,3675,3558,117,3.2
Hamilton County,2018-Sep,3630,3522,108,3
Hamilton County,2018-Oct,3623,3515,108,3
Hamilton County,2018-Nov,3602,3492,110,3.1
Hamilton County,2018-Dec,3604,3498,106,2.9
Hamilton County,2019-Jan,3598,3474,124,3.4
Hamilton County,2019-Feb,3659,3540,119,3.3
Hamilton County,2019-Mar,3631,3518,113,3.1
Hamilton County,2019-Apr,3577,3488,89,2.5
Hamilton County,2019-May,3568,3478,90,2.5
Hamilton County,2019-Jun,3653,3540,113,3.1
Hamilton County,2019-Jul,3656,3535,121,3.3
Hamilton County,2019-Aug,3677,3556,121,3.3
Hamilton County,2019-Sep,3622,3510,112,3.1
Hamilton County,2019-Oct,3671,3563,108,2.9
Hamilton County,2019-Nov,3641,3546,95,2.6
Hamilton County,2019-Dec,3668,3572,96,2.6
Hamilton County,2020-Jan,3721,3612,109,2.9
Hamilton County,2020-Feb,3725,3611,114,3.1
Hamilton County,2020-Mar,3705,3539,166,4.5
Hamilton County,2020-Apr,3478,3285,193,5.5
Hamilton County,2020-May,3600,3391,209,5.8
Hamilton County,2020-Jun,3681,3469,212,5.8
Hamilton County,2020-Jul,3732,3534,198,5.3
Hamilton County,2020-Aug,3799,3636,163,4.3
Hamilton County,2020-Sep,3773,3604,169,4.5
Hamilton County,2020-Oct,3763,3608,155,4.1
Hamilton County,2020-Nov,3754,3583,171,4.6
Hamilton County,2020-Dec,3784,3612,172,4.5
Hamilton County,2021-Jan,3808,3620,188,4.9
Hamilton County,2021-Feb,3862,3673,189,4.9
Hamilton County,2021-Mar,3855,3683,172,4.5
Hamilton County,2021-Apr,3853,3703,150,3.9
Hamilton County,2021-May,3826,3671,155,4.1
Hamilton County,2021-Jun,3844,3658,186,4.8
Hamilton County,2021-Jul,3787,3632,155,4.1
Hamilton County,2021-Aug,3776,3628,148,3.9
Hamilton County,2021-Sep,3746,3608,138,3.7
Hamilton County,2021-Oct,3721,3592,129,3.5
Hamilton County,2021-Nov,3710,3582,128,3.5
Hamilton County,2021-Dec,3720,3607,113,3
Hamilton County,2022-Jan,3749,3614,135,3.6
Hamilton County,2022-Feb,3812,3675,137,3.6
Hamilton County,2022-Mar,3849,3736,113,2.9
Hamilton County,2022-Apr,3774,3670,104,2.8
Hamilton County,2022-May,3760,3649,111,3
Hamilton County,2022-Jun,3775,3640,135,3.6
Hamilton County,2022-Jul,3795(P),3659(P),136(P),3.6(P)
Hansford County,2012-Jan,2958,2852,106,3.6
Hansford County,2012-Feb,2937,2836,101,3.4
Hansford County,2012-Mar,2999,2903,96,3.2
Hansford County,2012-Apr,3052,2961,91,3
Hansford County,2012-May,3080,2979,101,3.3
Hansford County,2012-Jun,3148,3028,120,3.8
Hansford County,2012-Jul,3153,3029,124,3.9
Hansford County,2012-Aug,3082,2971,111,3.6
Hansford County,2012-Sep,3062,2966,96,3.1
Hansford County,2012-Oct,3060,2963,97,3.2
Hansford County,2012-Nov,3036,2940,96,3.2
Hansford County,2012-Dec,3009,2909,100,3.3
Hansford County,2013-Jan,2995,2880,115,3.8
Hansford County,2013-Feb,3030,2920,110,3.6
Hansford County,2013-Mar,3032,2930,102,3.4
Hansford County,2013-Apr,3083,2986,97,3.1
Hansford County,2013-May,3152,3049,103,3.3
Hansford County,2013-Jun,3250,3133,117,3.6
Hansford County,2013-Jul,3241,3123,118,3.6
Hansford County,2013-Aug,3174,3071,103,3.2
Hansford County,2013-Sep,3131,3028,103,3.3
Hansford County,2013-Oct,3150,3056,94,3
Hansford County,2013-Nov,3080,2991,89,2.9
Hansford County,2013-Dec,3147,3063,84,2.7
Hansford County,2014-Jan,3105,3019,86,2.8
Hansford County,2014-Feb,3169,3081,88,2.8
Hansford County,2014-Mar,3175,3090,85,2.7
Hansford County,2014-Apr,3239,3167,72,2.2
Hansford County,2014-May,3323,3239,84,2.5
Hansford County,2014-Jun,3367,3275,92,2.7
Hansford County,2014-Jul,3336,3238,98,2.9
Hansford County,2014-Aug,3257,3168,89,2.7
Hansford County,2014-Sep,3239,3153,86,2.7
Hansford County,2014-Oct,3265,3184,81,2.5
Hansford County,2014-Nov,3188,3115,73,2.3
Hansford County,2014-Dec,3175,3110,65,2
Hansford County,2015-Jan,3141,3052,89,2.8
Hansford County,2015-Feb,3192,3099,93,2.9
Hansford County,2015-Mar,3202,3104,98,3.1
Hansford County,2015-Apr,3108,3018,90,2.9
Hansford County,2015-May,3156,3058,98,3.1
Hansford County,2015-Jun,3181,3081,100,3.1
Hansford County,2015-Jul,3131,3034,97,3.1
Hansford County,2015-Aug,3043,2957,86,2.8
Hansford County,2015-Sep,3072,2983,89,2.9
Hansford County,2015-Oct,3084,2994,90,2.9
Hansford County,2015-Nov,3016,2922,94,3.1
Hansford County,2015-Dec,3028,2933,95,3.1
Hansford County,2016-Jan,2895,2800,95,3.3
Hansford County,2016-Feb,3030,2934,96,3.2
Hansford County,2016-Mar,3050,2961,89,2.9
Hansford County,2016-Apr,3010,2926,84,2.8
Hansford County,2016-May,3083,2995,88,2.9
Hansford County,2016-Jun,3034,2937,97,3.2
Hansford County,2016-Jul,2940,2844,96,3.3
Hansford County,2016-Aug,2940,2844,96,3.3
Hansford County,2016-Sep,2914,2820,94,3.2
Hansford County,2016-Oct,2860,2767,93,3.3
Hansford County,2016-Nov,2799,2713,86,3.1
Hansford County,2016-Dec,2799,2708,91,3.3
Hansford County,2017-Jan,2746,2654,92,3.4
Hansford County,2017-Feb,2809,2714,95,3.4
Hansford County,2017-Mar,2876,2796,80,2.8
Hansford County,2017-Apr,2871,2802,69,2.4
Hansford County,2017-May,2893,2822,71,2.5
Hansford County,2017-Jun,2883,2810,73,2.5
Hansford County,2017-Jul,2837,2763,74,2.6
Hansford County,2017-Aug,2857,2786,71,2.5
Hansford County,2017-Sep,2798,2736,62,2.2
Hansford County,2017-Oct,2864,2807,57,2
Hansford County,2017-Nov,2815,2750,65,2.3
Hansford County,2017-Dec,2830,2765,65,2.3
Hansford County,2018-Jan,2788,2711,77,2.8
Hansford County,2018-Feb,2818,2746,72,2.6
Hansford County,2018-Mar,2898,2831,67,2.3
Hansford County,2018-Apr,2827,2765,62,2.2
Hansford County,2018-May,2899,2841,58,2
Hansford County,2018-Jun,2883,2810,73,2.5
Hansford County,2018-Jul,2834,2768,66,2.3
Hansford County,2018-Aug,2874,2809,65,2.3
Hansford County,2018-Sep,2842,2780,62,2.2
Hansford County,2018-Oct,2780,2719,61,2.2
Hansford County,2018-Nov,2738,2677,61,2.2
Hansford County,2018-Dec,2726,2659,67,2.5
Hansford County,2019-Jan,2694,2617,77,2.9
Hansford County,2019-Feb,2745,2675,70,2.6
Hansford County,2019-Mar,2796,2726,70,2.5
Hansford County,2019-Apr,2713,2656,57,2.1
Hansford County,2019-May,2735,2678,57,2.1
Hansford County,2019-Jun,2776,2701,75,2.7
Hansford County,2019-Jul,2738,2669,69,2.5
Hansford County,2019-Aug,2762,2697,65,2.4
Hansford County,2019-Sep,2718,2657,61,2.2
Hansford County,2019-Oct,2782,2722,60,2.2
Hansford County,2019-Nov,2671,2613,58,2.2
Hansford County,2019-Dec,2686,2629,57,2.1
Hansford County,2020-Jan,2484,2422,62,2.5
Hansford County,2020-Feb,2499,2444,55,2.2
Hansford County,2020-Mar,2478,2392,86,3.5
Hansford County,2020-Apr,2263,2198,65,2.9
Hansford County,2020-May,2320,2238,82,3.5
Hansford County,2020-Jun,2423,2308,115,4.7
Hansford County,2020-Jul,2477,2373,104,4.2
Hansford County,2020-Aug,2524,2434,90,3.6
Hansford County,2020-Sep,2506,2415,91,3.6
Hansford County,2020-Oct,2552,2461,91,3.6
Hansford County,2020-Nov,2478,2383,95,3.8
Hansford County,2020-Dec,2498,2408,90,3.6
Hansford County,2021-Jan,2540,2442,98,3.9
Hansford County,2021-Feb,2584,2493,91,3.5
Hansford County,2021-Mar,2651,2573,78,2.9
Hansford County,2021-Apr,2600,2529,71,2.7
Hansford County,2021-May,2534,2462,72,2.8
Hansford County,2021-Jun,2570,2480,90,3.5
Hansford County,2021-Jul,2564,2483,81,3.2
Hansford County,2021-Aug,2566,2492,74,2.9
Hansford County,2021-Sep,2557,2484,73,2.9
Hansford County,2021-Oct,2517,2446,71,2.8
Hansford County,2021-Nov,2454,2388,66,2.7
Hansford County,2021-Dec,2471,2411,60,2.4
Hansford County,2022-Jan,2497,2426,71,2.8
Hansford County,2022-Feb,2615,2542,73,2.8
Hansford County,2022-Mar,2714,2655,59,2.2
Hansford County,2022-Apr,2679,2627,52,1.9
Hansford County,2022-May,2605,2548,57,2.2
Hansford County,2022-Jun,2633,2562,71,2.7
Hansford County,2022-Jul,2718(P),2649(P),69(P),2.5(P)
Hardeman County,2012-Jan,1762,1652,110,6.2
Hardeman County,2012-Feb,1761,1648,113,6.4
Hardeman County,2012-Mar,1765,1662,103,5.8
Hardeman County,2012-Apr,1762,1662,100,5.7
Hardeman County,2012-May,1755,1654,101,5.8
Hardeman County,2012-Jun,1777,1667,110,6.2
Hardeman County,2012-Jul,1781,1668,113,6.3
Hardeman County,2012-Aug,1776,1668,108,6.1
Hardeman County,2012-Sep,1776,1678,98,5.5
Hardeman County,2012-Oct,1740,1646,94,5.4
Hardeman County,2012-Nov,1734,1642,92,5.3
Hardeman County,2012-Dec,1716,1619,97,5.7
Hardeman County,2013-Jan,1708,1600,108,6.3
Hardeman County,2013-Feb,1680,1575,105,6.3
Hardeman County,2013-Mar,1693,1589,104,6.1
Hardeman County,2013-Apr,1709,1613,96,5.6
Hardeman County,2013-May,1731,1632,99,5.7
Hardeman County,2013-Jun,1756,1652,104,5.9
Hardeman County,2013-Jul,1740,1637,103,5.9
Hardeman County,2013-Aug,1690,1593,97,5.7
Hardeman County,2013-Sep,1688,1593,95,5.6
Hardeman County,2013-Oct,1659,1564,95,5.7
Hardeman County,2013-Nov,1643,1547,96,5.8
Hardeman County,2013-Dec,1648,1560,88,5.3
Hardeman County,2014-Jan,1591,1505,86,5.4
Hardeman County,2014-Feb,1638,1547,91,5.6
Hardeman County,2014-Mar,1639,1553,86,5.2
Hardeman County,2014-Apr,1657,1584,73,4.4
Hardeman County,2014-May,1659,1579,80,4.8
Hardeman County,2014-Jun,1682,1590,92,5.5
Hardeman County,2014-Jul,1690,1596,94,5.6
Hardeman County,2014-Aug,1672,1589,83,5
Hardeman County,2014-Sep,1666,1589,77,4.6
Hardeman County,2014-Oct,1635,1558,77,4.7
Hardeman County,2014-Nov,1623,1549,74,4.6
Hardeman County,2014-Dec,1597,1524,73,4.6
Hardeman County,2015-Jan,1583,1503,80,5.1
Hardeman County,2015-Feb,1593,1511,82,5.1
Hardeman County,2015-Mar,1619,1531,88,5.4
Hardeman County,2015-Apr,1635,1553,82,5
Hardeman County,2015-May,1647,1562,85,5.2
Hardeman County,2015-Jun,1669,1583,86,5.2
Hardeman County,2015-Jul,1657,1564,93,5.6
Hardeman County,2015-Aug,1643,1557,86,5.2
Hardeman County,2015-Sep,1625,1549,76,4.7
Hardeman County,2015-Oct,1601,1528,73,4.6
Hardeman County,2015-Nov,1591,1521,70,4.4
Hardeman County,2015-Dec,1591,1531,60,3.8
Hardeman County,2016-Jan,1563,1500,63,4
Hardeman County,2016-Feb,1605,1541,64,4
Hardeman County,2016-Mar,1631,1568,63,3.9
Hardeman County,2016-Apr,1640,1581,59,3.6
Hardeman County,2016-May,1651,1587,64,3.9
Hardeman County,2016-Jun,1662,1590,72,4.3
Hardeman County,2016-Jul,1648,1578,70,4.2
Hardeman County,2016-Aug,1647,1584,63,3.8
Hardeman County,2016-Sep,1626,1564,62,3.8
Hardeman County,2016-Oct,1617,1554,63,3.9
Hardeman County,2016-Nov,1596,1536,60,3.8
Hardeman County,2016-Dec,1612,1548,64,4
Hardeman County,2017-Jan,1627,1556,71,4.4
Hardeman County,2017-Feb,1652,1578,74,4.5
Hardeman County,2017-Mar,1674,1605,69,4.1
Hardeman County,2017-Apr,1666,1606,60,3.6
Hardeman County,2017-May,1687,1627,60,3.6
Hardeman County,2017-Jun,1665,1599,66,4
Hardeman County,2017-Jul,1651,1585,66,4
Hardeman County,2017-Aug,1649,1581,68,4.1
Hardeman County,2017-Sep,1641,1574,67,4.1
Hardeman County,2017-Oct,1635,1576,59,3.6
Hardeman County,2017-Nov,1601,1536,65,4.1
Hardeman County,2017-Dec,1601,1539,62,3.9
Hardeman County,2018-Jan,1622,1556,66,4.1
Hardeman County,2018-Feb,1649,1579,70,4.2
Hardeman County,2018-Mar,1676,1608,68,4.1
Hardeman County,2018-Apr,1666,1607,59,3.5
Hardeman County,2018-May,1669,1612,57,3.4
Hardeman County,2018-Jun,1667,1604,63,3.8
Hardeman County,2018-Jul,1685,1623,62,3.7
Hardeman County,2018-Aug,1684,1626,58,3.4
Hardeman County,2018-Sep,1680,1618,62,3.7
Hardeman County,2018-Oct,1659,1606,53,3.2
Hardeman County,2018-Nov,1652,1601,51,3.1
Hardeman County,2018-Dec,1627,1574,53,3.3
Hardeman County,2019-Jan,1653,1593,60,3.6
Hardeman County,2019-Feb,1659,1605,54,3.3
Hardeman County,2019-Mar,1687,1631,56,3.3
Hardeman County,2019-Apr,1690,1646,44,2.6
Hardeman County,2019-May,1698,1653,45,2.7
Hardeman County,2019-Jun,1712,1659,53,3.1
Hardeman County,2019-Jul,1711,1656,55,3.2
Hardeman County,2019-Aug,1722,1669,53,3.1
Hardeman County,2019-Sep,1732,1681,51,2.9
Hardeman County,2019-Oct,1736,1687,49,2.8
Hardeman County,2019-Nov,1704,1654,50,2.9
Hardeman County,2019-Dec,1693,1652,41,2.4
Hardeman County,2020-Jan,1728,1677,51,3
Hardeman County,2020-Feb,1727,1681,46,2.7
Hardeman County,2020-Mar,1704,1631,73,4.3
Hardeman County,2020-Apr,1588,1517,71,4.5
Hardeman County,2020-May,1633,1544,89,5.5
Hardeman County,2020-Jun,1666,1565,101,6.1
Hardeman County,2020-Jul,1703,1621,82,4.8
Hardeman County,2020-Aug,1722,1656,66,3.8
Hardeman County,2020-Sep,1729,1657,72,4.2
Hardeman County,2020-Oct,1717,1645,72,4.2
Hardeman County,2020-Nov,1688,1610,78,4.6
Hardeman County,2020-Dec,1702,1614,88,5.2
Hardeman County,2021-Jan,1701,1614,87,5.1
Hardeman County,2021-Feb,1730,1643,87,5
Hardeman County,2021-Mar,1758,1667,91,5.2
Hardeman County,2021-Apr,1743,1675,68,3.9
Hardeman County,2021-May,1737,1661,76,4.4
Hardeman County,2021-Jun,1743,1664,79,4.5
Hardeman County,2021-Jul,1745,1671,74,4.2
Hardeman County,2021-Aug,1766,1694,72,4.1
Hardeman County,2021-Sep,1726,1657,69,4
Hardeman County,2021-Oct,1688,1624,64,3.8
Hardeman County,2021-Nov,1665,1604,61,3.7
Hardeman County,2021-Dec,1658,1602,56,3.4
Hardeman County,2022-Jan,1676,1607,69,4.1
Hardeman County,2022-Feb,1723,1650,73,4.2
Hardeman County,2022-Mar,1750,1692,58,3.3
Hardeman County,2022-Apr,1724,1671,53,3.1
Hardeman County,2022-May,1712,1657,55,3.2
Hardeman County,2022-Jun,1719,1654,65,3.8
Hardeman County,2022-Jul,1759(P),1693(P),66(P),3.8(P)
Hardin County,2012-Jan,26159,23852,2307,8.8
Hardin County,2012-Feb,26218,23997,2221,8.5
Hardin County,2012-Mar,26046,23974,2072,8
Hardin County,2012-Apr,26089,24131,1958,7.5
Hardin County,2012-May,26052,23967,2085,8
Hardin County,2012-Jun,26090,23688,2402,9.2
Hardin County,2012-Jul,25811,23429,2382,9.2
Hardin County,2012-Aug,25522,23255,2267,8.9
Hardin County,2012-Sep,25524,23418,2106,8.3
Hardin County,2012-Oct,25596,23531,2065,8.1
Hardin County,2012-Nov,25363,23357,2006,7.9
Hardin County,2012-Dec,25399,23240,2159,8.5
Hardin County,2013-Jan,25432,23125,2307,9.1
Hardin County,2013-Feb,25582,23458,2124,8.3
Hardin County,2013-Mar,25502,23443,2059,8.1
Hardin County,2013-Apr,25389,23411,1978,7.8
Hardin County,2013-May,25408,23399,2009,7.9
Hardin County,2013-Jun,25449,23212,2237,8.8
Hardin County,2013-Jul,25138,22953,2185,8.7
Hardin County,2013-Aug,24963,22876,2087,8.4
Hardin County,2013-Sep,25042,23033,2009,8
Hardin County,2013-Oct,24983,23101,1882,7.5
Hardin County,2013-Nov,25133,23244,1889,7.5
Hardin County,2013-Dec,25036,23243,1793,7.2
Hardin County,2014-Jan,25033,23182,1851,7.4
Hardin County,2014-Feb,25214,23403,1811,7.2
Hardin County,2014-Mar,25263,23529,1734,6.9
Hardin County,2014-Apr,25308,23791,1517,6
Hardin County,2014-May,25441,23907,1534,6
Hardin County,2014-Jun,25419,23745,1674,6.6
Hardin County,2014-Jul,25464,23685,1779,7
Hardin County,2014-Aug,25360,23643,1717,6.8
Hardin County,2014-Sep,25414,23845,1569,6.2
Hardin County,2014-Oct,25588,24172,1416,5.5
Hardin County,2014-Nov,25500,24084,1416,5.6
Hardin County,2014-Dec,25350,24026,1324,5.2
Hardin County,2015-Jan,25118,23671,1447,5.8
Hardin County,2015-Feb,25254,23887,1367,5.4
Hardin County,2015-Mar,25092,23728,1364,5.4
Hardin County,2015-Apr,24936,23677,1259,5
Hardin County,2015-May,25126,23785,1341,5.3
Hardin County,2015-Jun,25108,23636,1472,5.9
Hardin County,2015-Jul,24962,23442,1520,6.1
Hardin County,2015-Aug,24854,23361,1493,6
Hardin County,2015-Sep,24876,23457,1419,5.7
Hardin County,2015-Oct,24854,23436,1418,5.7
Hardin County,2015-Nov,24885,23388,1497,6
Hardin County,2015-Dec,24967,23508,1459,5.8
Hardin County,2016-Jan,25224,23761,1463,5.8
Hardin County,2016-Feb,25372,23952,1420,5.6
Hardin County,2016-Mar,25299,23838,1461,5.8
Hardin County,2016-Apr,25133,23786,1347,5.4
Hardin County,2016-May,24948,23593,1355,5.4
Hardin County,2016-Jun,25162,23551,1611,6.4
Hardin County,2016-Jul,25149,23415,1734,6.9
Hardin County,2016-Aug,25078,23371,1707,6.8
Hardin County,2016-Sep,25253,23619,1634,6.5
Hardin County,2016-Oct,25214,23725,1489,5.9
Hardin County,2016-Nov,25144,23598,1546,6.1
Hardin County,2016-Dec,25061,23425,1636,6.5
Hardin County,2017-Jan,25221,23431,1790,7.1
Hardin County,2017-Feb,25435,23739,1696,6.7
Hardin County,2017-Mar,25398,23813,1585,6.2
Hardin County,2017-Apr,25261,23818,1443,5.7
Hardin County,2017-May,25090,23679,1411,5.6
Hardin County,2017-Jun,25172,23618,1554,6.2
Hardin County,2017-Jul,25157,23602,1555,6.2
Hardin County,2017-Aug,24912,23320,1592,6.4
Hardin County,2017-Sep,24993,23310,1683,6.7
Hardin County,2017-Oct,24926,23511,1415,5.7
Hardin County,2017-Nov,24988,23533,1455,5.8
Hardin County,2017-Dec,24868,23417,1451,5.8
Hardin County,2018-Jan,25193,23633,1560,6.2
Hardin County,2018-Feb,25428,23971,1457,5.7
Hardin County,2018-Mar,25201,23802,1399,5.6
Hardin County,2018-Apr,25165,23902,1263,5
Hardin County,2018-May,25127,23927,1200,4.8
Hardin County,2018-Jun,25297,23902,1395,5.5
Hardin County,2018-Jul,25163,23751,1412,5.6
Hardin County,2018-Aug,24987,23659,1328,5.3
Hardin County,2018-Sep,25056,23830,1226,4.9
Hardin County,2018-Oct,25052,23917,1135,4.5
Hardin County,2018-Nov,25122,23964,1158,4.6
Hardin County,2018-Dec,24991,23774,1217,4.9
Hardin County,2019-Jan,25309,23938,1371,5.4
Hardin County,2019-Feb,25473,24226,1247,4.9
Hardin County,2019-Mar,25354,24212,1142,4.5
Hardin County,2019-Apr,25157,24200,957,3.8
Hardin County,2019-May,25102,24083,1019,4.1
Hardin County,2019-Jun,25197,23943,1254,5
Hardin County,2019-Jul,25130,23836,1294,5.1
Hardin County,2019-Aug,25099,23883,1216,4.8
Hardin County,2019-Sep,25253,24152,1101,4.4
Hardin County,2019-Oct,25396,24360,1036,4.1
Hardin County,2019-Nov,25456,24356,1100,4.3
Hardin County,2019-Dec,25337,24245,1092,4.3
Hardin County,2020-Jan,25664,24459,1205,4.7
Hardin County,2020-Feb,25824,24751,1073,4.2
Hardin County,2020-Mar,25516,23791,1725,6.8
Hardin County,2020-Apr,24232,20865,3367,13.9
Hardin County,2020-May,24709,21448,3261,13.2
Hardin County,2020-Jun,24859,21908,2951,11.9
Hardin County,2020-Jul,24877,22094,2783,11.2
Hardin County,2020-Aug,24866,22630,2236,9
Hardin County,2020-Sep,24908,22716,2192,8.8
Hardin County,2020-Oct,24933,23016,1917,7.7
Hardin County,2020-Nov,25178,23167,2011,8
Hardin County,2020-Dec,25093,22979,2114,8.4
Hardin County,2021-Jan,24891,22602,2289,9.2
Hardin County,2021-Feb,24904,22680,2224,8.9
Hardin County,2021-Mar,24875,22870,2005,8.1
Hardin County,2021-Apr,24756,22841,1915,7.7
Hardin County,2021-May,24714,22677,2037,8.2
Hardin County,2021-Jun,24805,22538,2267,9.1
Hardin County,2021-Jul,24704,22586,2118,8.6
Hardin County,2021-Aug,24638,22655,1983,8
Hardin County,2021-Sep,24603,22787,1816,7.4
Hardin County,2021-Oct,24626,22927,1699,6.9
Hardin County,2021-Nov,24803,23129,1674,6.7
Hardin County,2021-Dec,24800,23194,1606,6.5
Hardin County,2022-Jan,25015,23205,1810,7.2
Hardin County,2022-Feb,25169,23443,1726,6.9
Hardin County,2022-Mar,24988,23580,1408,5.6
Hardin County,2022-Apr,24791,23506,1285,5.2
Hardin County,2022-May,24772,23436,1336,5.4
Hardin County,2022-Jun,24941,23388,1553,6.2
Hardin County,2022-Jul,24838(P),23299(P),1539(P),6.2(P)
Harris County,2012-Jan,2118087,1963547,154540,7.3
Harris County,2012-Feb,2131731,1980706,151025,7.1
Harris County,2012-Mar,2132171,1991789,140382,6.6
Harris County,2012-Apr,2132668,1999449,133219,6.2
Harris County,2012-May,2144464,2003665,140799,6.6
Harris County,2012-Jun,2158341,2003415,154926,7.2
Harris County,2012-Jul,2166417,2012090,154327,7.1
Harris County,2012-Aug,2153988,2008945,145043,6.7
Harris County,2012-Sep,2164124,2028731,135393,6.3
Harris County,2012-Oct,2170770,2039021,131749,6.1
Harris County,2012-Nov,2171198,2042912,128286,5.9
Harris County,2012-Dec,2175738,2043132,132606,6.1
Harris County,2013-Jan,2172751,2025173,147578,6.8
Harris County,2013-Feb,2182185,2043160,139025,6.4
Harris County,2013-Mar,2180167,2047557,132610,6.1
Harris County,2013-Apr,2187456,2059868,127588,5.8
Harris County,2013-May,2193874,2059986,133888,6.1
Harris County,2013-Jun,2201830,2055767,146063,6.6
Harris County,2013-Jul,2209077,2066562,142515,6.5
Harris County,2013-Aug,2197711,2061658,136053,6.2
Harris County,2013-Sep,2203544,2069548,133996,6.1
Harris County,2013-Oct,2193986,2066171,127815,5.8
Harris County,2013-Nov,2209818,2086555,123263,5.6
Harris County,2013-Dec,2206771,2090496,116275,5.3
Harris County,2014-Jan,2198373,2075288,123085,5.6
Harris County,2014-Feb,2214101,2090516,123585,5.6
Harris County,2014-Mar,2220098,2101913,118185,5.3
Harris County,2014-Apr,2214294,2110232,104062,4.7
Harris County,2014-May,2220775,2109793,110982,5
Harris County,2014-Jun,2228298,2108305,119993,5.4
Harris County,2014-Jul,2241212,2117528,123684,5.5
Harris County,2014-Aug,2231322,2112210,119112,5.3
Harris County,2014-Sep,2234391,2124158,110233,4.9
Harris County,2014-Oct,2240412,2138357,102055,4.6
Harris County,2014-Nov,2244586,2143178,101408,4.5
Harris County,2014-Dec,2235865,2142332,93533,4.2
Harris County,2015-Jan,2228880,2123645,105235,4.7
Harris County,2015-Feb,2231084,2130011,101073,4.5
Harris County,2015-Mar,2226444,2128359,98085,4.4
Harris County,2015-Apr,2232084,2139230,92854,4.2
Harris County,2015-May,2234385,2135544,98841,4.4
Harris County,2015-Jun,2235579,2126969,108610,4.9
Harris County,2015-Jul,2242693,2129562,113131,5
Harris County,2015-Aug,2234992,2125479,109513,4.9
Harris County,2015-Sep,2230419,2122437,107982,4.8
Harris County,2015-Oct,2237423,2131091,106332,4.8
Harris County,2015-Nov,2246270,2137065,109205,4.9
Harris County,2015-Dec,2244457,2140121,104336,4.6
Harris County,2016-Jan,2233263,2122634,110629,5
Harris County,2016-Feb,2247394,2136920,110474,4.9
Harris County,2016-Mar,2249146,2135558,113588,5.1
Harris County,2016-Apr,2248366,2137664,110702,4.9
Harris County,2016-May,2242006,2131347,110659,4.9
Harris County,2016-Jun,2254951,2126951,128000,5.7
Harris County,2016-Jul,2265793,2133624,132169,5.8
Harris County,2016-Aug,2255096,2124082,131014,5.8
Harris County,2016-Sep,2257506,2126119,131387,5.8
Harris County,2016-Oct,2252040,2130694,121346,5.4
Harris County,2016-Nov,2255721,2135857,119864,5.3
Harris County,2016-Dec,2254500,2132046,122454,5.4
Harris County,2017-Jan,2232983,2099925,133058,6
Harris County,2017-Feb,2248269,2117809,130460,5.8
Harris County,2017-Mar,2247445,2127094,120351,5.4
Harris County,2017-Apr,2249730,2137685,112045,5
Harris County,2017-May,2240507,2131316,109191,4.9
Harris County,2017-Jun,2251803,2133573,118230,5.3
Harris County,2017-Jul,2255274,2139536,115738,5.1
Harris County,2017-Aug,2249308,2131604,117704,5.2
Harris County,2017-Sep,2255120,2141149,113971,5.1
Harris County,2017-Oct,2243703,2142569,101134,4.5
Harris County,2017-Nov,2258055,2153254,104801,4.6
Harris County,2017-Dec,2256277,2153626,102651,4.5
Harris County,2018-Jan,2241250,2127299,113951,5.1
Harris County,2018-Feb,2268506,2157220,111286,4.9
Harris County,2018-Mar,2261700,2156950,104750,4.6
Harris County,2018-Apr,2262380,2164797,97583,4.3
Harris County,2018-May,2255650,2161009,94641,4.2
Harris County,2018-Jun,2270388,2162101,108287,4.8
Harris County,2018-Jul,2275254,2170078,105176,4.6
Harris County,2018-Aug,2254857,2153388,101469,4.5
Harris County,2018-Sep,2259956,2162616,97340,4.3
Harris County,2018-Oct,2269198,2179040,90158,4
Harris County,2018-Nov,2275562,2185546,90016,4
Harris County,2018-Dec,2280771,2188529,92242,4
Harris County,2019-Jan,2261238,2158009,103229,4.6
Harris County,2019-Feb,2274984,2180869,94115,4.1
Harris County,2019-Mar,2263190,2176820,86370,3.8
Harris County,2019-Apr,2255513,2179318,76195,3.4
Harris County,2019-May,2255666,2177707,77959,3.5
Harris County,2019-Jun,2274632,2181900,92732,4.1
Harris County,2019-Jul,2281985,2186973,95012,4.2
Harris County,2019-Aug,2273119,2180968,92151,4.1
Harris County,2019-Sep,2282299,2195898,86401,3.8
Harris County,2019-Oct,2285145,2201852,83293,3.6
Harris County,2019-Nov,2293424,2209255,84169,3.7
Harris County,2019-Dec,2288865,2206789,82076,3.6
Harris County,2020-Jan,2274302,2182268,92034,4
Harris County,2020-Feb,2293334,2207029,86305,3.8
Harris County,2020-Mar,2258784,2123727,135057,6
Harris County,2020-Apr,2168175,1868453,299722,13.8
Harris County,2020-May,2247277,1940127,307150,13.7
Harris County,2020-Jun,2275110,1994042,281068,12.4
Harris County,2020-Jul,2275866,2006929,268937,11.8
Harris County,2020-Aug,2269063,2047895,221168,9.7
Harris County,2020-Sep,2272297,2059691,212606,9.4
Harris County,2020-Oct,2271142,2092892,178250,7.8
Harris County,2020-Nov,2279285,2101852,177433,7.8
Harris County,2020-Dec,2274476,2097587,176889,7.8
Harris County,2021-Jan,2260546,2080145,180401,8
Harris County,2021-Feb,2274359,2100509,173850,7.6
Harris County,2021-Mar,2272214,2106330,165884,7.3
Harris County,2021-Apr,2270805,2116626,154179,6.8
Harris County,2021-May,2266472,2120483,145989,6.4
Harris County,2021-Jun,2282848,2120014,162834,7.1
Harris County,2021-Jul,2295029,2141028,154001,6.7
Harris County,2021-Aug,2289061,2143692,145369,6.4
Harris County,2021-Sep,2288882,2157099,131783,5.8
Harris County,2021-Oct,2292916,2168058,124858,5.4
Harris County,2021-Nov,2306238,2187454,118784,5.2
Harris County,2021-Dec,2308130,2196197,111933,4.8
Harris County,2022-Jan,2304549,2177878,126671,5.5
Harris County,2022-Feb,2323068,2199403,123665,5.3
Harris County,2022-Mar,2315269,2213714,101555,4.4
Harris County,2022-Apr,2309623,2213045,96578,4.2
Harris County,2022-May,2324944,2224953,99991,4.3
Harris County,2022-Jun,2349000,2234804,114196,4.9
Harris County,2022-Jul,2349900(P),2236644(P),113256(P),4.8(P)
Harrison County,2012-Jan,31400,28929,2471,7.9
Harrison County,2012-Feb,31608,29171,2437,7.7
Harrison County,2012-Mar,31698,29426,2272,7.2
Harrison County,2012-Apr,31875,29726,2149,6.7
Harrison County,2012-May,32019,29698,2321,7.2
Harrison County,2012-Jun,32079,29537,2542,7.9
Harrison County,2012-Jul,32209,29656,2553,7.9
Harrison County,2012-Aug,32045,29612,2433,7.6
Harrison County,2012-Sep,31809,29500,2309,7.3
Harrison County,2012-Oct,32203,29912,2291,7.1
Harrison County,2012-Nov,31982,29792,2190,6.8
Harrison County,2012-Dec,31893,29629,2264,7.1
Harrison County,2013-Jan,32240,29782,2458,7.6
Harrison County,2013-Feb,32339,29998,2341,7.2
Harrison County,2013-Mar,32222,30037,2185,6.8
Harrison County,2013-Apr,32454,30311,2143,6.6
Harrison County,2013-May,32254,30053,2201,6.8
Harrison County,2013-Jun,32446,30040,2406,7.4
Harrison County,2013-Jul,32411,30015,2396,7.4
Harrison County,2013-Aug,32211,29928,2283,7.1
Harrison County,2013-Sep,32326,30066,2260,7
Harrison County,2013-Oct,32181,30031,2150,6.7
Harrison County,2013-Nov,32183,30141,2042,6.3
Harrison County,2013-Dec,31888,29982,1906,6
Harrison County,2014-Jan,31750,29758,1992,6.3
Harrison County,2014-Feb,32007,30010,1997,6.2
Harrison County,2014-Mar,32340,30430,1910,5.9
Harrison County,2014-Apr,31971,30293,1678,5.2
Harrison County,2014-May,32171,30375,1796,5.6
Harrison County,2014-Jun,32295,30379,1916,5.9
Harrison County,2014-Jul,32283,30299,1984,6.1
Harrison County,2014-Aug,32201,30303,1898,5.9
Harrison County,2014-Sep,32180,30449,1731,5.4
Harrison County,2014-Oct,32212,30606,1606,5
Harrison County,2014-Nov,32269,30689,1580,4.9
Harrison County,2014-Dec,32131,30700,1431,4.5
Harrison County,2015-Jan,32139,30550,1589,4.9
Harrison County,2015-Feb,31869,30334,1535,4.8
Harrison County,2015-Mar,31593,30062,1531,4.8
Harrison County,2015-Apr,31349,29886,1463,4.7
Harrison County,2015-May,31278,29705,1573,5
Harrison County,2015-Jun,31262,29504,1758,5.6
Harrison County,2015-Jul,31146,29324,1822,5.8
Harrison County,2015-Aug,30885,29152,1733,5.6
Harrison County,2015-Sep,30887,29215,1672,5.4
Harrison County,2015-Oct,30967,29323,1644,5.3
Harrison County,2015-Nov,30800,29083,1717,5.6
Harrison County,2015-Dec,30431,28760,1671,5.5
Harrison County,2016-Jan,30022,28295,1727,5.8
Harrison County,2016-Feb,30311,28588,1723,5.7
Harrison County,2016-Mar,30057,28343,1714,5.7
Harrison County,2016-Apr,30126,28431,1695,5.6
Harrison County,2016-May,29946,28269,1677,5.6
Harrison County,2016-Jun,30115,28118,1997,6.6
Harrison County,2016-Jul,29958,27946,2012,6.7
Harrison County,2016-Aug,29806,27817,1989,6.7
Harrison County,2016-Sep,29982,28041,1941,6.5
Harrison County,2016-Oct,29940,28186,1754,5.9
Harrison County,2016-Nov,29821,28135,1686,5.7
Harrison County,2016-Dec,29455,27742,1713,5.8
Harrison County,2017-Jan,29266,27359,1907,6.5
Harrison County,2017-Feb,29501,27632,1869,6.3
Harrison County,2017-Mar,29358,27653,1705,5.8
Harrison County,2017-Apr,29434,27918,1516,5.2
Harrison County,2017-May,29248,27757,1491,5.1
Harrison County,2017-Jun,29377,27766,1611,5.5
Harrison County,2017-Jul,29146,27603,1543,5.3
Harrison County,2017-Aug,29121,27578,1543,5.3
Harrison County,2017-Sep,29219,27831,1388,4.8
Harrison County,2017-Oct,29066,27807,1259,4.3
Harrison County,2017-Nov,29143,27793,1350,4.6
Harrison County,2017-Dec,29092,27791,1301,4.5
Harrison County,2018-Jan,29318,27894,1424,4.9
Harrison County,2018-Feb,29719,28332,1387,4.7
Harrison County,2018-Mar,29795,28441,1354,4.5
Harrison County,2018-Apr,29943,28711,1232,4.1
Harrison County,2018-May,29845,28637,1208,4
Harrison County,2018-Jun,29957,28533,1424,4.8
Harrison County,2018-Jul,29827,28464,1363,4.6
Harrison County,2018-Aug,29569,28220,1349,4.6
Harrison County,2018-Sep,29696,28436,1260,4.2
Harrison County,2018-Oct,29481,28279,1202,4.1
Harrison County,2018-Nov,29343,28159,1184,4
Harrison County,2018-Dec,29212,28008,1204,4.1
Harrison County,2019-Jan,28963,27612,1351,4.7
Harrison County,2019-Feb,29137,27931,1206,4.1
Harrison County,2019-Mar,29124,27947,1177,4
Harrison County,2019-Apr,28990,28001,989,3.4
Harrison County,2019-May,28800,27757,1043,3.6
Harrison County,2019-Jun,28935,27732,1203,4.2
Harrison County,2019-Jul,29038,27799,1239,4.3
Harrison County,2019-Aug,29054,27845,1209,4.2
Harrison County,2019-Sep,29386,28213,1173,4
Harrison County,2019-Oct,29348,28201,1147,3.9
Harrison County,2019-Nov,29229,28098,1131,3.9
Harrison County,2019-Dec,28987,27892,1095,3.8
Harrison County,2020-Jan,28936,27705,1231,4.3
Harrison County,2020-Feb,29228,28064,1164,4
Harrison County,2020-Mar,28937,27129,1808,6.2
Harrison County,2020-Apr,27772,24941,2831,10.2
Harrison County,2020-May,28558,25461,3097,10.8
Harrison County,2020-Jun,28848,25818,3030,10.5
Harrison County,2020-Jul,28744,25906,2838,9.9
Harrison County,2020-Aug,28784,26460,2324,8.1
Harrison County,2020-Sep,28973,26677,2296,7.9
Harrison County,2020-Oct,28981,26863,2118,7.3
Harrison County,2020-Nov,29039,26784,2255,7.8
Harrison County,2020-Dec,29022,26807,2215,7.6
Harrison County,2021-Jan,28736,26465,2271,7.9
Harrison County,2021-Feb,28926,26698,2228,7.7
Harrison County,2021-Mar,28936,26822,2114,7.3
Harrison County,2021-Apr,28806,26883,1923,6.7
Harrison County,2021-May,28741,26860,1881,6.5
Harrison County,2021-Jun,28911,26722,2189,7.6
Harrison County,2021-Jul,28524,26559,1965,6.9
Harrison County,2021-Aug,28457,26636,1821,6.4
Harrison County,2021-Sep,28626,26954,1672,5.8
Harrison County,2021-Oct,28505,26859,1646,5.8
Harrison County,2021-Nov,28374,26831,1543,5.4
Harrison County,2021-Dec,28259,26792,1467,5.2
Harrison County,2022-Jan,28231,26601,1630,5.8
Harrison County,2022-Feb,28467,26836,1631,5.7
Harrison County,2022-Mar,28458,27103,1355,4.8
Harrison County,2022-Apr,28309,27020,1289,4.6
Harrison County,2022-May,28340,26992,1348,4.8
Harrison County,2022-Jun,28390,26881,1509,5.3
Harrison County,2022-Jul,28429(P),26942(P),1487(P),5.2(P)
Hartley County,2012-Jan,2791,2691,100,3.6
Hartley County,2012-Feb,2792,2696,96,3.4
Hartley County,2012-Mar,2828,2738,90,3.2
Hartley County,2012-Apr,2877,2788,89,3.1
Hartley County,2012-May,2912,2814,98,3.4
Hartley County,2012-Jun,2975,2860,115,3.9
Hartley County,2012-Jul,2949,2835,114,3.9
Hartley County,2012-Aug,2903,2805,98,3.4
Hartley County,2012-Sep,2932,2840,92,3.1
Hartley County,2012-Oct,2926,2836,90,3.1
Hartley County,2012-Nov,2950,2866,84,2.8
Hartley County,2012-Dec,2919,2830,89,3
Hartley County,2013-Jan,2878,2777,101,3.5
Hartley County,2013-Feb,2863,2772,91,3.2
Hartley County,2013-Mar,2873,2783,90,3.1
Hartley County,2013-Apr,2960,2877,83,2.8
Hartley County,2013-May,3001,2908,93,3.1
Hartley County,2013-Jun,3032,2926,106,3.5
Hartley County,2013-Jul,3008,2904,104,3.5
Hartley County,2013-Aug,2935,2836,99,3.4
Hartley County,2013-Sep,2929,2832,97,3.3
Hartley County,2013-Oct,2927,2838,89,3
Hartley County,2013-Nov,2836,2755,81,2.9
Hartley County,2013-Dec,2863,2786,77,2.7
Hartley County,2014-Jan,2810,2733,77,2.7
Hartley County,2014-Feb,2895,2812,83,2.9
Hartley County,2014-Mar,2925,2851,74,2.5
Hartley County,2014-Apr,2919,2857,62,2.1
Hartley County,2014-May,2937,2866,71,2.4
Hartley County,2014-Jun,2988,2907,81,2.7
Hartley County,2014-Jul,2942,2856,86,2.9
Hartley County,2014-Aug,2876,2799,77,2.7
Hartley County,2014-Sep,2905,2831,74,2.5
Hartley County,2014-Oct,2888,2817,71,2.5
Hartley County,2014-Nov,2842,2772,70,2.5
Hartley County,2014-Dec,2824,2764,60,2.1
Hartley County,2015-Jan,2947,2874,73,2.5
Hartley County,2015-Feb,2967,2901,66,2.2
Hartley County,2015-Mar,3026,2960,66,2.2
Hartley County,2015-Apr,3009,2949,60,2
Hartley County,2015-May,3029,2962,67,2.2
Hartley County,2015-Jun,3058,2984,74,2.4
Hartley County,2015-Jul,3027,2957,70,2.3
Hartley County,2015-Aug,2991,2930,61,2
Hartley County,2015-Sep,3006,2946,60,2
Hartley County,2015-Oct,3029,2971,58,1.9
Hartley County,2015-Nov,2975,2917,58,1.9
Hartley County,2015-Dec,2991,2932,59,2
Hartley County,2016-Jan,2874,2813,61,2.1
Hartley County,2016-Feb,2986,2927,59,2
Hartley County,2016-Mar,3020,2961,59,2
Hartley County,2016-Apr,3027,2977,50,1.7
Hartley County,2016-May,3087,3032,55,1.8
Hartley County,2016-Jun,3040,2974,66,2.2
Hartley County,2016-Jul,2927,2859,68,2.3
Hartley County,2016-Aug,2941,2879,62,2.1
Hartley County,2016-Sep,2922,2860,62,2.1
Hartley County,2016-Oct,2917,2857,60,2.1
Hartley County,2016-Nov,2906,2850,56,1.9
Hartley County,2016-Dec,2878,2821,57,2
Hartley County,2017-Jan,2845,2780,65,2.3
Hartley County,2017-Feb,2894,2830,64,2.2
Hartley County,2017-Mar,2982,2921,61,2
Hartley County,2017-Apr,2981,2928,53,1.8
Hartley County,2017-May,2976,2921,55,1.8
Hartley County,2017-Jun,2989,2929,60,2
Hartley County,2017-Jul,2900,2838,62,2.1
Hartley County,2017-Aug,2913,2853,60,2.1
Hartley County,2017-Sep,2878,2825,53,1.8
Hartley County,2017-Oct,2921,2871,50,1.7
Hartley County,2017-Nov,2869,2812,57,2
Hartley County,2017-Dec,2873,2821,52,1.8
Hartley County,2018-Jan,2804,2749,55,2
Hartley County,2018-Feb,2837,2784,53,1.9
Hartley County,2018-Mar,2909,2856,53,1.8
Hartley County,2018-Apr,2872,2828,44,1.5
Hartley County,2018-May,2916,2872,44,1.5
Hartley County,2018-Jun,2892,2836,56,1.9
Hartley County,2018-Jul,2840,2788,52,1.8
Hartley County,2018-Aug,2871,2815,56,2
Hartley County,2018-Sep,2818,2761,57,2
Hartley County,2018-Oct,2803,2752,51,1.8
Hartley County,2018-Nov,2751,2703,48,1.7
Hartley County,2018-Dec,2704,2655,49,1.8
Hartley County,2019-Jan,2699,2644,55,2
Hartley County,2019-Feb,2753,2706,47,1.7
Hartley County,2019-Mar,2791,2746,45,1.6
Hartley County,2019-Apr,2740,2705,35,1.3
Hartley County,2019-May,2770,2732,38,1.4
Hartley County,2019-Jun,2765,2718,47,1.7
Hartley County,2019-Jul,2784,2736,48,1.7
Hartley County,2019-Aug,2834,2785,49,1.7
Hartley County,2019-Sep,2746,2698,48,1.7
Hartley County,2019-Oct,2799,2754,45,1.6
Hartley County,2019-Nov,2750,2703,47,1.7
Hartley County,2019-Dec,2751,2709,42,1.5
Hartley County,2020-Jan,2602,2554,48,1.8
Hartley County,2020-Feb,2607,2564,43,1.6
Hartley County,2020-Mar,2595,2532,63,2.4
Hartley County,2020-Apr,2468,2415,53,2.1
Hartley County,2020-May,2523,2465,58,2.3
Hartley County,2020-Jun,2557,2489,68,2.7
Hartley County,2020-Jul,2593,2529,64,2.5
Hartley County,2020-Aug,2644,2599,45,1.7
Hartley County,2020-Sep,2608,2563,45,1.7
Hartley County,2020-Oct,2676,2635,41,1.5
Hartley County,2020-Nov,2624,2578,46,1.8
Hartley County,2020-Dec,2637,2594,43,1.6
Hartley County,2021-Jan,2705,2649,56,2.1
Hartley County,2021-Feb,2781,2720,61,2.2
Hartley County,2021-Mar,2812,2749,63,2.2
Hartley County,2021-Apr,2782,2730,52,1.9
Hartley County,2021-May,2729,2671,58,2.1
Hartley County,2021-Jun,2730,2662,68,2.5
Hartley County,2021-Jul,2736,2677,59,2.2
Hartley County,2021-Aug,2721,2665,56,2.1
Hartley County,2021-Sep,2727,2667,60,2.2
Hartley County,2021-Oct,2719,2663,56,2.1
Hartley County,2021-Nov,2681,2629,52,1.9
Hartley County,2021-Dec,2680,2632,48,1.8
Hartley County,2022-Jan,2686,2631,55,2
Hartley County,2022-Feb,2805,2751,54,1.9
Hartley County,2022-Mar,2876,2832,44,1.5
Hartley County,2022-Apr,2837,2799,38,1.3
Hartley County,2022-May,2776,2732,44,1.6
Hartley County,2022-Jun,2761,2710,51,1.8
Hartley County,2022-Jul,2844(P),2795(P),49(P),1.7(P)
Haskell County,2012-Jan,2773,2609,164,5.9
Haskell County,2012-Feb,2753,2585,168,6.1
Haskell County,2012-Mar,2773,2620,153,5.5
Haskell County,2012-Apr,2764,2629,135,4.9
Haskell County,2012-May,2767,2621,146,5.3
Haskell County,2012-Jun,2825,2663,162,5.7
Haskell County,2012-Jul,2816,2654,162,5.8
Haskell County,2012-Aug,2767,2617,150,5.4
Haskell County,2012-Sep,2755,2620,135,4.9
Haskell County,2012-Oct,2751,2626,125,4.5
Haskell County,2012-Nov,2755,2629,126,4.6
Haskell County,2012-Dec,2712,2585,127,4.7
Haskell County,2013-Jan,2691,2537,154,5.7
Haskell County,2013-Feb,2693,2546,147,5.5
Haskell County,2013-Mar,2668,2531,137,5.1
Haskell County,2013-Apr,2689,2558,131,4.9
Haskell County,2013-May,2722,2584,138,5.1
Haskell County,2013-Jun,2764,2614,150,5.4
Haskell County,2013-Jul,2753,2611,142,5.2
Haskell County,2013-Aug,2692,2556,136,5.1
Haskell County,2013-Sep,2720,2582,138,5.1
Haskell County,2013-Oct,2747,2623,124,4.5
Haskell County,2013-Nov,2659,2546,113,4.2
Haskell County,2013-Dec,2677,2572,105,3.9
Haskell County,2014-Jan,2608,2505,103,3.9
Haskell County,2014-Feb,2662,2556,106,4
Haskell County,2014-Mar,2691,2573,118,4.4
Haskell County,2014-Apr,2706,2602,104,3.8
Haskell County,2014-May,2733,2620,113,4.1
Haskell County,2014-Jun,2731,2611,120,4.4
Haskell County,2014-Jul,2715,2597,118,4.3
Haskell County,2014-Aug,2663,2554,109,4.1
Haskell County,2014-Sep,2705,2598,107,4
Haskell County,2014-Oct,2761,2657,104,3.8
Haskell County,2014-Nov,2683,2584,99,3.7
Haskell County,2014-Dec,2620,2534,86,3.3
Haskell County,2015-Jan,2563,2464,99,3.9
Haskell County,2015-Feb,2611,2519,92,3.5
Haskell County,2015-Mar,2663,2571,92,3.5
Haskell County,2015-Apr,2581,2496,85,3.3
Haskell County,2015-May,2630,2529,101,3.8
Haskell County,2015-Jun,2661,2552,109,4.1
Haskell County,2015-Jul,2569,2477,92,3.6
Haskell County,2015-Aug,2525,2438,87,3.4
Haskell County,2015-Sep,2566,2475,91,3.5
Haskell County,2015-Oct,2594,2508,86,3.3
Haskell County,2015-Nov,2518,2436,82,3.3
Haskell County,2015-Dec,2515,2440,75,3
Haskell County,2016-Jan,2446,2358,88,3.6
Haskell County,2016-Feb,2547,2455,92,3.6
Haskell County,2016-Mar,2607,2511,96,3.7
Haskell County,2016-Apr,2590,2495,95,3.7
Haskell County,2016-May,2592,2500,92,3.5
Haskell County,2016-Jun,2556,2452,104,4.1
Haskell County,2016-Jul,2465,2357,108,4.4
Haskell County,2016-Aug,2479,2359,120,4.8
Haskell County,2016-Sep,2495,2367,128,5.1
Haskell County,2016-Oct,2453,2333,120,4.9
Haskell County,2016-Nov,2445,2326,119,4.9
Haskell County,2016-Dec,2439,2326,113,4.6
Haskell County,2017-Jan,2404,2276,128,5.3
Haskell County,2017-Feb,2453,2327,126,5.1
Haskell County,2017-Mar,2537,2423,114,4.5
Haskell County,2017-Apr,2498,2376,122,4.9
Haskell County,2017-May,2492,2369,123,4.9
Haskell County,2017-Jun,2441,2314,127,5.2
Haskell County,2017-Jul,2370,2246,124,5.2
Haskell County,2017-Aug,2407,2282,125,5.2
Haskell County,2017-Sep,2365,2253,112,4.7
Haskell County,2017-Oct,2380,2281,99,4.2
Haskell County,2017-Nov,2333,2226,107,4.6
Haskell County,2017-Dec,2354,2257,97,4.1
Haskell County,2018-Jan,2330,2227,103,4.4
Haskell County,2018-Feb,2356,2257,99,4.2
Haskell County,2018-Mar,2434,2335,99,4.1
Haskell County,2018-Apr,2333,2240,93,4
Haskell County,2018-May,2385,2301,84,3.5
Haskell County,2018-Jun,2371,2270,101,4.3
Haskell County,2018-Jul,2290,2194,96,4.2
Haskell County,2018-Aug,2356,2264,92,3.9
Haskell County,2018-Sep,2316,2232,84,3.6
Haskell County,2018-Oct,2311,2230,81,3.5
Haskell County,2018-Nov,2274,2194,80,3.5
Haskell County,2018-Dec,2236,2159,77,3.4
Haskell County,2019-Jan,2159,2078,81,3.8
Haskell County,2019-Feb,2220,2140,80,3.6
Haskell County,2019-Mar,2244,2168,76,3.4
Haskell County,2019-Apr,2219,2148,71,3.2
Haskell County,2019-May,2247,2177,70,3.1
Haskell County,2019-Jun,2241,2164,77,3.4
Haskell County,2019-Jul,2224,2147,77,3.5
Haskell County,2019-Aug,2278,2203,75,3.3
Haskell County,2019-Sep,2251,2179,72,3.2
Haskell County,2019-Oct,2260,2194,66,2.9
Haskell County,2019-Nov,2184,2116,68,3.1
Haskell County,2019-Dec,2192,2133,59,2.7
Haskell County,2020-Jan,2659,2585,74,2.8
Haskell County,2020-Feb,2684,2615,69,2.6
Haskell County,2020-Mar,2591,2483,108,4.2
Haskell County,2020-Apr,2483,2364,119,4.8
Haskell County,2020-May,2561,2429,132,5.2
Haskell County,2020-Jun,2616,2470,146,5.6
Haskell County,2020-Jul,2654,2513,141,5.3
Haskell County,2020-Aug,2719,2602,117,4.3
Haskell County,2020-Sep,2643,2523,120,4.5
Haskell County,2020-Oct,2745,2640,105,3.8
Haskell County,2020-Nov,2717,2606,111,4.1
Haskell County,2020-Dec,2727,2609,118,4.3
Haskell County,2021-Jan,2760,2635,125,4.5
Haskell County,2021-Feb,2791,2672,119,4.3
Haskell County,2021-Mar,2797,2679,118,4.2
Haskell County,2021-Apr,2782,2677,105,3.8
Haskell County,2021-May,2710,2609,101,3.7
Haskell County,2021-Jun,2729,2609,120,4.4
Haskell County,2021-Jul,2738,2624,114,4.2
Haskell County,2021-Aug,2741,2629,112,4.1
Haskell County,2021-Sep,2734,2630,104,3.8
Haskell County,2021-Oct,2733,2632,101,3.7
Haskell County,2021-Nov,2688,2592,96,3.6
Haskell County,2021-Dec,2675,2590,85,3.2
Haskell County,2022-Jan,2707,2613,94,3.5
Haskell County,2022-Feb,2828,2732,96,3.4
Haskell County,2022-Mar,2895,2818,77,2.7
Haskell County,2022-Apr,2870,2797,73,2.5
Haskell County,2022-May,2801,2724,77,2.7
Haskell County,2022-Jun,2768,2682,86,3.1
Haskell County,2022-Jul,2855(P),2777(P),78(P),2.7(P)
Hays County,2012-Jan,84312,78929,5383,6.4
Hays County,2012-Feb,84655,79476,5179,6.1
Hays County,2012-Mar,84677,79838,4839,5.7
Hays County,2012-Apr,84910,80315,4595,5.4
Hays County,2012-May,85186,80312,4874,5.7
Hays County,2012-Jun,85839,80279,5560,6.5
Hays County,2012-Jul,85891,80379,5512,6.4
Hays County,2012-Aug,85517,80363,5154,6
Hays County,2012-Sep,86009,81261,4748,5.5
Hays County,2012-Oct,86699,82004,4695,5.4
Hays County,2012-Nov,87023,82537,4486,5.2
Hays County,2012-Dec,86606,82072,4534,5.2
Hays County,2013-Jan,88249,82983,5266,6
Hays County,2013-Feb,88492,83538,4954,5.6
Hays County,2013-Mar,88613,83816,4797,5.4
Hays County,2013-Apr,89306,84771,4535,5.1
Hays County,2013-May,89713,84825,4888,5.4
Hays County,2013-Jun,90190,84797,5393,6
Hays County,2013-Jul,90235,84996,5239,5.8
Hays County,2013-Aug,89829,84942,4887,5.4
Hays County,2013-Sep,90245,85450,4795,5.3
Hays County,2013-Oct,90261,85466,4795,5.3
Hays County,2013-Nov,90991,86644,4347,4.8
Hays County,2013-Dec,90486,86450,4036,4.5
Hays County,2014-Jan,92439,88062,4377,4.7
Hays County,2014-Feb,93279,88837,4442,4.8
Hays County,2014-Mar,93645,89459,4186,4.5
Hays County,2014-Apr,93503,89886,3617,3.9
Hays County,2014-May,93716,89698,4018,4.3
Hays County,2014-Jun,94264,89814,4450,4.7
Hays County,2014-Jul,94432,89848,4584,4.9
Hays County,2014-Aug,93899,89595,4304,4.6
Hays County,2014-Sep,94056,90047,4009,4.3
Hays County,2014-Oct,94562,90786,3776,4
Hays County,2014-Nov,94865,91178,3687,3.9
Hays County,2014-Dec,94102,90784,3318,3.5
Hays County,2015-Jan,96730,92870,3860,4
Hays County,2015-Feb,97099,93558,3541,3.6
Hays County,2015-Mar,97267,93977,3290,3.4
Hays County,2015-Apr,97916,94907,3009,3.1
Hays County,2015-May,98451,95130,3321,3.4
Hays County,2015-Jun,98914,95187,3727,3.8
Hays County,2015-Jul,98657,94970,3687,3.7
Hays County,2015-Aug,98383,95001,3382,3.4
Hays County,2015-Sep,98868,95488,3380,3.4
Hays County,2015-Oct,99488,96151,3337,3.4
Hays County,2015-Nov,100159,96896,3263,3.3
Hays County,2015-Dec,100031,96989,3042,3
Hays County,2016-Jan,102580,99210,3370,3.3
Hays County,2016-Feb,103790,100415,3375,3.3
Hays County,2016-Mar,104096,100750,3346,3.2
Hays County,2016-Apr,104244,101190,3054,2.9
Hays County,2016-May,104220,101129,3091,3
Hays County,2016-Jun,105113,101307,3806,3.6
Hays County,2016-Jul,105548,101645,3903,3.7
Hays County,2016-Aug,105166,101390,3776,3.6
Hays County,2016-Sep,105717,101927,3790,3.6
Hays County,2016-Oct,106068,102462,3606,3.4
Hays County,2016-Nov,106419,102950,3469,3.3
Hays County,2016-Dec,106086,102613,3473,3.3
Hays County,2017-Jan,107828,103994,3834,3.6
Hays County,2017-Feb,108831,104949,3882,3.6
Hays County,2017-Mar,109097,105487,3610,3.3
Hays County,2017-Apr,109549,106353,3196,2.9
Hays County,2017-May,109434,106105,3329,3
Hays County,2017-Jun,110014,106266,3748,3.4
Hays County,2017-Jul,110359,106659,3700,3.4
Hays County,2017-Aug,109945,106262,3683,3.3
Hays County,2017-Sep,110768,107434,3334,3
Hays County,2017-Oct,110680,107587,3093,2.8
Hays County,2017-Nov,111164,107857,3307,3
Hays County,2017-Dec,110953,107790,3163,2.9
Hays County,2018-Jan,112772,109237,3535,3.1
Hays County,2018-Feb,114182,110622,3560,3.1
Hays County,2018-Mar,114136,110680,3456,3
Hays County,2018-Apr,114570,111513,3057,2.7
Hays County,2018-May,114581,111474,3107,2.7
Hays County,2018-Jun,115587,111736,3851,3.3
Hays County,2018-Jul,115543,111862,3681,3.2
Hays County,2018-Aug,114748,111117,3631,3.2
Hays County,2018-Sep,115236,111812,3424,3
Hays County,2018-Oct,116229,112970,3259,2.8
Hays County,2018-Nov,116575,113314,3261,2.8
Hays County,2018-Dec,116497,113185,3312,2.8
Hays County,2019-Jan,117680,113569,4111,3.5
Hays County,2019-Feb,118379,114883,3496,3
Hays County,2019-Mar,118262,114984,3278,2.8
Hays County,2019-Apr,118335,115566,2769,2.3
Hays County,2019-May,118201,115349,2852,2.4
Hays County,2019-Jun,119401,115809,3592,3
Hays County,2019-Jul,119808,116154,3654,3
Hays County,2019-Aug,119523,116000,3523,2.9
Hays County,2019-Sep,120129,116766,3363,2.8
Hays County,2019-Oct,120921,117676,3245,2.7
Hays County,2019-Nov,121289,118153,3136,2.6
Hays County,2019-Dec,121204,118264,2940,2.4
Hays County,2020-Jan,123865,120399,3466,2.8
Hays County,2020-Feb,124801,121562,3239,2.6
Hays County,2020-Mar,122183,117177,5006,4.1
Hays County,2020-Apr,115532,102219,13313,11.5
Hays County,2020-May,118964,106311,12653,10.6
Hays County,2020-Jun,121523,110458,11065,9.1
Hays County,2020-Jul,122434,112492,9942,8.1
Hays County,2020-Aug,123107,115350,7757,6.3
Hays County,2020-Sep,123483,116271,7212,5.8
Hays County,2020-Oct,124985,118815,6170,4.9
Hays County,2020-Nov,125548,119257,6291,5
Hays County,2020-Dec,125680,119582,6098,4.9
Hays County,2021-Jan,125592,119058,6534,5.2
Hays County,2021-Feb,126705,120243,6462,5.1
Hays County,2021-Mar,126840,120848,5992,4.7
Hays County,2021-Apr,127767,122426,5341,4.2
Hays County,2021-May,128187,122996,5191,4
Hays County,2021-Jun,129787,123740,6047,4.7
Hays County,2021-Jul,130483,125041,5442,4.2
Hays County,2021-Aug,130478,125376,5102,3.9
Hays County,2021-Sep,130921,126083,4838,3.7
Hays County,2021-Oct,132321,127666,4655,3.5
Hays County,2021-Nov,133134,128789,4345,3.3
Hays County,2021-Dec,132993,128989,4004,3
Hays County,2022-Jan,132713,128052,4661,3.5
Hays County,2022-Feb,134205,129545,4660,3.5
Hays County,2022-Mar,134688,130911,3777,2.8
Hays County,2022-Apr,133737,130254,3483,2.6
Hays County,2022-May,133450,129743,3707,2.8
Hays County,2022-Jun,134721,130284,4437,3.3
Hays County,2022-Jul,134970(P),130672(P),4298(P),3.2(P)
Hemphill County,2012-Jan,2514,2435,79,3.1
Hemphill County,2012-Feb,2504,2432,72,2.9
Hemphill County,2012-Mar,2529,2464,65,2.6
Hemphill County,2012-Apr,2585,2519,66,2.6
Hemphill County,2012-May,2570,2498,72,2.8
Hemphill County,2012-Jun,2635,2549,86,3.3
Hemphill County,2012-Jul,2597,2512,85,3.3
Hemphill County,2012-Aug,2561,2480,81,3.2
Hemphill County,2012-Sep,2551,2479,72,2.8
Hemphill County,2012-Oct,2523,2455,68,2.7
Hemphill County,2012-Nov,2466,2399,67,2.7
Hemphill County,2012-Dec,2467,2395,72,2.9
Hemphill County,2013-Jan,2477,2392,85,3.4
Hemphill County,2013-Feb,2414,2338,76,3.1
Hemphill County,2013-Mar,2407,2330,77,3.2
Hemphill County,2013-Apr,2494,2424,70,2.8
Hemphill County,2013-May,2507,2431,76,3
Hemphill County,2013-Jun,2524,2439,85,3.4
Hemphill County,2013-Jul,2521,2439,82,3.3
Hemphill County,2013-Aug,2472,2397,75,3
Hemphill County,2013-Sep,2450,2373,77,3.1
Hemphill County,2013-Oct,2441,2371,70,2.9
Hemphill County,2013-Nov,2457,2389,68,2.8
Hemphill County,2013-Dec,2478,2415,63,2.5
Hemphill County,2014-Jan,2494,2429,65,2.6
Hemphill County,2014-Feb,2503,2434,69,2.8
Hemphill County,2014-Mar,2510,2449,61,2.4
Hemphill County,2014-Apr,2547,2493,54,2.1
Hemphill County,2014-May,2575,2512,63,2.4
Hemphill County,2014-Jun,2594,2526,68,2.6
Hemphill County,2014-Jul,2628,2557,71,2.7
Hemphill County,2014-Aug,2566,2501,65,2.5
Hemphill County,2014-Sep,2582,2522,60,2.3
Hemphill County,2014-Oct,2561,2505,56,2.2
Hemphill County,2014-Nov,2493,2438,55,2.2
Hemphill County,2014-Dec,2433,2383,50,2.1
Hemphill County,2015-Jan,2410,2347,63,2.6
Hemphill County,2015-Feb,2416,2350,66,2.7
Hemphill County,2015-Mar,2394,2323,71,3
Hemphill County,2015-Apr,2365,2294,71,3
Hemphill County,2015-May,2387,2308,79,3.3
Hemphill County,2015-Jun,2392,2307,85,3.6
Hemphill County,2015-Jul,2294,2216,78,3.4
Hemphill County,2015-Aug,2249,2169,80,3.6
Hemphill County,2015-Sep,2210,2137,73,3.3
Hemphill County,2015-Oct,2203,2134,69,3.1
Hemphill County,2015-Nov,2157,2085,72,3.3
Hemphill County,2015-Dec,2145,2078,67,3.1
Hemphill County,2016-Jan,2078,2003,75,3.6
Hemphill County,2016-Feb,2112,2029,83,3.9
Hemphill County,2016-Mar,2105,2011,94,4.5
Hemphill County,2016-Apr,2072,1989,83,4
Hemphill County,2016-May,2119,2030,89,4.2
Hemphill County,2016-Jun,2149,2063,86,4
Hemphill County,2016-Jul,2135,2049,86,4
Hemphill County,2016-Aug,2128,2052,76,3.6
Hemphill County,2016-Sep,2133,2055,78,3.7
Hemphill County,2016-Oct,2118,2050,68,3.2
Hemphill County,2016-Nov,2110,2043,67,3.2
Hemphill County,2016-Dec,2130,2063,67,3.1
Hemphill County,2017-Jan,2211,2142,69,3.1
Hemphill County,2017-Feb,2261,2190,71,3.1
Hemphill County,2017-Mar,2308,2246,62,2.7
Hemphill County,2017-Apr,2325,2271,54,2.3
Hemphill County,2017-May,2301,2242,59,2.6
Hemphill County,2017-Jun,2284,2219,65,2.8
Hemphill County,2017-Jul,2354,2292,62,2.6
Hemphill County,2017-Aug,2241,2182,59,2.6
Hemphill County,2017-Sep,2377,2322,55,2.3
Hemphill County,2017-Oct,2236,2192,44,2
Hemphill County,2017-Nov,2383,2334,49,2.1
Hemphill County,2017-Dec,2288,2244,44,1.9
Hemphill County,2018-Jan,2393,2343,50,2.1
Hemphill County,2018-Feb,2354,2301,53,2.3
Hemphill County,2018-Mar,2384,2331,53,2.2
Hemphill County,2018-Apr,2186,2140,46,2.1
Hemphill County,2018-May,2126,2084,42,2
Hemphill County,2018-Jun,2149,2096,53,2.5
Hemphill County,2018-Jul,2200,2151,49,2.2
Hemphill County,2018-Aug,2131,2085,46,2.2
Hemphill County,2018-Sep,2277,2234,43,1.9
Hemphill County,2018-Oct,2146,2103,43,2
Hemphill County,2018-Nov,2201,2160,41,1.9
Hemphill County,2018-Dec,2172,2131,41,1.9
Hemphill County,2019-Jan,1902,1850,52,2.7
Hemphill County,2019-Feb,1887,1838,49,2.6
Hemphill County,2019-Mar,1897,1851,46,2.4
Hemphill County,2019-Apr,1923,1874,49,2.5
Hemphill County,2019-May,1932,1873,59,3.1
Hemphill County,2019-Jun,1999,1940,59,3
Hemphill County,2019-Jul,1938,1880,58,3
Hemphill County,2019-Aug,1917,1862,55,2.9
Hemphill County,2019-Sep,1900,1852,48,2.5
Hemphill County,2019-Oct,2128,2075,53,2.5
Hemphill County,2019-Nov,2179,2128,51,2.3
Hemphill County,2019-Dec,2176,2128,48,2.2
Hemphill County,2020-Jan,1998,1933,65,3.3
Hemphill County,2020-Feb,2026,1968,58,2.9
Hemphill County,2020-Mar,2020,1938,82,4.1
Hemphill County,2020-Apr,1729,1643,86,5
Hemphill County,2020-May,1717,1624,93,5.4
Hemphill County,2020-Jun,1755,1650,105,6
Hemphill County,2020-Jul,1703,1609,94,5.5
Hemphill County,2020-Aug,1716,1640,76,4.4
Hemphill County,2020-Sep,1713,1641,72,4.2
Hemphill County,2020-Oct,1675,1603,72,4.3
Hemphill County,2020-Nov,1660,1572,88,5.3
Hemphill County,2020-Dec,1653,1568,85,5.1
Hemphill County,2021-Jan,1649,1563,86,5.2
Hemphill County,2021-Feb,1648,1560,88,5.3
Hemphill County,2021-Mar,1668,1592,76,4.6
Hemphill County,2021-Apr,1648,1581,67,4.1
Hemphill County,2021-May,1630,1562,68,4.2
Hemphill County,2021-Jun,1686,1599,87,5.2
Hemphill County,2021-Jul,1602,1528,74,4.6
Hemphill County,2021-Aug,1649,1579,70,4.2
Hemphill County,2021-Sep,1629,1562,67,4.1
Hemphill County,2021-Oct,1623,1560,63,3.9
Hemphill County,2021-Nov,1601,1545,56,3.5
Hemphill County,2021-Dec,1595,1540,55,3.4
Hemphill County,2022-Jan,1529,1461,68,4.4
Hemphill County,2022-Feb,1549,1479,70,4.5
Hemphill County,2022-Mar,1582,1530,52,3.3
Hemphill County,2022-Apr,1553,1509,44,2.8
Hemphill County,2022-May,1535,1488,47,3.1
Hemphill County,2022-Jun,1578,1521,57,3.6
Hemphill County,2022-Jul,1532(P),1480(P),52(P),3.4(P)
Henderson County,2012-Jan,34476,31646,2830,8.2
Henderson County,2012-Feb,34446,31681,2765,8
Henderson County,2012-Mar,34350,31781,2569,7.5
Henderson County,2012-Apr,34455,32042,2413,7
Henderson County,2012-May,34487,31930,2557,7.4
Henderson County,2012-Jun,34892,32077,2815,8.1
Henderson County,2012-Jul,34716,31920,2796,8.1
Henderson County,2012-Aug,34434,31788,2646,7.7
Henderson County,2012-Sep,34389,31935,2454,7.1
Henderson County,2012-Oct,34315,31868,2447,7.1
Henderson County,2012-Nov,34276,31905,2371,6.9
Henderson County,2012-Dec,34310,31842,2468,7.2
Henderson County,2013-Jan,34273,31518,2755,8
Henderson County,2013-Feb,34239,31662,2577,7.5
Henderson County,2013-Mar,34195,31696,2499,7.3
Henderson County,2013-Apr,34537,32168,2369,6.9
Henderson County,2013-May,34564,32110,2454,7.1
Henderson County,2013-Jun,34834,32147,2687,7.7
Henderson County,2013-Jul,34871,32248,2623,7.5
Henderson County,2013-Aug,34557,32039,2518,7.3
Henderson County,2013-Sep,34689,32181,2508,7.2
Henderson County,2013-Oct,34324,31980,2344,6.8
Henderson County,2013-Nov,34495,32259,2236,6.5
Henderson County,2013-Dec,34370,32269,2101,6.1
Henderson County,2014-Jan,34502,32313,2189,6.3
Henderson County,2014-Feb,34576,32376,2200,6.4
Henderson County,2014-Mar,34773,32648,2125,6.1
Henderson County,2014-Apr,34691,32882,1809,5.2
Henderson County,2014-May,34935,33007,1928,5.5
Henderson County,2014-Jun,35142,33055,2087,5.9
Henderson County,2014-Jul,34774,32633,2141,6.2
Henderson County,2014-Aug,34641,32597,2044,5.9
Henderson County,2014-Sep,34836,32950,1886,5.4
Henderson County,2014-Oct,34633,32839,1794,5.2
Henderson County,2014-Nov,34625,32867,1758,5.1
Henderson County,2014-Dec,34181,32581,1600,4.7
Henderson County,2015-Jan,34081,32287,1794,5.3
Henderson County,2015-Feb,34092,32365,1727,5.1
Henderson County,2015-Mar,34123,32399,1724,5.1
Henderson County,2015-Apr,34457,32910,1547,4.5
Henderson County,2015-May,34636,33000,1636,4.7
Henderson County,2015-Jun,34705,32900,1805,5.2
Henderson County,2015-Jul,34660,32834,1826,5.3
Henderson County,2015-Aug,34247,32578,1669,4.9
Henderson County,2015-Sep,34138,32472,1666,4.9
Henderson County,2015-Oct,34394,32755,1639,4.8
Henderson County,2015-Nov,34600,32983,1617,4.7
Henderson County,2015-Dec,34470,32917,1553,4.5
Henderson County,2016-Jan,34446,32814,1632,4.7
Henderson County,2016-Feb,34874,33312,1562,4.5
Henderson County,2016-Mar,35273,33648,1625,4.6
Henderson County,2016-Apr,35437,33946,1491,4.2
Henderson County,2016-May,35483,33972,1511,4.3
Henderson County,2016-Jun,35723,33931,1792,5
Henderson County,2016-Jul,35734,33900,1834,5.1
Henderson County,2016-Aug,35544,33737,1807,5.1
Henderson County,2016-Sep,35467,33689,1778,5
Henderson County,2016-Oct,35503,33853,1650,4.6
Henderson County,2016-Nov,35767,34153,1614,4.5
Henderson County,2016-Dec,35530,33937,1593,4.5
Henderson County,2017-Jan,35123,33399,1724,4.9
Henderson County,2017-Feb,35364,33634,1730,4.9
Henderson County,2017-Mar,35383,33771,1612,4.6
Henderson County,2017-Apr,35367,33957,1410,4
Henderson County,2017-May,35377,33972,1405,4
Henderson County,2017-Jun,35586,34006,1580,4.4
Henderson County,2017-Jul,35367,33818,1549,4.4
Henderson County,2017-Aug,35224,33702,1522,4.3
Henderson County,2017-Sep,35412,34014,1398,3.9
Henderson County,2017-Oct,35357,34055,1302,3.7
Henderson County,2017-Nov,35499,34156,1343,3.8
Henderson County,2017-Dec,35432,34139,1293,3.6
Henderson County,2018-Jan,35494,34070,1424,4
Henderson County,2018-Feb,35829,34421,1408,3.9
Henderson County,2018-Mar,36101,34674,1427,4
Henderson County,2018-Apr,35971,34720,1251,3.5
Henderson County,2018-May,35963,34722,1241,3.5
Henderson County,2018-Jun,36128,34598,1530,4.2
Henderson County,2018-Jul,35920,34436,1484,4.1
Henderson County,2018-Aug,35575,34191,1384,3.9
Henderson County,2018-Sep,35711,34384,1327,3.7
Henderson County,2018-Oct,35569,34306,1263,3.6
Henderson County,2018-Nov,35695,34410,1285,3.6
Henderson County,2018-Dec,35605,34299,1306,3.7
Henderson County,2019-Jan,35612,34147,1465,4.1
Henderson County,2019-Feb,35921,34581,1340,3.7
Henderson County,2019-Mar,35972,34676,1296,3.6
Henderson County,2019-Apr,35972,34873,1099,3.1
Henderson County,2019-May,35941,34841,1100,3.1
Henderson County,2019-Jun,36325,34945,1380,3.8
Henderson County,2019-Jul,36278,34860,1418,3.9
Henderson County,2019-Aug,36194,34873,1321,3.6
Henderson County,2019-Sep,36371,35113,1258,3.5
Henderson County,2019-Oct,36532,35328,1204,3.3
Henderson County,2019-Nov,36760,35547,1213,3.3
Henderson County,2019-Dec,36534,35388,1146,3.1
Henderson County,2020-Jan,36708,35348,1360,3.7
Henderson County,2020-Feb,37023,35762,1261,3.4
Henderson County,2020-Mar,36601,34615,1986,5.4
Henderson County,2020-Apr,34306,31208,3098,9
Henderson County,2020-May,35788,32559,3229,9
Henderson County,2020-Jun,36729,33553,3176,8.6
Henderson County,2020-Jul,36995,34057,2938,7.9
Henderson County,2020-Aug,37252,34807,2445,6.6
Henderson County,2020-Sep,37382,35012,2370,6.3
Henderson County,2020-Oct,37550,35426,2124,5.7
Henderson County,2020-Nov,37617,35422,2195,5.8
Henderson County,2020-Dec,37623,35413,2210,5.9
Henderson County,2021-Jan,37573,35243,2330,6.2
Henderson County,2021-Feb,37783,35463,2320,6.1
Henderson County,2021-Mar,37954,35733,2221,5.9
Henderson County,2021-Apr,38006,36038,1968,5.2
Henderson County,2021-May,38023,36092,1931,5.1
Henderson County,2021-Jun,38255,36000,2255,5.9
Henderson County,2021-Jul,38523,36497,2026,5.3
Henderson County,2021-Aug,38438,36536,1902,4.9
Henderson County,2021-Sep,38438,36655,1783,4.6
Henderson County,2021-Oct,38479,36755,1724,4.5
Henderson County,2021-Nov,38604,36982,1622,4.2
Henderson County,2021-Dec,38356,36891,1465,3.8
Henderson County,2022-Jan,38343,36669,1674,4.4
Henderson County,2022-Feb,38707,37028,1679,4.3
Henderson County,2022-Mar,39007,37634,1373,3.5
Henderson County,2022-Apr,38837,37563,1274,3.3
Henderson County,2022-May,38922,37557,1365,3.5
Henderson County,2022-Jun,39094,37502,1592,4.1
Henderson County,2022-Jul,39412(P),37843(P),1569(P),4.0(P)
Hidalgo County,2012-Jan,328901,292035,36866,11.2
Hidalgo County,2012-Feb,327935,292139,35796,10.9
Hidalgo County,2012-Mar,326664,293636,33028,10.1
Hidalgo County,2012-Apr,325757,294420,31337,9.6
Hidalgo County,2012-May,325578,292337,33241,10.2
Hidalgo County,2012-Jun,329001,291381,37620,11.4
Hidalgo County,2012-Jul,323966,286349,37617,11.6
Hidalgo County,2012-Aug,323950,288007,35943,11.1
Hidalgo County,2012-Sep,325670,292298,33372,10.2
Hidalgo County,2012-Oct,326872,294695,32177,9.8
Hidalgo County,2012-Nov,329782,297731,32051,9.7
Hidalgo County,2012-Dec,332222,297504,34718,10.5
Hidalgo County,2013-Jan,331457,293467,37990,11.5
Hidalgo County,2013-Feb,330823,294802,36021,10.9
Hidalgo County,2013-Mar,328894,294928,33966,10.3
Hidalgo County,2013-Apr,331003,298003,33000,10
Hidalgo County,2013-May,330899,297228,33671,10.2
Hidalgo County,2013-Jun,332549,295677,36872,11.1
Hidalgo County,2013-Jul,326875,290969,35906,11
Hidalgo County,2013-Aug,328189,293308,34881,10.6
Hidalgo County,2013-Sep,329299,295655,33644,10.2
Hidalgo County,2013-Oct,328669,296615,32054,9.8
Hidalgo County,2013-Nov,334000,301035,32965,9.9
Hidalgo County,2013-Dec,335740,303063,32677,9.7
Hidalgo County,2014-Jan,333902,299621,34281,10.3
Hidalgo County,2014-Feb,334777,301640,33137,9.9
Hidalgo County,2014-Mar,333912,302357,31555,9.5
Hidalgo County,2014-Apr,332267,304148,28119,8.5
Hidalgo County,2014-May,332301,304285,28016,8.4
Hidalgo County,2014-Jun,333657,302397,31260,9.4
Hidalgo County,2014-Jul,328497,296747,31750,9.7
Hidalgo County,2014-Aug,328750,298142,30608,9.3
Hidalgo County,2014-Sep,328513,301366,27147,8.3
Hidalgo County,2014-Oct,329496,304648,24848,7.5
Hidalgo County,2014-Nov,332745,306123,26622,8
Hidalgo County,2014-Dec,331976,305969,26007,7.8
Hidalgo County,2015-Jan,331280,302523,28757,8.7
Hidalgo County,2015-Feb,330726,303814,26912,8.1
Hidalgo County,2015-Mar,331346,305443,25903,7.8
Hidalgo County,2015-Apr,331688,306993,24695,7.4
Hidalgo County,2015-May,334420,308837,25583,7.6
Hidalgo County,2015-Jun,333405,305406,27999,8.4
Hidalgo County,2015-Jul,327945,299950,27995,8.5
Hidalgo County,2015-Aug,327976,300958,27018,8.2
Hidalgo County,2015-Sep,327423,302071,25352,7.7
Hidalgo County,2015-Oct,328745,304486,24259,7.4
Hidalgo County,2015-Nov,333944,307657,26287,7.9
Hidalgo County,2015-Dec,334531,308202,26329,7.9
Hidalgo County,2016-Jan,333442,306104,27338,8.2
Hidalgo County,2016-Feb,336220,310076,26144,7.8
Hidalgo County,2016-Mar,338144,312085,26059,7.7
Hidalgo County,2016-Apr,338208,313663,24545,7.3
Hidalgo County,2016-May,337460,313610,23850,7.1
Hidalgo County,2016-Jun,339227,310829,28398,8.4
Hidalgo County,2016-Jul,333224,304792,28432,8.5
Hidalgo County,2016-Aug,335872,307986,27886,8.3
Hidalgo County,2016-Sep,335791,309135,26656,7.9
Hidalgo County,2016-Oct,335433,311826,23607,7
Hidalgo County,2016-Nov,339786,314313,25473,7.5
Hidalgo County,2016-Dec,344207,315879,28328,8.2
Hidalgo County,2017-Jan,342972,311647,31325,9.1
Hidalgo County,2017-Feb,342524,313226,29298,8.6
Hidalgo County,2017-Mar,342362,315477,26885,7.9
Hidalgo County,2017-Apr,343066,317712,25354,7.4
Hidalgo County,2017-May,340945,316860,24085,7.1
Hidalgo County,2017-Jun,342393,314749,27644,8.1
Hidalgo County,2017-Jul,334328,307993,26335,7.9
Hidalgo County,2017-Aug,337059,310457,26602,7.9
Hidalgo County,2017-Sep,337631,314087,23544,7
Hidalgo County,2017-Oct,336429,316224,20205,6
Hidalgo County,2017-Nov,341238,318906,22332,6.5
Hidalgo County,2017-Dec,345300,321612,23688,6.9
Hidalgo County,2018-Jan,346186,319144,27042,7.8
Hidalgo County,2018-Feb,346874,321936,24938,7.2
Hidalgo County,2018-Mar,347785,324282,23503,6.8
Hidalgo County,2018-Apr,347125,324785,22340,6.4
Hidalgo County,2018-May,344906,324196,20710,6
Hidalgo County,2018-Jun,345452,320408,25044,7.2
Hidalgo County,2018-Jul,340004,315858,24146,7.1
Hidalgo County,2018-Aug,339718,317030,22688,6.7
Hidalgo County,2018-Sep,339966,318708,21258,6.3
Hidalgo County,2018-Oct,340971,321999,18972,5.6
Hidalgo County,2018-Nov,344888,324547,20341,5.9
Hidalgo County,2018-Dec,348811,325450,23361,6.7
Hidalgo County,2019-Jan,349115,322837,26278,7.5
Hidalgo County,2019-Feb,348342,325525,22817,6.6
Hidalgo County,2019-Mar,346852,326733,20119,5.8
Hidalgo County,2019-Apr,344303,326564,17739,5.2
Hidalgo County,2019-May,343944,325231,18713,5.4
Hidalgo County,2019-Jun,346859,323803,23056,6.6
Hidalgo County,2019-Jul,343551,319636,23915,7
Hidalgo County,2019-Aug,347252,324528,22724,6.5
Hidalgo County,2019-Sep,347553,326521,21032,6.1
Hidalgo County,2019-Oct,347719,328020,19699,5.7
Hidalgo County,2019-Nov,351622,330162,21460,6.1
Hidalgo County,2019-Dec,356176,331956,24220,6.8
Hidalgo County,2020-Jan,356446,329995,26451,7.4
Hidalgo County,2020-Feb,356474,333561,22913,6.4
Hidalgo County,2020-Mar,357001,322686,34315,9.6
Hidalgo County,2020-Apr,342733,285822,56911,16.6
Hidalgo County,2020-May,355261,297928,57333,16.1
Hidalgo County,2020-Jun,359909,307498,52411,14.6
Hidalgo County,2020-Jul,359248,307367,51881,14.4
Hidalgo County,2020-Aug,358694,315509,43185,12
Hidalgo County,2020-Sep,359210,317837,41373,11.5
Hidalgo County,2020-Oct,357050,321277,35773,10
Hidalgo County,2020-Nov,361055,323232,37823,10.5
Hidalgo County,2020-Dec,364530,325008,39522,10.8
Hidalgo County,2021-Jan,365489,323868,41621,11.4
Hidalgo County,2021-Feb,367435,327388,40047,10.9
Hidalgo County,2021-Mar,366067,329139,36928,10.1
Hidalgo County,2021-Apr,367042,331360,35682,9.7
Hidalgo County,2021-May,364335,330792,33543,9.2
Hidalgo County,2021-Jun,365950,328183,37767,10.3
Hidalgo County,2021-Jul,366511,331169,35342,9.6
Hidalgo County,2021-Aug,365467,332171,33296,9.1
Hidalgo County,2021-Sep,365552,335539,30013,8.2
Hidalgo County,2021-Oct,364635,336563,28072,7.7
Hidalgo County,2021-Nov,367158,338908,28250,7.7
Hidalgo County,2021-Dec,368989,340222,28767,7.8
Hidalgo County,2022-Jan,369704,336478,33226,9
Hidalgo County,2022-Feb,373560,342196,31364,8.4
Hidalgo County,2022-Mar,373135,347195,25940,7
Hidalgo County,2022-Apr,368939,343774,25165,6.8
Hidalgo County,2022-May,367917,342509,25408,6.9
Hidalgo County,2022-Jun,371401,341457,29944,8.1
Hidalgo County,2022-Jul,369168(P),339756(P),29412(P),8.0(P)
Hill County,2012-Jan,15671,14448,1223,7.8
Hill County,2012-Feb,15600,14429,1171,7.5
Hill County,2012-Mar,15637,14545,1092,7
Hill County,2012-Apr,15647,14618,1029,6.6
Hill County,2012-May,15774,14673,1101,7
Hill County,2012-Jun,15818,14604,1214,7.7
Hill County,2012-Jul,15849,14647,1202,7.6
Hill County,2012-Aug,15778,14698,1080,6.8
Hill County,2012-Sep,15848,14855,993,6.3
Hill County,2012-Oct,15814,14851,963,6.1
Hill County,2012-Nov,15896,14938,958,6
Hill County,2012-Dec,15857,14868,989,6.2
Hill County,2013-Jan,15884,14772,1112,7
Hill County,2013-Feb,15902,14858,1044,6.6
Hill County,2013-Mar,15829,14820,1009,6.4
Hill County,2013-Apr,16051,15097,954,5.9
Hill County,2013-May,16261,15190,1071,6.6
Hill County,2013-Jun,16220,15052,1168,7.2
Hill County,2013-Jul,15995,14858,1137,7.1
Hill County,2013-Aug,15832,14791,1041,6.6
Hill County,2013-Sep,15993,14987,1006,6.3
Hill County,2013-Oct,15757,14767,990,6.3
Hill County,2013-Nov,15823,14874,949,6
Hill County,2013-Dec,15728,14830,898,5.7
Hill County,2014-Jan,15755,14817,938,6
Hill County,2014-Feb,15927,14968,959,6
Hill County,2014-Mar,15930,15023,907,5.7
Hill County,2014-Apr,15924,15130,794,5
Hill County,2014-May,15976,15119,857,5.4
Hill County,2014-Jun,15951,15009,942,5.9
Hill County,2014-Jul,15953,14987,966,6.1
Hill County,2014-Aug,15816,14920,896,5.7
Hill County,2014-Sep,15893,15101,792,5
Hill County,2014-Oct,15757,15022,735,4.7
Hill County,2014-Nov,15801,15078,723,4.6
Hill County,2014-Dec,15641,14983,658,4.2
Hill County,2015-Jan,15472,14736,736,4.8
Hill County,2015-Feb,15549,14815,734,4.7
Hill County,2015-Mar,15538,14836,702,4.5
Hill County,2015-Apr,15647,14990,657,4.2
Hill County,2015-May,15716,15005,711,4.5
Hill County,2015-Jun,15633,14835,798,5.1
Hill County,2015-Jul,15611,14829,782,5
Hill County,2015-Aug,15536,14811,725,4.7
Hill County,2015-Sep,15625,14923,702,4.5
Hill County,2015-Oct,15671,14981,690,4.4
Hill County,2015-Nov,15746,15057,689,4.4
Hill County,2015-Dec,15723,15060,663,4.2
Hill County,2016-Jan,15517,14815,702,4.5
Hill County,2016-Feb,15875,15174,701,4.4
Hill County,2016-Mar,15988,15303,685,4.3
Hill County,2016-Apr,15919,15286,633,4
Hill County,2016-May,15940,15286,654,4.1
Hill County,2016-Jun,15809,15050,759,4.8
Hill County,2016-Jul,15784,15013,771,4.9
Hill County,2016-Aug,15709,14981,728,4.6
Hill County,2016-Sep,15800,15077,723,4.6
Hill County,2016-Oct,15762,15084,678,4.3
Hill County,2016-Nov,15819,15158,661,4.2
Hill County,2016-Dec,15820,15145,675,4.3
Hill County,2017-Jan,15701,14969,732,4.7
Hill County,2017-Feb,15905,15161,744,4.7
Hill County,2017-Mar,16069,15370,699,4.3
Hill County,2017-Apr,16055,15475,580,3.6
Hill County,2017-May,15989,15388,601,3.8
Hill County,2017-Jun,15980,15294,686,4.3
Hill County,2017-Jul,16113,15417,696,4.3
Hill County,2017-Aug,16135,15483,652,4
Hill County,2017-Sep,16271,15684,587,3.6
Hill County,2017-Oct,16166,15639,527,3.3
Hill County,2017-Nov,16168,15596,572,3.5
Hill County,2017-Dec,16035,15471,564,3.5
Hill County,2018-Jan,15778,15155,623,3.9
Hill County,2018-Feb,16154,15535,619,3.8
Hill County,2018-Mar,16250,15652,598,3.7
Hill County,2018-Apr,16221,15670,551,3.4
Hill County,2018-May,16160,15614,546,3.4
Hill County,2018-Jun,16172,15510,662,4.1
Hill County,2018-Jul,16191,15550,641,4
Hill County,2018-Aug,16143,15553,590,3.7
Hill County,2018-Sep,16228,15640,588,3.6
Hill County,2018-Oct,16116,15545,571,3.5
Hill County,2018-Nov,16105,15557,548,3.4
Hill County,2018-Dec,16055,15498,557,3.5
Hill County,2019-Jan,15882,15248,634,4
Hill County,2019-Feb,16082,15502,580,3.6
Hill County,2019-Mar,16144,15593,551,3.4
Hill County,2019-Apr,16023,15572,451,2.8
Hill County,2019-May,16101,15632,469,2.9
Hill County,2019-Jun,16142,15558,584,3.6
Hill County,2019-Jul,16241,15633,608,3.7
Hill County,2019-Aug,16374,15802,572,3.5
Hill County,2019-Sep,16361,15827,534,3.3
Hill County,2019-Oct,16382,15869,513,3.1
Hill County,2019-Nov,16340,15839,501,3.1
Hill County,2019-Dec,16357,15882,475,2.9
Hill County,2020-Jan,16084,15519,565,3.5
Hill County,2020-Feb,16315,15781,534,3.3
Hill County,2020-Mar,16151,15334,817,5.1
Hill County,2020-Apr,15200,13837,1363,9
Hill County,2020-May,15806,14343,1463,9.3
Hill County,2020-Jun,15985,14609,1376,8.6
Hill County,2020-Jul,16098,14829,1269,7.9
Hill County,2020-Aug,16293,15256,1037,6.4
Hill County,2020-Sep,16327,15346,981,6
Hill County,2020-Oct,16534,15651,883,5.3
Hill County,2020-Nov,16484,15533,951,5.8
Hill County,2020-Dec,16527,15556,971,5.9
Hill County,2021-Jan,16547,15530,1017,6.1
Hill County,2021-Feb,16777,15771,1006,6
Hill County,2021-Mar,16854,15893,961,5.7
Hill County,2021-Apr,16730,15892,838,5
Hill County,2021-May,16700,15874,826,4.9
Hill County,2021-Jun,16712,15768,944,5.6
Hill County,2021-Jul,16862,15992,870,5.2
Hill County,2021-Aug,16843,16044,799,4.7
Hill County,2021-Sep,16968,16196,772,4.5
Hill County,2021-Oct,16991,16266,725,4.3
Hill County,2021-Nov,16949,16253,696,4.1
Hill County,2021-Dec,16939,16284,655,3.9
Hill County,2022-Jan,16857,16122,735,4.4
Hill County,2022-Feb,17197,16469,728,4.2
Hill County,2022-Mar,17332,16742,590,3.4
Hill County,2022-Apr,16963,16413,550,3.2
Hill County,2022-May,17046,16442,604,3.5
Hill County,2022-Jun,17033,16326,707,4.2
Hill County,2022-Jul,17229(P),16533(P),696(P),4.0(P)
Hockley County,2012-Jan,11455,10797,658,5.7
Hockley County,2012-Feb,11511,10855,656,5.7
Hockley County,2012-Mar,11596,10948,648,5.6
Hockley County,2012-Apr,11766,11198,568,4.8
Hockley County,2012-May,11863,11254,609,5.1
Hockley County,2012-Jun,12034,11344,690,5.7
Hockley County,2012-Jul,11826,11125,701,5.9
Hockley County,2012-Aug,11733,11096,637,5.4
Hockley County,2012-Sep,11839,11255,584,4.9
Hockley County,2012-Oct,11893,11334,559,4.7
Hockley County,2012-Nov,11872,11324,548,4.6
Hockley County,2012-Dec,11781,11211,570,4.8
Hockley County,2013-Jan,11780,11113,667,5.7
Hockley County,2013-Feb,11841,11224,617,5.2
Hockley County,2013-Mar,11804,11199,605,5.1
Hockley County,2013-Apr,11927,11360,567,4.8
Hockley County,2013-May,12026,11425,601,5
Hockley County,2013-Jun,12162,11480,682,5.6
Hockley County,2013-Jul,11994,11327,667,5.6
Hockley County,2013-Aug,11867,11253,614,5.2
Hockley County,2013-Sep,11965,11365,600,5
Hockley County,2013-Oct,11895,11324,571,4.8
Hockley County,2013-Nov,11772,11233,539,4.6
Hockley County,2013-Dec,11756,11256,500,4.3
Hockley County,2014-Jan,11847,11313,534,4.5
Hockley County,2014-Feb,11967,11444,523,4.4
Hockley County,2014-Mar,12015,11514,501,4.2
Hockley County,2014-Apr,12103,11677,426,3.5
Hockley County,2014-May,12168,11706,462,3.8
Hockley County,2014-Jun,12163,11636,527,4.3
Hockley County,2014-Jul,12145,11586,559,4.6
Hockley County,2014-Aug,11983,11492,491,4.1
Hockley County,2014-Sep,12020,11564,456,3.8
Hockley County,2014-Oct,12237,11819,418,3.4
Hockley County,2014-Nov,12138,11738,400,3.3
Hockley County,2014-Dec,12062,11700,362,3
Hockley County,2015-Jan,12132,11682,450,3.7
Hockley County,2015-Feb,12134,11683,451,3.7
Hockley County,2015-Mar,12038,11573,465,3.9
Hockley County,2015-Apr,11926,11487,439,3.7
Hockley County,2015-May,11915,11423,492,4.1
Hockley County,2015-Jun,11874,11327,547,4.6
Hockley County,2015-Jul,11562,11003,559,4.8
Hockley County,2015-Aug,11439,10916,523,4.6
Hockley County,2015-Sep,11418,10910,508,4.4
Hockley County,2015-Oct,11484,10999,485,4.2
Hockley County,2015-Nov,11364,10864,500,4.4
Hockley County,2015-Dec,11390,10922,468,4.1
Hockley County,2016-Jan,11288,10769,519,4.6
Hockley County,2016-Feb,11418,10856,562,4.9
Hockley County,2016-Mar,11406,10858,548,4.8
Hockley County,2016-Apr,11325,10825,500,4.4
Hockley County,2016-May,11295,10802,493,4.4
Hockley County,2016-Jun,11236,10655,581,5.2
Hockley County,2016-Jul,11008,10429,579,5.3
Hockley County,2016-Aug,11053,10495,558,5
Hockley County,2016-Sep,11024,10506,518,4.7
Hockley County,2016-Oct,10998,10517,481,4.4
Hockley County,2016-Nov,11040,10591,449,4.1
Hockley County,2016-Dec,11019,10571,448,4.1
Hockley County,2017-Jan,10903,10453,450,4.1
Hockley County,2017-Feb,11057,10587,470,4.3
Hockley County,2017-Mar,11234,10787,447,4
Hockley County,2017-Apr,11290,10903,387,3.4
Hockley County,2017-May,11279,10876,403,3.6
Hockley County,2017-Jun,11253,10789,464,4.1
Hockley County,2017-Jul,11133,10679,454,4.1
Hockley County,2017-Aug,11155,10700,455,4.1
Hockley County,2017-Sep,11185,10787,398,3.6
Hockley County,2017-Oct,11243,10872,371,3.3
Hockley County,2017-Nov,11184,10810,374,3.3
Hockley County,2017-Dec,11214,10869,345,3.1
Hockley County,2018-Jan,11111,10746,365,3.3
Hockley County,2018-Feb,11294,10917,377,3.3
Hockley County,2018-Mar,11476,11082,394,3.4
Hockley County,2018-Apr,11503,11173,330,2.9
Hockley County,2018-May,11493,11169,324,2.8
Hockley County,2018-Jun,11385,10982,403,3.5
Hockley County,2018-Jul,11321,10937,384,3.4
Hockley County,2018-Aug,11308,10945,363,3.2
Hockley County,2018-Sep,11328,10989,339,3
Hockley County,2018-Oct,11353,11035,318,2.8
Hockley County,2018-Nov,11216,10895,321,2.9
Hockley County,2018-Dec,11085,10759,326,2.9
Hockley County,2019-Jan,11113,10748,365,3.3
Hockley County,2019-Feb,11257,10898,359,3.2
Hockley County,2019-Mar,11237,10887,350,3.1
Hockley County,2019-Apr,11203,10922,281,2.5
Hockley County,2019-May,11159,10856,303,2.7
Hockley County,2019-Jun,11106,10736,370,3.3
Hockley County,2019-Jul,11102,10731,371,3.3
Hockley County,2019-Aug,11169,10824,345,3.1
Hockley County,2019-Sep,11050,10738,312,2.8
Hockley County,2019-Oct,11219,10906,313,2.8
Hockley County,2019-Nov,11078,10778,300,2.7
Hockley County,2019-Dec,10927,10648,279,2.6
Hockley County,2020-Jan,11078,10723,355,3.2
Hockley County,2020-Feb,11177,10857,320,2.9
Hockley County,2020-Mar,11012,10516,496,4.5
Hockley County,2020-Apr,10345,9277,1068,10.3
Hockley County,2020-May,10252,8992,1260,12.3
Hockley County,2020-Jun,10287,9059,1228,11.9
Hockley County,2020-Jul,10390,9265,1125,10.8
Hockley County,2020-Aug,10406,9465,941,9
Hockley County,2020-Sep,10444,9567,877,8.4
Hockley County,2020-Oct,10607,9815,792,7.5
Hockley County,2020-Nov,10532,9696,836,7.9
Hockley County,2020-Dec,10468,9664,804,7.7
Hockley County,2021-Jan,10475,9664,811,7.7
Hockley County,2021-Feb,10737,9958,779,7.3
Hockley County,2021-Mar,10817,10081,736,6.8
Hockley County,2021-Apr,10806,10130,676,6.3
Hockley County,2021-May,10707,10059,648,6.1
Hockley County,2021-Jun,10648,9908,740,6.9
Hockley County,2021-Jul,10576,9900,676,6.4
Hockley County,2021-Aug,10541,9925,616,5.8
Hockley County,2021-Sep,10677,10134,543,5.1
Hockley County,2021-Oct,10738,10214,524,4.9
Hockley County,2021-Nov,10624,10137,487,4.6
Hockley County,2021-Dec,10528,10065,463,4.4
Hockley County,2022-Jan,10629,10118,511,4.8
Hockley County,2022-Feb,10919,10424,495,4.5
Hockley County,2022-Mar,11017,10606,411,3.7
Hockley County,2022-Apr,11127,10736,391,3.5
Hockley County,2022-May,11053,10649,404,3.7
Hockley County,2022-Jun,10960,10491,469,4.3
Hockley County,2022-Jul,11045(P),10597(P),448(P),4.1(P)
Hood County,2012-Jan,23494,21785,1709,7.3
Hood County,2012-Feb,23516,21883,1633,6.9
Hood County,2012-Mar,23508,21998,1510,6.4
Hood County,2012-Apr,23556,22128,1428,6.1
Hood County,2012-May,23667,22133,1534,6.5
Hood County,2012-Jun,23880,22223,1657,6.9
Hood County,2012-Jul,23885,22195,1690,7.1
Hood County,2012-Aug,23760,22191,1569,6.6
Hood County,2012-Sep,23835,22374,1461,6.1
Hood County,2012-Oct,23810,22399,1411,5.9
Hood County,2012-Nov,23893,22498,1395,5.8
Hood County,2012-Dec,23898,22454,1444,6
Hood County,2013-Jan,23714,22078,1636,6.9
Hood County,2013-Feb,23746,22220,1526,6.4
Hood County,2013-Mar,23658,22229,1429,6
Hood County,2013-Apr,23866,22496,1370,5.7
Hood County,2013-May,24040,22558,1482,6.2
Hood County,2013-Jun,24177,22556,1621,6.7
Hood County,2013-Jul,24187,22611,1576,6.5
Hood County,2013-Aug,24046,22570,1476,6.1
Hood County,2013-Sep,24158,22682,1476,6.1
Hood County,2013-Oct,23916,22539,1377,5.8
Hood County,2013-Nov,24062,22729,1333,5.5
Hood County,2013-Dec,24035,22779,1256,5.2
Hood County,2014-Jan,23832,22529,1303,5.5
Hood County,2014-Feb,24097,22757,1340,5.6
Hood County,2014-Mar,24168,22892,1276,5.3
Hood County,2014-Apr,24136,23032,1104,4.6
Hood County,2014-May,24273,23058,1215,5
Hood County,2014-Jun,24381,23088,1293,5.3
Hood County,2014-Jul,24378,23037,1341,5.5
Hood County,2014-Aug,24228,22966,1262,5.2
Hood County,2014-Sep,24285,23111,1174,4.8
Hood County,2014-Oct,24320,23224,1096,4.5
Hood County,2014-Nov,24355,23262,1093,4.5
Hood County,2014-Dec,24225,23213,1012,4.2
Hood County,2015-Jan,24282,23128,1154,4.8
Hood County,2015-Feb,24304,23195,1109,4.6
Hood County,2015-Mar,24311,23248,1063,4.4
Hood County,2015-Apr,24491,23479,1012,4.1
Hood County,2015-May,24661,23592,1069,4.3
Hood County,2015-Jun,24651,23483,1168,4.7
Hood County,2015-Jul,24656,23447,1209,4.9
Hood County,2015-Aug,24531,23414,1117,4.6
Hood County,2015-Sep,24554,23420,1134,4.6
Hood County,2015-Oct,24644,23518,1126,4.6
Hood County,2015-Nov,24726,23584,1142,4.6
Hood County,2015-Dec,24745,23658,1087,4.4
Hood County,2016-Jan,24757,23589,1168,4.7
Hood County,2016-Feb,25049,23891,1158,4.6
Hood County,2016-Mar,25183,23998,1185,4.7
Hood County,2016-Apr,25227,24146,1081,4.3
Hood County,2016-May,25283,24197,1086,4.3
Hood County,2016-Jun,25407,24127,1280,5
Hood County,2016-Jul,25414,24115,1299,5.1
Hood County,2016-Aug,25383,24134,1249,4.9
Hood County,2016-Sep,25370,24119,1251,4.9
Hood County,2016-Oct,25301,24137,1164,4.6
Hood County,2016-Nov,25464,24286,1178,4.6
Hood County,2016-Dec,25476,24297,1179,4.6
Hood County,2017-Jan,25412,24123,1289,5.1
Hood County,2017-Feb,25579,24309,1270,5
Hood County,2017-Mar,25636,24486,1150,4.5
Hood County,2017-Apr,25654,24605,1049,4.1
Hood County,2017-May,25623,24554,1069,4.2
Hood County,2017-Jun,25758,24622,1136,4.4
Hood County,2017-Jul,25804,24645,1159,4.5
Hood County,2017-Aug,25803,24693,1110,4.3
Hood County,2017-Sep,25864,24841,1023,4
Hood County,2017-Oct,25757,24852,905,3.5
Hood County,2017-Nov,25947,24963,984,3.8
Hood County,2017-Dec,25939,24990,949,3.7
Hood County,2018-Jan,26440,25359,1081,4.1
Hood County,2018-Feb,26715,25620,1095,4.1
Hood County,2018-Mar,26761,25716,1045,3.9
Hood County,2018-Apr,26752,25811,941,3.5
Hood County,2018-May,26769,25840,929,3.5
Hood County,2018-Jun,26889,25797,1092,4.1
Hood County,2018-Jul,26931,25844,1087,4
Hood County,2018-Aug,26771,25752,1019,3.8
Hood County,2018-Sep,26783,25831,952,3.6
Hood County,2018-Oct,26828,25939,889,3.3
Hood County,2018-Nov,26915,26005,910,3.4
Hood County,2018-Dec,26966,26049,917,3.4
Hood County,2019-Jan,27085,26027,1058,3.9
Hood County,2019-Feb,27239,26253,986,3.6
Hood County,2019-Mar,27255,26310,945,3.5
Hood County,2019-Apr,27077,26280,797,2.9
Hood County,2019-May,27121,26313,808,3
Hood County,2019-Jun,27348,26346,1002,3.7
Hood County,2019-Jul,27492,26460,1032,3.8
Hood County,2019-Aug,27549,26553,996,3.6
Hood County,2019-Sep,27591,26653,938,3.4
Hood County,2019-Oct,27667,26773,894,3.2
Hood County,2019-Nov,27825,26915,910,3.3
Hood County,2019-Dec,27825,26962,863,3.1
Hood County,2020-Jan,28185,27182,1003,3.6
Hood County,2020-Feb,28371,27415,956,3.4
Hood County,2020-Mar,27883,26450,1433,5.1
Hood County,2020-Apr,25720,23165,2555,9.9
Hood County,2020-May,26706,24128,2578,9.7
Hood County,2020-Jun,27449,24998,2451,8.9
Hood County,2020-Jul,27779,25470,2309,8.3
Hood County,2020-Aug,27943,26106,1837,6.6
Hood County,2020-Sep,27991,26155,1836,6.6
Hood County,2020-Oct,28362,26756,1606,5.7
Hood County,2020-Nov,28413,26723,1690,5.9
Hood County,2020-Dec,28531,26794,1737,6.1
Hood County,2021-Jan,28440,26570,1870,6.6
Hood County,2021-Feb,28593,26757,1836,6.4
Hood County,2021-Mar,28723,27024,1699,5.9
Hood County,2021-Apr,28540,27075,1465,5.1
Hood County,2021-May,28554,27075,1479,5.2
Hood County,2021-Jun,28721,27069,1652,5.8
Hood County,2021-Jul,28858,27342,1516,5.3
Hood County,2021-Aug,28922,27474,1448,5
Hood County,2021-Sep,28918,27584,1334,4.6
Hood County,2021-Oct,29011,27752,1259,4.3
Hood County,2021-Nov,29277,28065,1212,4.1
Hood County,2021-Dec,29217,28118,1099,3.8
Hood County,2022-Jan,29055,27799,1256,4.3
Hood County,2022-Feb,29515,28256,1259,4.3
Hood County,2022-Mar,29721,28664,1057,3.6
Hood County,2022-Apr,29501,28528,973,3.3
Hood County,2022-May,29576,28541,1035,3.5
Hood County,2022-Jun,29625,28464,1161,3.9
Hood County,2022-Jul,29884(P),28720(P),1164(P),3.9(P)
Hopkins County,2012-Jan,16654,15500,1154,6.9
Hopkins County,2012-Feb,16640,15511,1129,6.8
Hopkins County,2012-Mar,16770,15711,1059,6.3
Hopkins County,2012-Apr,16798,15785,1013,6
Hopkins County,2012-May,17001,15905,1096,6.4
Hopkins County,2012-Jun,17260,16026,1234,7.1
Hopkins County,2012-Jul,17140,15907,1233,7.2
Hopkins County,2012-Aug,17110,15972,1138,6.7
Hopkins County,2012-Sep,17366,16302,1064,6.1
Hopkins County,2012-Oct,17383,16345,1038,6
Hopkins County,2012-Nov,17338,16348,990,5.7
Hopkins County,2012-Dec,17074,16070,1004,5.9
Hopkins County,2013-Jan,17050,15953,1097,6.4
Hopkins County,2013-Feb,17057,16012,1045,6.1
Hopkins County,2013-Mar,17416,16443,973,5.6
Hopkins County,2013-Apr,17475,16543,932,5.3
Hopkins County,2013-May,17329,16332,997,5.8
Hopkins County,2013-Jun,17367,16246,1121,6.5
Hopkins County,2013-Jul,17360,16274,1086,6.3
Hopkins County,2013-Aug,17221,16188,1033,6
Hopkins County,2013-Sep,17302,16262,1040,6
Hopkins County,2013-Oct,17147,16195,952,5.6
Hopkins County,2013-Nov,17063,16169,894,5.2
Hopkins County,2013-Dec,17077,16233,844,4.9
Hopkins County,2014-Jan,17132,16220,912,5.3
Hopkins County,2014-Feb,17323,16390,933,5.4
Hopkins County,2014-Mar,17597,16720,877,5
Hopkins County,2014-Apr,17648,16880,768,4.4
Hopkins County,2014-May,17512,16697,815,4.7
Hopkins County,2014-Jun,17403,16521,882,5.1
Hopkins County,2014-Jul,17373,16464,909,5.2
Hopkins County,2014-Aug,17240,16368,872,5.1
Hopkins County,2014-Sep,17782,16958,824,4.6
Hopkins County,2014-Oct,17808,17053,755,4.2
Hopkins County,2014-Nov,17577,16830,747,4.2
Hopkins County,2014-Dec,17187,16522,665,3.9
Hopkins County,2015-Jan,17096,16335,761,4.5
Hopkins County,2015-Feb,17113,16350,763,4.5
Hopkins County,2015-Mar,17071,16318,753,4.4
Hopkins County,2015-Apr,17178,16486,692,4
Hopkins County,2015-May,17156,16431,725,4.2
Hopkins County,2015-Jun,17092,16304,788,4.6
Hopkins County,2015-Jul,16862,16082,780,4.6
Hopkins County,2015-Aug,16738,16029,709,4.2
Hopkins County,2015-Sep,16980,16283,697,4.1
Hopkins County,2015-Oct,17050,16373,677,4
Hopkins County,2015-Nov,16998,16324,674,4
Hopkins County,2015-Dec,16898,16262,636,3.8
Hopkins County,2016-Jan,16990,16310,680,4
Hopkins County,2016-Feb,17280,16615,665,3.8
Hopkins County,2016-Mar,17394,16720,674,3.9
Hopkins County,2016-Apr,17384,16750,634,3.6
Hopkins County,2016-May,17429,16792,637,3.7
Hopkins County,2016-Jun,17410,16662,748,4.3
Hopkins County,2016-Jul,17340,16574,766,4.4
Hopkins County,2016-Aug,17306,16567,739,4.3
Hopkins County,2016-Sep,17377,16655,722,4.2
Hopkins County,2016-Oct,17372,16678,694,4
Hopkins County,2016-Nov,17457,16785,672,3.8
Hopkins County,2016-Dec,17233,16560,673,3.9
Hopkins County,2017-Jan,17067,16336,731,4.3
Hopkins County,2017-Feb,17176,16463,713,4.2
Hopkins County,2017-Mar,17396,16717,679,3.9
Hopkins County,2017-Apr,17184,16577,607,3.5
Hopkins County,2017-May,17046,16443,603,3.5
Hopkins County,2017-Jun,17003,16354,649,3.8
Hopkins County,2017-Jul,16914,16271,643,3.8
Hopkins County,2017-Aug,16905,16286,619,3.7
Hopkins County,2017-Sep,16972,16411,561,3.3
Hopkins County,2017-Oct,16923,16414,509,3
Hopkins County,2017-Nov,16948,16384,564,3.3
Hopkins County,2017-Dec,16959,16419,540,3.2
Hopkins County,2018-Jan,16897,16299,598,3.5
Hopkins County,2018-Feb,17112,16468,644,3.8
Hopkins County,2018-Mar,17328,16708,620,3.6
Hopkins County,2018-Apr,17268,16692,576,3.3
Hopkins County,2018-May,17270,16724,546,3.2
Hopkins County,2018-Jun,17287,16648,639,3.7
Hopkins County,2018-Jul,17102,16493,609,3.6
Hopkins County,2018-Aug,17088,16494,594,3.5
Hopkins County,2018-Sep,17159,16586,573,3.3
Hopkins County,2018-Oct,17065,16529,536,3.1
Hopkins County,2018-Nov,17189,16652,537,3.1
Hopkins County,2018-Dec,17098,16559,539,3.2
Hopkins County,2019-Jan,17098,16471,627,3.7
Hopkins County,2019-Feb,17236,16655,581,3.4
Hopkins County,2019-Mar,17338,16775,563,3.2
Hopkins County,2019-Apr,17178,16710,468,2.7
Hopkins County,2019-May,17326,16855,471,2.7
Hopkins County,2019-Jun,17324,16772,552,3.2
Hopkins County,2019-Jul,17323,16753,570,3.3
Hopkins County,2019-Aug,17401,16846,555,3.2
Hopkins County,2019-Sep,17377,16871,506,2.9
Hopkins County,2019-Oct,17558,17058,500,2.8
Hopkins County,2019-Nov,17470,16965,505,2.9
Hopkins County,2019-Dec,17409,16934,475,2.7
Hopkins County,2020-Jan,17474,16934,540,3.1
Hopkins County,2020-Feb,17480,16954,526,3
Hopkins County,2020-Mar,17215,16426,789,4.6
Hopkins County,2020-Apr,16354,15150,1204,7.4
Hopkins County,2020-May,16778,15623,1155,6.9
Hopkins County,2020-Jun,17087,15960,1127,6.6
Hopkins County,2020-Jul,17312,16256,1056,6.1
Hopkins County,2020-Aug,17415,16548,867,5
Hopkins County,2020-Sep,17580,16704,876,5
Hopkins County,2020-Oct,17765,16974,791,4.5
Hopkins County,2020-Nov,17812,16977,835,4.7
Hopkins County,2020-Dec,17739,16885,854,4.8
Hopkins County,2021-Jan,17667,16759,908,5.1
Hopkins County,2021-Feb,17865,16964,901,5
Hopkins County,2021-Mar,17929,17065,864,4.8
Hopkins County,2021-Apr,17781,16998,783,4.4
Hopkins County,2021-May,17786,17017,769,4.3
Hopkins County,2021-Jun,17720,16836,884,5
Hopkins County,2021-Jul,17673,16883,790,4.5
Hopkins County,2021-Aug,17796,17035,761,4.3
Hopkins County,2021-Sep,17940,17228,712,4
Hopkins County,2021-Oct,17952,17275,677,3.8
Hopkins County,2021-Nov,17980,17337,643,3.6
Hopkins County,2021-Dec,17848,17265,583,3.3
Hopkins County,2022-Jan,17845,17174,671,3.8
Hopkins County,2022-Feb,18097,17413,684,3.8
Hopkins County,2022-Mar,18258,17702,556,3
Hopkins County,2022-Apr,18045,17531,514,2.8
Hopkins County,2022-May,18103,17545,558,3.1
Hopkins County,2022-Jun,17975,17347,628,3.5
Hopkins County,2022-Jul,18062(P),17458(P),604(P),3.3(P)
Houston County,2012-Jan,10259,9444,815,7.9
Houston County,2012-Feb,10107,9328,779,7.7
Houston County,2012-Mar,10085,9352,733,7.3
Houston County,2012-Apr,10094,9424,670,6.6
Houston County,2012-May,10120,9429,691,6.8
Houston County,2012-Jun,10231,9465,766,7.5
Houston County,2012-Jul,10169,9410,759,7.5
Houston County,2012-Aug,10047,9342,705,7
Houston County,2012-Sep,9975,9318,657,6.6
Houston County,2012-Oct,9901,9259,642,6.5
Houston County,2012-Nov,9891,9279,612,6.2
Houston County,2012-Dec,9743,9117,626,6.4
Houston County,2013-Jan,9806,9118,688,7
Houston County,2013-Feb,9826,9172,654,6.7
Houston County,2013-Mar,9815,9177,638,6.5
Houston County,2013-Apr,9838,9240,598,6.1
Houston County,2013-May,9881,9272,609,6.2
Houston County,2013-Jun,10035,9346,689,6.9
Houston County,2013-Jul,10009,9329,680,6.8
Houston County,2013-Aug,9868,9247,621,6.3
Houston County,2013-Sep,9735,9127,608,6.2
Houston County,2013-Oct,9727,9166,561,5.8
Houston County,2013-Nov,9728,9191,537,5.5
Houston County,2013-Dec,9690,9190,500,5.2
Houston County,2014-Jan,9580,9055,525,5.5
Houston County,2014-Feb,9588,9059,529,5.5
Houston County,2014-Mar,9619,9096,523,5.4
Houston County,2014-Apr,9636,9197,439,4.6
Houston County,2014-May,9762,9273,489,5
Houston County,2014-Jun,9929,9398,531,5.3
Houston County,2014-Jul,10010,9459,551,5.5
Houston County,2014-Aug,9924,9406,518,5.2
Houston County,2014-Sep,9805,9328,477,4.9
Houston County,2014-Oct,9905,9457,448,4.5
Houston County,2014-Nov,9930,9483,447,4.5
Houston County,2014-Dec,9768,9358,410,4.2
Houston County,2015-Jan,9509,9037,472,5
Houston County,2015-Feb,9603,9161,442,4.6
Houston County,2015-Mar,9617,9177,440,4.6
Houston County,2015-Apr,9939,9536,403,4.1
Houston County,2015-May,9947,9525,422,4.2
Houston County,2015-Jun,10207,9723,484,4.7
Houston County,2015-Jul,10158,9691,467,4.6
Houston County,2015-Aug,10149,9694,455,4.5
Houston County,2015-Sep,10017,9586,431,4.3
Houston County,2015-Oct,10015,9589,426,4.3
Houston County,2015-Nov,10084,9616,468,4.6
Houston County,2015-Dec,10047,9604,443,4.4
Houston County,2016-Jan,9854,9401,453,4.6
Houston County,2016-Feb,9981,9526,455,4.6
Houston County,2016-Mar,10010,9531,479,4.8
Houston County,2016-Apr,10094,9675,419,4.2
Houston County,2016-May,10086,9668,418,4.1
Houston County,2016-Jun,10134,9661,473,4.7
Houston County,2016-Jul,10150,9636,514,5.1
Houston County,2016-Aug,10337,9848,489,4.7
Houston County,2016-Sep,10111,9619,492,4.9
Houston County,2016-Oct,10089,9633,456,4.5
Houston County,2016-Nov,9977,9515,462,4.6
Houston County,2016-Dec,9984,9510,474,4.7
Houston County,2017-Jan,10051,9565,486,4.8
Houston County,2017-Feb,10174,9692,482,4.7
Houston County,2017-Mar,10352,9920,432,4.2
Houston County,2017-Apr,10329,9928,401,3.9
Houston County,2017-May,10309,9908,401,3.9
Houston County,2017-Jun,10594,10148,446,4.2
Houston County,2017-Jul,10323,9794,529,5.1
Houston County,2017-Aug,10458,9948,510,4.9
Houston County,2017-Sep,10476,10032,444,4.2
Houston County,2017-Oct,10318,9896,422,4.1
Houston County,2017-Nov,10266,9829,437,4.3
Houston County,2017-Dec,10069,9651,418,4.2
Houston County,2018-Jan,9776,9317,459,4.7
Houston County,2018-Feb,10020,9578,442,4.4
Houston County,2018-Mar,10159,9730,429,4.2
Houston County,2018-Apr,10089,9716,373,3.7
Houston County,2018-May,10143,9791,352,3.5
Houston County,2018-Jun,10215,9796,419,4.1
Houston County,2018-Jul,10241,9848,393,3.8
Houston County,2018-Aug,10168,9793,375,3.7
Houston County,2018-Sep,10062,9714,348,3.5
Houston County,2018-Oct,10098,9784,314,3.1
Houston County,2018-Nov,10145,9819,326,3.2
Houston County,2018-Dec,10124,9793,331,3.3
Houston County,2019-Jan,9956,9586,370,3.7
Houston County,2019-Feb,10014,9696,318,3.2
Houston County,2019-Mar,10038,9727,311,3.1
Houston County,2019-Apr,9909,9655,254,2.6
Houston County,2019-May,10078,9813,265,2.6
Houston County,2019-Jun,10294,9936,358,3.5
Houston County,2019-Jul,10484,10122,362,3.5
Houston County,2019-Aug,10452,10100,352,3.4
Houston County,2019-Sep,10294,9986,308,3
Houston County,2019-Oct,10206,9896,310,3
Houston County,2019-Nov,10082,9773,309,3.1
Houston County,2019-Dec,10090,9793,297,2.9
Houston County,2020-Jan,9876,9535,341,3.5
Houston County,2020-Feb,9961,9646,315,3.2
Houston County,2020-Mar,9919,9400,519,5.2
Houston County,2020-Apr,9232,8692,540,5.8
Houston County,2020-May,9577,8955,622,6.5
Houston County,2020-Jun,9965,9319,646,6.5
Houston County,2020-Jul,10079,9460,619,6.1
Houston County,2020-Aug,10263,9755,508,4.9
Houston County,2020-Sep,10139,9621,518,5.1
Houston County,2020-Oct,10304,9800,504,4.9
Houston County,2020-Nov,10339,9788,551,5.3
Houston County,2020-Dec,10363,9756,607,5.9
Houston County,2021-Jan,10214,9588,626,6.1
Houston County,2021-Feb,10307,9688,619,6
Houston County,2021-Mar,10426,9868,558,5.4
Houston County,2021-Apr,10490,9989,501,4.8
Houston County,2021-May,10528,10040,488,4.6
Houston County,2021-Jun,10632,10052,580,5.5
Houston County,2021-Jul,10798,10267,531,4.9
Houston County,2021-Aug,10831,10315,516,4.8
Houston County,2021-Sep,10750,10284,466,4.3
Houston County,2021-Oct,10678,10233,445,4.2
Houston County,2021-Nov,10676,10249,427,4
Houston County,2021-Dec,10638,10238,400,3.8
Houston County,2022-Jan,10463,10008,455,4.3
Houston County,2022-Feb,10610,10161,449,4.2
Houston County,2022-Mar,10784,10417,367,3.4
Houston County,2022-Apr,10569,10247,322,3
Houston County,2022-May,10658,10311,347,3.3
Houston County,2022-Jun,10797,10388,409,3.8
Houston County,2022-Jul,10989(P),10586(P),403(P),3.7(P)
Howard County,2012-Jan,13210,12407,803,6.1
Howard County,2012-Feb,13173,12416,757,5.7
Howard County,2012-Mar,13197,12469,728,5.5
Howard County,2012-Apr,13287,12598,689,5.2
Howard County,2012-May,13278,12541,737,5.6
Howard County,2012-Jun,13384,12524,860,6.4
Howard County,2012-Jul,13638,12777,861,6.3
Howard County,2012-Aug,13393,12617,776,5.8
Howard County,2012-Sep,13413,12712,701,5.2
Howard County,2012-Oct,13558,12862,696,5.1
Howard County,2012-Nov,13465,12803,662,4.9
Howard County,2012-Dec,13453,12778,675,5
Howard County,2013-Jan,13477,12694,783,5.8
Howard County,2013-Feb,13458,12715,743,5.5
Howard County,2013-Mar,13455,12744,711,5.3
Howard County,2013-Apr,13615,12944,671,4.9
Howard County,2013-May,13671,12931,740,5.4
Howard County,2013-Jun,13694,12862,832,6.1
Howard County,2013-Jul,13650,12835,815,6
Howard County,2013-Aug,13550,12792,758,5.6
Howard County,2013-Sep,13602,12857,745,5.5
Howard County,2013-Oct,13440,12727,713,5.3
Howard County,2013-Nov,13466,12793,673,5
Howard County,2013-Dec,13447,12795,652,4.8
Howard County,2014-Jan,13601,12928,673,4.9
Howard County,2014-Feb,13597,12909,688,5.1
Howard County,2014-Mar,13602,12947,655,4.8
Howard County,2014-Apr,13484,12943,541,4
Howard County,2014-May,13528,12931,597,4.4
Howard County,2014-Jun,13634,12988,646,4.7
Howard County,2014-Jul,13688,13016,672,4.9
Howard County,2014-Aug,13581,12954,627,4.6
Howard County,2014-Sep,13624,13040,584,4.3
Howard County,2014-Oct,13482,12945,537,4
Howard County,2014-Nov,13559,13023,536,4
Howard County,2014-Dec,13477,13006,471,3.5
Howard County,2015-Jan,13586,12997,589,4.3
Howard County,2015-Feb,13549,12960,589,4.3
Howard County,2015-Mar,13570,12975,595,4.4
Howard County,2015-Apr,13509,12937,572,4.2
Howard County,2015-May,13478,12859,619,4.6
Howard County,2015-Jun,13330,12658,672,5
Howard County,2015-Jul,13301,12634,667,5
Howard County,2015-Aug,13189,12563,626,4.7
Howard County,2015-Sep,13222,12596,626,4.7
Howard County,2015-Oct,13181,12558,623,4.7
Howard County,2015-Nov,13202,12567,635,4.8
Howard County,2015-Dec,13218,12595,623,4.7
Howard County,2016-Jan,13237,12586,651,4.9
Howard County,2016-Feb,13446,12769,677,5
Howard County,2016-Mar,13456,12721,735,5.5
Howard County,2016-Apr,13355,12644,711,5.3
Howard County,2016-May,13290,12581,709,5.3
Howard County,2016-Jun,13254,12470,784,5.9
Howard County,2016-Jul,13271,12489,782,5.9
Howard County,2016-Aug,13175,12405,770,5.8
Howard County,2016-Sep,13023,12257,766,5.9
Howard County,2016-Oct,13037,12278,759,5.8
Howard County,2016-Nov,13098,12360,738,5.6
Howard County,2016-Dec,12974,12267,707,5.4
Howard County,2017-Jan,13074,12357,717,5.5
Howard County,2017-Feb,13081,12376,705,5.4
Howard County,2017-Mar,13180,12549,631,4.8
Howard County,2017-Apr,13120,12546,574,4.4
Howard County,2017-May,13100,12542,558,4.3
Howard County,2017-Jun,13086,12496,590,4.5
Howard County,2017-Jul,13227,12652,575,4.3
Howard County,2017-Aug,13175,12612,563,4.3
Howard County,2017-Sep,13093,12591,502,3.8
Howard County,2017-Oct,13035,12584,451,3.5
Howard County,2017-Nov,13075,12607,468,3.6
Howard County,2017-Dec,13226,12789,437,3.3
Howard County,2018-Jan,13302,12815,487,3.7
Howard County,2018-Feb,13340,12854,486,3.6
Howard County,2018-Mar,13575,13063,512,3.8
Howard County,2018-Apr,13412,12994,418,3.1
Howard County,2018-May,13374,12972,402,3
Howard County,2018-Jun,13501,12993,508,3.8
Howard County,2018-Jul,13538,13041,497,3.7
Howard County,2018-Aug,13466,13022,444,3.3
Howard County,2018-Sep,13526,13104,422,3.1
Howard County,2018-Oct,13437,13042,395,2.9
Howard County,2018-Nov,13555,13161,394,2.9
Howard County,2018-Dec,13546,13152,394,2.9
Howard County,2019-Jan,13802,13349,453,3.3
Howard County,2019-Feb,13827,13406,421,3
Howard County,2019-Mar,13793,13352,441,3.2
Howard County,2019-Apr,13685,13327,358,2.6
Howard County,2019-May,13726,13361,365,2.7
Howard County,2019-Jun,13888,13425,463,3.3
Howard County,2019-Jul,13901,13419,482,3.5
Howard County,2019-Aug,13956,13502,454,3.3
Howard County,2019-Sep,13896,13459,437,3.1
Howard County,2019-Oct,13957,13517,440,3.2
Howard County,2019-Nov,13948,13523,425,3
Howard County,2019-Dec,13894,13487,407,2.9
Howard County,2020-Jan,13937,13487,450,3.2
Howard County,2020-Feb,13923,13503,420,3
Howard County,2020-Mar,13649,12979,670,4.9
Howard County,2020-Apr,12573,11338,1235,9.8
Howard County,2020-May,13109,11593,1516,11.6
Howard County,2020-Jun,13317,11793,1524,11.4
Howard County,2020-Jul,13280,11804,1476,11.1
Howard County,2020-Aug,13249,12026,1223,9.2
Howard County,2020-Sep,13229,12034,1195,9
Howard County,2020-Oct,13291,12196,1095,8.2
Howard County,2020-Nov,13308,12200,1108,8.3
Howard County,2020-Dec,13232,12136,1096,8.3
Howard County,2021-Jan,13237,12150,1087,8.2
Howard County,2021-Feb,13311,12250,1061,8
Howard County,2021-Mar,13196,12234,962,7.3
Howard County,2021-Apr,13109,12235,874,6.7
Howard County,2021-May,13599,12762,837,6.2
Howard County,2021-Jun,13598,12634,964,7.1
Howard County,2021-Jul,13116,12235,881,6.7
Howard County,2021-Aug,13092,12269,823,6.3
Howard County,2021-Sep,13210,12439,771,5.8
Howard County,2021-Oct,13230,12468,762,5.8
Howard County,2021-Nov,13223,12517,706,5.3
Howard County,2021-Dec,13152,12483,669,5.1
Howard County,2022-Jan,13437,12528,909,6.8
Howard County,2022-Feb,13514,12620,894,6.6
Howard County,2022-Mar,13429,12702,727,5.4
Howard County,2022-Apr,13410,12758,652,4.9
Howard County,2022-May,13416,12756,660,4.9
Howard County,2022-Jun,13516,12745,771,5.7
Howard County,2022-Jul,13379(P),12619(P),760(P),5.7(P)
Hudspeth County,2012-Jan,1305,1202,103,7.9
Hudspeth County,2012-Feb,1297,1196,101,7.8
Hudspeth County,2012-Mar,1309,1213,96,7.3
Hudspeth County,2012-Apr,1326,1236,90,6.8
Hudspeth County,2012-May,1339,1237,102,7.6
Hudspeth County,2012-Jun,1352,1241,111,8.2
Hudspeth County,2012-Jul,1348,1237,111,8.2
Hudspeth County,2012-Aug,1327,1227,100,7.5
Hudspeth County,2012-Sep,1334,1240,94,7
Hudspeth County,2012-Oct,1319,1230,89,6.7
Hudspeth County,2012-Nov,1314,1227,87,6.6
Hudspeth County,2012-Dec,1299,1210,89,6.9
Hudspeth County,2013-Jan,1267,1166,101,8
Hudspeth County,2013-Feb,1266,1173,93,7.3
Hudspeth County,2013-Mar,1264,1168,96,7.6
Hudspeth County,2013-Apr,1293,1200,93,7.2
Hudspeth County,2013-May,1307,1216,91,7
Hudspeth County,2013-Jun,1318,1218,100,7.6
Hudspeth County,2013-Jul,1318,1225,93,7.1
Hudspeth County,2013-Aug,1291,1202,89,6.9
Hudspeth County,2013-Sep,1306,1219,87,6.7
Hudspeth County,2013-Oct,1306,1218,88,6.7
Hudspeth County,2013-Nov,1274,1194,80,6.3
Hudspeth County,2013-Dec,1290,1212,78,6
Hudspeth County,2014-Jan,1230,1149,81,6.6
Hudspeth County,2014-Feb,1260,1174,86,6.8
Hudspeth County,2014-Mar,1269,1180,89,7
Hudspeth County,2014-Apr,1278,1194,84,6.6
Hudspeth County,2014-May,1286,1200,86,6.7
Hudspeth County,2014-Jun,1275,1189,86,6.7
Hudspeth County,2014-Jul,1256,1174,82,6.5
Hudspeth County,2014-Aug,1238,1157,81,6.5
Hudspeth County,2014-Sep,1244,1167,77,6.2
Hudspeth County,2014-Oct,1236,1165,71,5.7
Hudspeth County,2014-Nov,1221,1150,71,5.8
Hudspeth County,2014-Dec,1204,1139,65,5.4
Hudspeth County,2015-Jan,1264,1185,79,6.3
Hudspeth County,2015-Feb,1289,1213,76,5.9
Hudspeth County,2015-Mar,1304,1231,73,5.6
Hudspeth County,2015-Apr,1287,1222,65,5.1
Hudspeth County,2015-May,1303,1238,65,5
Hudspeth County,2015-Jun,1297,1227,70,5.4
Hudspeth County,2015-Jul,1284,1203,81,6.3
Hudspeth County,2015-Aug,1263,1187,76,6
Hudspeth County,2015-Sep,1275,1203,72,5.6
Hudspeth County,2015-Oct,1278,1208,70,5.5
Hudspeth County,2015-Nov,1263,1191,72,5.7
Hudspeth County,2015-Dec,1268,1197,71,5.6
Hudspeth County,2016-Jan,1486,1397,89,6
Hudspeth County,2016-Feb,1550,1462,88,5.7
Hudspeth County,2016-Mar,1572,1482,90,5.7
Hudspeth County,2016-Apr,1575,1489,86,5.5
Hudspeth County,2016-May,1600,1511,89,5.6
Hudspeth County,2016-Jun,1566,1464,102,6.5
Hudspeth County,2016-Jul,1529,1425,104,6.8
Hudspeth County,2016-Aug,1544,1448,96,6.2
Hudspeth County,2016-Sep,1534,1442,92,6
Hudspeth County,2016-Oct,1521,1431,90,5.9
Hudspeth County,2016-Nov,1514,1427,87,5.7
Hudspeth County,2016-Dec,1512,1420,92,6.1
Hudspeth County,2017-Jan,1622,1514,108,6.7
Hudspeth County,2017-Feb,1660,1548,112,6.7
Hudspeth County,2017-Mar,1705,1602,103,6
Hudspeth County,2017-Apr,1700,1600,100,5.9
Hudspeth County,2017-May,1692,1600,92,5.4
Hudspeth County,2017-Jun,1666,1564,102,6.1
Hudspeth County,2017-Jul,1623,1513,110,6.8
Hudspeth County,2017-Aug,1637,1541,96,5.9
Hudspeth County,2017-Sep,1622,1536,86,5.3
Hudspeth County,2017-Oct,1640,1563,77,4.7
Hudspeth County,2017-Nov,1627,1542,85,5.2
Hudspeth County,2017-Dec,1627,1549,78,4.8
Hudspeth County,2018-Jan,1743,1657,86,4.9
Hudspeth County,2018-Feb,1780,1688,92,5.2
Hudspeth County,2018-Mar,1825,1737,88,4.8
Hudspeth County,2018-Apr,1792,1712,80,4.5
Hudspeth County,2018-May,1822,1742,80,4.4
Hudspeth County,2018-Jun,1788,1700,88,4.9
Hudspeth County,2018-Jul,1767,1679,88,5
Hudspeth County,2018-Aug,1802,1717,85,4.7
Hudspeth County,2018-Sep,1790,1712,78,4.4
Hudspeth County,2018-Oct,1785,1710,75,4.2
Hudspeth County,2018-Nov,1777,1703,74,4.2
Hudspeth County,2018-Dec,1749,1675,74,4.2
Hudspeth County,2019-Jan,1789,1697,92,5.1
Hudspeth County,2019-Feb,1811,1735,76,4.2
Hudspeth County,2019-Mar,1847,1772,75,4.1
Hudspeth County,2019-Apr,1824,1757,67,3.7
Hudspeth County,2019-May,1844,1773,71,3.9
Hudspeth County,2019-Jun,1824,1741,83,4.6
Hudspeth County,2019-Jul,1832,1744,88,4.8
Hudspeth County,2019-Aug,1883,1795,88,4.7
Hudspeth County,2019-Sep,1864,1774,90,4.8
Hudspeth County,2019-Oct,1881,1801,80,4.3
Hudspeth County,2019-Nov,1838,1760,78,4.2
Hudspeth County,2019-Dec,1845,1773,72,3.9
Hudspeth County,2020-Jan,1834,1756,78,4.3
Hudspeth County,2020-Feb,1853,1780,73,3.9
Hudspeth County,2020-Mar,1844,1736,108,5.9
Hudspeth County,2020-Apr,1713,1532,181,10.6
Hudspeth County,2020-May,1782,1575,207,11.6
Hudspeth County,2020-Jun,1817,1622,195,10.7
Hudspeth County,2020-Jul,1850,1656,194,10.5
Hudspeth County,2020-Aug,1873,1721,152,8.1
Hudspeth County,2020-Sep,1839,1703,136,7.4
Hudspeth County,2020-Oct,1890,1745,145,7.7
Hudspeth County,2020-Nov,1850,1695,155,8.4
Hudspeth County,2020-Dec,1860,1701,159,8.5
Hudspeth County,2021-Jan,1862,1714,148,7.9
Hudspeth County,2021-Feb,1886,1758,128,6.8
Hudspeth County,2021-Mar,1924,1797,127,6.6
Hudspeth County,2021-Apr,1881,1772,109,5.8
Hudspeth County,2021-May,1840,1739,101,5.5
Hudspeth County,2021-Jun,1834,1710,124,6.8
Hudspeth County,2021-Jul,1824,1724,100,5.5
Hudspeth County,2021-Aug,1844,1748,96,5.2
Hudspeth County,2021-Sep,1845,1752,93,5
Hudspeth County,2021-Oct,1838,1748,90,4.9
Hudspeth County,2021-Nov,1813,1725,88,4.9
Hudspeth County,2021-Dec,1791,1713,78,4.4
Hudspeth County,2022-Jan,1808,1722,86,4.8
Hudspeth County,2022-Feb,1892,1805,87,4.6
Hudspeth County,2022-Mar,1929,1857,72,3.7
Hudspeth County,2022-Apr,1907,1837,70,3.7
Hudspeth County,2022-May,1860,1786,74,4
Hudspeth County,2022-Jun,1847,1767,80,4.3
Hudspeth County,2022-Jul,1908(P),1827(P),81(P),4.2(P)
Hunt County,2012-Jan,37819,34587,3232,8.5
Hunt County,2012-Feb,37931,34790,3141,8.3
Hunt County,2012-Mar,37930,34931,2999,7.9
Hunt County,2012-Apr,38119,35145,2974,7.8
Hunt County,2012-May,38362,35148,3214,8.4
Hunt County,2012-Jun,38686,35144,3542,9.2
Hunt County,2012-Jul,38694,35163,3531,9.1
Hunt County,2012-Aug,38438,35121,3317,8.6
Hunt County,2012-Sep,38511,35406,3105,8.1
Hunt County,2012-Oct,38538,35522,3016,7.8
Hunt County,2012-Nov,38476,35607,2869,7.5
Hunt County,2012-Dec,38412,35509,2903,7.6
Hunt County,2013-Jan,37706,34520,3186,8.4
Hunt County,2013-Feb,37678,34671,3007,8
Hunt County,2013-Mar,37640,34737,2903,7.7
Hunt County,2013-Apr,37828,35075,2753,7.3
Hunt County,2013-May,38058,35137,2921,7.7
Hunt County,2013-Jun,38373,35199,3174,8.3
Hunt County,2013-Jul,38469,35411,3058,7.9
Hunt County,2013-Aug,38311,35444,2867,7.5
Hunt County,2013-Sep,38357,35571,2786,7.3
Hunt County,2013-Oct,38172,35476,2696,7.1
Hunt County,2013-Nov,38446,35879,2567,6.7
Hunt County,2013-Dec,38273,35893,2380,6.2
Hunt County,2014-Jan,37947,35483,2464,6.5
Hunt County,2014-Feb,38207,35663,2544,6.7
Hunt County,2014-Mar,38296,35850,2446,6.4
Hunt County,2014-Apr,38218,36114,2104,5.5
Hunt County,2014-May,38360,36096,2264,5.9
Hunt County,2014-Jun,38606,36174,2432,6.3
Hunt County,2014-Jul,38782,36305,2477,6.4
Hunt County,2014-Aug,38663,36279,2384,6.2
Hunt County,2014-Sep,38774,36441,2333,6
Hunt County,2014-Oct,38819,36639,2180,5.6
Hunt County,2014-Nov,38920,36787,2133,5.5
Hunt County,2014-Dec,38675,36732,1943,5
Hunt County,2015-Jan,38471,36313,2158,5.6
Hunt County,2015-Feb,38447,36492,1955,5.1
Hunt County,2015-Mar,38359,36531,1828,4.8
Hunt County,2015-Apr,38665,36972,1693,4.4
Hunt County,2015-May,38839,37047,1792,4.6
Hunt County,2015-Jun,39084,37070,2014,5.2
Hunt County,2015-Jul,39186,37200,1986,5.1
Hunt County,2015-Aug,39096,37229,1867,4.8
Hunt County,2015-Sep,39019,37198,1821,4.7
Hunt County,2015-Oct,39185,37433,1752,4.5
Hunt County,2015-Nov,39370,37632,1738,4.4
Hunt County,2015-Dec,39393,37731,1662,4.2
Hunt County,2016-Jan,39704,37934,1770,4.5
Hunt County,2016-Feb,40088,38364,1724,4.3
Hunt County,2016-Mar,40162,38436,1726,4.3
Hunt County,2016-Apr,40247,38667,1580,3.9
Hunt County,2016-May,40277,38715,1562,3.9
Hunt County,2016-Jun,40625,38725,1900,4.7
Hunt County,2016-Jul,40813,38880,1933,4.7
Hunt County,2016-Aug,40794,38945,1849,4.5
Hunt County,2016-Sep,40785,38990,1795,4.4
Hunt County,2016-Oct,40840,39148,1692,4.1
Hunt County,2016-Nov,41033,39369,1664,4.1
Hunt County,2016-Dec,41016,39342,1674,4.1
Hunt County,2017-Jan,40533,38699,1834,4.5
Hunt County,2017-Feb,40846,38976,1870,4.6
Hunt County,2017-Mar,40911,39104,1807,4.4
Hunt County,2017-Apr,40920,39384,1536,3.8
Hunt County,2017-May,40798,39245,1553,3.8
Hunt County,2017-Jun,41102,39333,1769,4.3
Hunt County,2017-Jul,41237,39489,1748,4.2
Hunt County,2017-Aug,41201,39492,1709,4.1
Hunt County,2017-Sep,41321,39757,1564,3.8
Hunt County,2017-Oct,41204,39750,1454,3.5
Hunt County,2017-Nov,41460,39948,1512,3.6
Hunt County,2017-Dec,41360,39893,1467,3.5
Hunt County,2018-Jan,41564,39914,1650,4
Hunt County,2018-Feb,41918,40259,1659,4
Hunt County,2018-Mar,41881,40234,1647,3.9
Hunt County,2018-Apr,41888,40399,1489,3.6
Hunt County,2018-May,41882,40392,1490,3.6
Hunt County,2018-Jun,42236,40441,1795,4.2
Hunt County,2018-Jul,42336,40613,1723,4.1
Hunt County,2018-Aug,42076,40414,1662,3.9
Hunt County,2018-Sep,42121,40511,1610,3.8
Hunt County,2018-Oct,42289,40746,1543,3.6
Hunt County,2018-Nov,42477,40924,1553,3.7
Hunt County,2018-Dec,42463,40909,1554,3.7
Hunt County,2019-Jan,42659,40884,1775,4.2
Hunt County,2019-Feb,42821,41183,1638,3.8
Hunt County,2019-Mar,42724,41186,1538,3.6
Hunt County,2019-Apr,42672,41348,1324,3.1
Hunt County,2019-May,42744,41343,1401,3.3
Hunt County,2019-Jun,43143,41469,1674,3.9
Hunt County,2019-Jul,43421,41717,1704,3.9
Hunt County,2019-Aug,43411,41789,1622,3.7
Hunt County,2019-Sep,43454,41943,1511,3.5
Hunt County,2019-Oct,43754,42269,1485,3.4
Hunt County,2019-Nov,43869,42402,1467,3.3
Hunt County,2019-Dec,43820,42423,1397,3.2
Hunt County,2020-Jan,43470,41919,1551,3.6
Hunt County,2020-Feb,43739,42252,1487,3.4
Hunt County,2020-Mar,42989,40656,2333,5.4
Hunt County,2020-Apr,40020,35918,4102,10.2
Hunt County,2020-May,41435,37340,4095,9.9
Hunt County,2020-Jun,42373,38523,3850,9.1
Hunt County,2020-Jul,42743,39262,3481,8.1
Hunt County,2020-Aug,43224,40413,2811,6.5
Hunt County,2020-Sep,43300,40606,2694,6.2
Hunt County,2020-Oct,43794,41410,2384,5.4
Hunt County,2020-Nov,44046,41505,2541,5.8
Hunt County,2020-Dec,44153,41569,2584,5.9
Hunt County,2021-Jan,44120,41350,2770,6.3
Hunt County,2021-Feb,44456,41698,2758,6.2
Hunt County,2021-Mar,44447,41841,2606,5.9
Hunt County,2021-Apr,44491,42169,2322,5.2
Hunt County,2021-May,44543,42229,2314,5.2
Hunt County,2021-Jun,44789,42163,2626,5.9
Hunt County,2021-Jul,45021,42656,2365,5.3
Hunt County,2021-Aug,45094,42880,2214,4.9
Hunt County,2021-Sep,45162,43073,2089,4.6
Hunt County,2021-Oct,45413,43412,2001,4.4
Hunt County,2021-Nov,45860,43967,1893,4.1
Hunt County,2021-Dec,45731,43986,1745,3.8
Hunt County,2022-Jan,45920,43900,2020,4.4
Hunt County,2022-Feb,46494,44455,2039,4.4
Hunt County,2022-Mar,46598,44928,1670,3.6
Hunt County,2022-Apr,46587,45041,1546,3.3
Hunt County,2022-May,46867,45244,1623,3.5
Hunt County,2022-Jun,47081,45158,1923,4.1
Hunt County,2022-Jul,47136(P),45258(P),1878(P),4.0(P)
Hutchinson County,2012-Jan,9712,9037,675,7
Hutchinson County,2012-Feb,9807,9154,653,6.7
Hutchinson County,2012-Mar,9824,9199,625,6.4
Hutchinson County,2012-Apr,9782,9181,601,6.1
Hutchinson County,2012-May,9836,9192,644,6.5
Hutchinson County,2012-Jun,9918,9212,706,7.1
Hutchinson County,2012-Jul,9946,9236,710,7.1
Hutchinson County,2012-Aug,9745,9076,669,6.9
Hutchinson County,2012-Sep,9727,9124,603,6.2
Hutchinson County,2012-Oct,9849,9278,571,5.8
Hutchinson County,2012-Nov,9768,9219,549,5.6
Hutchinson County,2012-Dec,9744,9144,600,6.2
Hutchinson County,2013-Jan,9724,9041,683,7
Hutchinson County,2013-Feb,9637,8977,660,6.8
Hutchinson County,2013-Mar,9601,8983,618,6.4
Hutchinson County,2013-Apr,9606,9013,593,6.2
Hutchinson County,2013-May,9736,9101,635,6.5
Hutchinson County,2013-Jun,9820,9154,666,6.8
Hutchinson County,2013-Jul,9910,9266,644,6.5
Hutchinson County,2013-Aug,9794,9185,609,6.2
Hutchinson County,2013-Sep,9716,9118,598,6.2
Hutchinson County,2013-Oct,9690,9143,547,5.6
Hutchinson County,2013-Nov,9870,9340,530,5.4
Hutchinson County,2013-Dec,9986,9469,517,5.2
Hutchinson County,2014-Jan,10187,9675,512,5
Hutchinson County,2014-Feb,10205,9678,527,5.2
Hutchinson County,2014-Mar,10198,9703,495,4.9
Hutchinson County,2014-Apr,10291,9860,431,4.2
Hutchinson County,2014-May,10468,9991,477,4.6
Hutchinson County,2014-Jun,10645,10145,500,4.7
Hutchinson County,2014-Jul,10806,10284,522,4.8
Hutchinson County,2014-Aug,10501,10020,481,4.6
Hutchinson County,2014-Sep,10506,10072,434,4.1
Hutchinson County,2014-Oct,10698,10293,405,3.8
Hutchinson County,2014-Nov,10743,10332,411,3.8
Hutchinson County,2014-Dec,10777,10398,379,3.5
Hutchinson County,2015-Jan,10627,10190,437,4.1
Hutchinson County,2015-Feb,10779,10361,418,3.9
Hutchinson County,2015-Mar,10913,10504,409,3.7
Hutchinson County,2015-Apr,9408,9034,374,4
Hutchinson County,2015-May,9487,9073,414,4.4
Hutchinson County,2015-Jun,9507,9057,450,4.7
Hutchinson County,2015-Jul,9578,9132,446,4.7
Hutchinson County,2015-Aug,9490,9043,447,4.7
Hutchinson County,2015-Sep,9417,8947,470,5
Hutchinson County,2015-Oct,9413,8973,440,4.7
Hutchinson County,2015-Nov,9458,8985,473,5
Hutchinson County,2015-Dec,9532,9083,449,4.7
Hutchinson County,2016-Jan,9580,9115,465,4.9
Hutchinson County,2016-Feb,9650,9184,466,4.8
Hutchinson County,2016-Mar,9634,9154,480,5
Hutchinson County,2016-Apr,9833,9376,457,4.6
Hutchinson County,2016-May,9702,9243,459,4.7
Hutchinson County,2016-Jun,9739,9139,600,6.2
Hutchinson County,2016-Jul,9577,8962,615,6.4
Hutchinson County,2016-Aug,9508,8877,631,6.6
Hutchinson County,2016-Sep,9704,9073,631,6.5
Hutchinson County,2016-Oct,9580,9010,570,5.9
Hutchinson County,2016-Nov,9521,8973,548,5.8
Hutchinson County,2016-Dec,9637,9037,600,6.2
Hutchinson County,2017-Jan,9728,9069,659,6.8
Hutchinson County,2017-Feb,9548,8926,622,6.5
Hutchinson County,2017-Mar,9648,9064,584,6.1
Hutchinson County,2017-Apr,9616,9014,602,6.3
Hutchinson County,2017-May,9563,8968,595,6.2
Hutchinson County,2017-Jun,9504,8863,641,6.7
Hutchinson County,2017-Jul,9206,8609,597,6.5
Hutchinson County,2017-Aug,9120,8553,567,6.2
Hutchinson County,2017-Sep,9019,8509,510,5.7
Hutchinson County,2017-Oct,8991,8528,463,5.1
Hutchinson County,2017-Nov,9062,8581,481,5.3
Hutchinson County,2017-Dec,8946,8462,484,5.4
Hutchinson County,2018-Jan,9008,8482,526,5.8
Hutchinson County,2018-Feb,9240,8741,499,5.4
Hutchinson County,2018-Mar,9122,8665,457,5
Hutchinson County,2018-Apr,8874,8444,430,4.8
Hutchinson County,2018-May,8852,8422,430,4.9
Hutchinson County,2018-Jun,9025,8524,501,5.6
Hutchinson County,2018-Jul,8886,8411,475,5.3
Hutchinson County,2018-Aug,8788,8348,440,5
Hutchinson County,2018-Sep,8786,8363,423,4.8
Hutchinson County,2018-Oct,8846,8457,389,4.4
Hutchinson County,2018-Nov,8756,8366,390,4.5
Hutchinson County,2018-Dec,8733,8334,399,4.6
Hutchinson County,2019-Jan,8505,8050,455,5.3
Hutchinson County,2019-Feb,8439,8050,389,4.6
Hutchinson County,2019-Mar,8437,8079,358,4.2
Hutchinson County,2019-Apr,8501,8189,312,3.7
Hutchinson County,2019-May,8552,8239,313,3.7
Hutchinson County,2019-Jun,8727,8324,403,4.6
Hutchinson County,2019-Jul,8766,8332,434,5
Hutchinson County,2019-Aug,8615,8182,433,5
Hutchinson County,2019-Sep,8631,8248,383,4.4
Hutchinson County,2019-Oct,8559,8211,348,4.1
Hutchinson County,2019-Nov,8515,8158,357,4.2
Hutchinson County,2019-Dec,8499,8126,373,4.4
Hutchinson County,2020-Jan,8422,8018,404,4.8
Hutchinson County,2020-Feb,8375,7996,379,4.5
Hutchinson County,2020-Mar,8355,7806,549,6.6
Hutchinson County,2020-Apr,8165,7421,744,9.1
Hutchinson County,2020-May,8269,7452,817,9.9
Hutchinson County,2020-Jun,8527,7713,814,9.5
Hutchinson County,2020-Jul,8528,7816,712,8.3
Hutchinson County,2020-Aug,8517,7941,576,6.8
Hutchinson County,2020-Sep,8562,7988,574,6.7
Hutchinson County,2020-Oct,8540,8020,520,6.1
Hutchinson County,2020-Nov,8551,7982,569,6.7
Hutchinson County,2020-Dec,8418,7829,589,7
Hutchinson County,2021-Jan,8535,7897,638,7.5
Hutchinson County,2021-Feb,8607,7993,614,7.1
Hutchinson County,2021-Mar,8579,8012,567,6.6
Hutchinson County,2021-Apr,8599,8081,518,6
Hutchinson County,2021-May,8588,8091,497,5.8
Hutchinson County,2021-Jun,8725,8157,568,6.5
Hutchinson County,2021-Jul,8578,8063,515,6
Hutchinson County,2021-Aug,8455,7975,480,5.7
Hutchinson County,2021-Sep,8406,7943,463,5.5
Hutchinson County,2021-Oct,8354,7917,437,5.2
Hutchinson County,2021-Nov,8348,7911,437,5.2
Hutchinson County,2021-Dec,8203,7807,396,4.8
Hutchinson County,2022-Jan,8275,7804,471,5.7
Hutchinson County,2022-Feb,8273,7813,460,5.6
Hutchinson County,2022-Mar,8297,7916,381,4.6
Hutchinson County,2022-Apr,8170,7833,337,4.1
Hutchinson County,2022-May,8201,7828,373,4.5
Hutchinson County,2022-Jun,8321,7910,411,4.9
Hutchinson County,2022-Jul,8232(P),7839(P),393(P),4.8(P)
Irion County,2012-Jan,841,795,46,5.5
Irion County,2012-Feb,832,790,42,5
Irion County,2012-Mar,837,799,38,4.5
Irion County,2012-Apr,849,811,38,4.5
Irion County,2012-May,846,807,39,4.6
Irion County,2012-Jun,864,820,44,5.1
Irion County,2012-Jul,861,818,43,5
Irion County,2012-Aug,852,816,36,4.2
Irion County,2012-Sep,865,829,36,4.2
Irion County,2012-Oct,848,817,31,3.7
Irion County,2012-Nov,855,822,33,3.9
Irion County,2012-Dec,844,811,33,3.9
Irion County,2013-Jan,830,793,37,4.5
Irion County,2013-Feb,835,799,36,4.3
Irion County,2013-Mar,827,795,32,3.9
Irion County,2013-Apr,850,819,31,3.6
Irion County,2013-May,857,822,35,4.1
Irion County,2013-Jun,863,823,40,4.6
Irion County,2013-Jul,868,825,43,5
Irion County,2013-Aug,855,816,39,4.6
Irion County,2013-Sep,862,822,40,4.6
Irion County,2013-Oct,853,817,36,4.2
Irion County,2013-Nov,844,809,35,4.1
Irion County,2013-Dec,849,816,33,3.9
Irion County,2014-Jan,817,778,39,4.8
Irion County,2014-Feb,835,797,38,4.6
Irion County,2014-Mar,834,801,33,4
Irion County,2014-Apr,834,806,28,3.4
Irion County,2014-May,837,807,30,3.6
Irion County,2014-Jun,840,808,32,3.8
Irion County,2014-Jul,838,803,35,4.2
Irion County,2014-Aug,824,795,29,3.5
Irion County,2014-Sep,834,807,27,3.2
Irion County,2014-Oct,835,807,28,3.4
Irion County,2014-Nov,828,801,27,3.3
Irion County,2014-Dec,819,789,30,3.7
Irion County,2015-Jan,788,758,30,3.8
Irion County,2015-Feb,799,768,31,3.9
Irion County,2015-Mar,810,781,29,3.6
Irion County,2015-Apr,815,786,29,3.6
Irion County,2015-May,827,794,33,4
Irion County,2015-Jun,817,785,32,3.9
Irion County,2015-Jul,801,770,31,3.9
Irion County,2015-Aug,785,758,27,3.4
Irion County,2015-Sep,794,764,30,3.8
Irion County,2015-Oct,794,767,27,3.4
Irion County,2015-Nov,781,756,25,3.2
Irion County,2015-Dec,781,757,24,3.1
Irion County,2016-Jan,757,735,22,2.9
Irion County,2016-Feb,786,763,23,2.9
Irion County,2016-Mar,798,775,23,2.9
Irion County,2016-Apr,801,778,23,2.9
Irion County,2016-May,808,786,22,2.7
Irion County,2016-Jun,798,773,25,3.1
Irion County,2016-Jul,774,747,27,3.5
Irion County,2016-Aug,778,752,26,3.3
Irion County,2016-Sep,766,738,28,3.7
Irion County,2016-Oct,767,740,27,3.5
Irion County,2016-Nov,761,736,25,3.3
Irion County,2016-Dec,766,737,29,3.8
Irion County,2017-Jan,737,708,29,3.9
Irion County,2017-Feb,749,722,27,3.6
Irion County,2017-Mar,766,741,25,3.3
Irion County,2017-Apr,759,736,23,3
Irion County,2017-May,761,737,24,3.2
Irion County,2017-Jun,760,736,24,3.2
Irion County,2017-Jul,738,716,22,3
Irion County,2017-Aug,745,725,20,2.7
Irion County,2017-Sep,738,719,19,2.6
Irion County,2017-Oct,753,732,21,2.8
Irion County,2017-Nov,748,723,25,3.3
Irion County,2017-Dec,753,731,22,2.9
Irion County,2018-Jan,747,723,24,3.2
Irion County,2018-Feb,759,733,26,3.4
Irion County,2018-Mar,779,753,26,3.3
Irion County,2018-Apr,770,746,24,3.1
Irion County,2018-May,773,750,23,3
Irion County,2018-Jun,766,738,28,3.7
Irion County,2018-Jul,758,731,27,3.6
Irion County,2018-Aug,762,740,22,2.9
Irion County,2018-Sep,758,736,22,2.9
Irion County,2018-Oct,749,729,20,2.7
Irion County,2018-Nov,747,729,18,2.4
Irion County,2018-Dec,743,722,21,2.8
Irion County,2019-Jan,743,722,21,2.8
Irion County,2019-Feb,755,736,19,2.5
Irion County,2019-Mar,763,744,19,2.5
Irion County,2019-Apr,753,738,15,2
Irion County,2019-May,754,737,17,2.3
Irion County,2019-Jun,751,732,19,2.5
Irion County,2019-Jul,749,727,22,2.9
Irion County,2019-Aug,766,747,19,2.5
Irion County,2019-Sep,754,736,18,2.4
Irion County,2019-Oct,756,739,17,2.2
Irion County,2019-Nov,744,728,16,2.2
Irion County,2019-Dec,750,734,16,2.1
Irion County,2020-Jan,754,737,17,2.3
Irion County,2020-Feb,767,749,18,2.3
Irion County,2020-Mar,755,725,30,4
Irion County,2020-Apr,692,646,46,6.6
Irion County,2020-May,725,667,58,8
Irion County,2020-Jun,747,682,65,8.7
Irion County,2020-Jul,756,697,59,7.8
Irion County,2020-Aug,770,721,49,6.4
Irion County,2020-Sep,762,710,52,6.8
Irion County,2020-Oct,778,727,51,6.6
Irion County,2020-Nov,755,710,45,6
Irion County,2020-Dec,765,714,51,6.7
Irion County,2021-Jan,766,717,49,6.4
Irion County,2021-Feb,775,731,44,5.7
Irion County,2021-Mar,800,755,45,5.6
Irion County,2021-Apr,786,747,39,5
Irion County,2021-May,775,737,38,4.9
Irion County,2021-Jun,770,728,42,5.5
Irion County,2021-Jul,771,733,38,4.9
Irion County,2021-Aug,776,741,35,4.5
Irion County,2021-Sep,775,740,35,4.5
Irion County,2021-Oct,771,737,34,4.4
Irion County,2021-Nov,760,729,31,4.1
Irion County,2021-Dec,755,730,25,3.3
Irion County,2022-Jan,753,721,32,4.2
Irion County,2022-Feb,782,753,29,3.7
Irion County,2022-Mar,803,778,25,3.1
Irion County,2022-Apr,789,766,23,2.9
Irion County,2022-May,779,754,25,3.2
Irion County,2022-Jun,776,751,25,3.2
Irion County,2022-Jul,792(P),769(P),23(P),2.9(P)
Jack County,2012-Jan,3755,3524,231,6.2
Jack County,2012-Feb,3801,3580,221,5.8
Jack County,2012-Mar,3774,3563,211,5.6
Jack County,2012-Apr,3780,3575,205,5.4
Jack County,2012-May,3787,3574,213,5.6
Jack County,2012-Jun,3788,3554,234,6.2
Jack County,2012-Jul,3815,3570,245,6.4
Jack County,2012-Aug,3788,3563,225,5.9
Jack County,2012-Sep,3811,3602,209,5.5
Jack County,2012-Oct,3789,3590,199,5.3
Jack County,2012-Nov,3808,3615,193,5.1
Jack County,2012-Dec,3842,3628,214,5.6
Jack County,2013-Jan,3991,3747,244,6.1
Jack County,2013-Feb,3979,3749,230,5.8
Jack County,2013-Mar,3975,3754,221,5.6
Jack County,2013-Apr,3965,3750,215,5.4
Jack County,2013-May,3980,3762,218,5.5
Jack County,2013-Jun,4026,3790,236,5.9
Jack County,2013-Jul,4029,3812,217,5.4
Jack County,2013-Aug,3981,3773,208,5.2
Jack County,2013-Sep,4021,3813,208,5.2
Jack County,2013-Oct,3987,3789,198,5
Jack County,2013-Nov,4032,3842,190,4.7
Jack County,2013-Dec,4027,3847,180,4.5
Jack County,2014-Jan,4186,4003,183,4.4
Jack County,2014-Feb,4248,4065,183,4.3
Jack County,2014-Mar,4242,4067,175,4.1
Jack County,2014-Apr,4314,4161,153,3.5
Jack County,2014-May,4335,4171,164,3.8
Jack County,2014-Jun,4411,4230,181,4.1
Jack County,2014-Jul,4349,4169,180,4.1
Jack County,2014-Aug,4282,4114,168,3.9
Jack County,2014-Sep,4348,4191,157,3.6
Jack County,2014-Oct,4328,4180,148,3.4
Jack County,2014-Nov,4305,4164,141,3.3
Jack County,2014-Dec,4255,4129,126,3
Jack County,2015-Jan,4222,4071,151,3.6
Jack County,2015-Feb,4178,4024,154,3.7
Jack County,2015-Mar,4130,3956,174,4.2
Jack County,2015-Apr,4153,3979,174,4.2
Jack County,2015-May,4113,3934,179,4.4
Jack County,2015-Jun,4097,3901,196,4.8
Jack County,2015-Jul,4091,3901,190,4.6
Jack County,2015-Aug,4084,3906,178,4.4
Jack County,2015-Sep,4006,3831,175,4.4
Jack County,2015-Oct,4005,3829,176,4.4
Jack County,2015-Nov,3953,3779,174,4.4
Jack County,2015-Dec,3926,3766,160,4.1
Jack County,2016-Jan,3931,3753,178,4.5
Jack County,2016-Feb,3990,3789,201,5
Jack County,2016-Mar,3886,3678,208,5.4
Jack County,2016-Apr,3888,3695,193,5
Jack County,2016-May,3854,3660,194,5
Jack County,2016-Jun,3862,3651,211,5.5
Jack County,2016-Jul,3874,3663,211,5.4
Jack County,2016-Aug,3868,3665,203,5.2
Jack County,2016-Sep,3826,3627,199,5.2
Jack County,2016-Oct,3767,3597,170,4.5
Jack County,2016-Nov,3757,3598,159,4.2
Jack County,2016-Dec,3769,3610,159,4.2
Jack County,2017-Jan,3772,3595,177,4.7
Jack County,2017-Feb,3856,3677,179,4.6
Jack County,2017-Mar,3870,3695,175,4.5
Jack County,2017-Apr,3978,3820,158,4
Jack County,2017-May,3972,3826,146,3.7
Jack County,2017-Jun,3952,3797,155,3.9
Jack County,2017-Jul,3920,3771,149,3.8
Jack County,2017-Aug,3968,3821,147,3.7
Jack County,2017-Sep,3927,3794,133,3.4
Jack County,2017-Oct,3892,3773,119,3.1
Jack County,2017-Nov,3940,3817,123,3.1
Jack County,2017-Dec,4035,3924,111,2.8
Jack County,2018-Jan,4058,3940,118,2.9
Jack County,2018-Feb,4217,4106,111,2.6
Jack County,2018-Mar,4268,4154,114,2.7
Jack County,2018-Apr,4451,4340,111,2.5
Jack County,2018-May,4525,4424,101,2.2
Jack County,2018-Jun,4541,4421,120,2.6
Jack County,2018-Jul,4520,4403,117,2.6
Jack County,2018-Aug,4499,4382,117,2.6
Jack County,2018-Sep,4376,4273,103,2.4
Jack County,2018-Oct,4199,4098,101,2.4
Jack County,2018-Nov,4188,4086,102,2.4
Jack County,2018-Dec,4181,4084,97,2.3
Jack County,2019-Jan,3382,3261,121,3.6
Jack County,2019-Feb,3388,3273,115,3.4
Jack County,2019-Mar,3409,3301,108,3.2
Jack County,2019-Apr,3411,3320,91,2.7
Jack County,2019-May,3441,3352,89,2.6
Jack County,2019-Jun,3455,3347,108,3.1
Jack County,2019-Jul,3484,3371,113,3.2
Jack County,2019-Aug,3485,3374,111,3.2
Jack County,2019-Sep,3436,3326,110,3.2
Jack County,2019-Oct,3427,3312,115,3.4
Jack County,2019-Nov,3407,3293,114,3.3
Jack County,2019-Dec,3414,3312,102,3
Jack County,2020-Jan,3381,3245,136,4
Jack County,2020-Feb,3408,3272,136,4
Jack County,2020-Mar,3423,3223,200,5.8
Jack County,2020-Apr,3323,3038,285,8.6
Jack County,2020-May,3380,3056,324,9.6
Jack County,2020-Jun,3339,3026,313,9.4
Jack County,2020-Jul,3369,3074,295,8.8
Jack County,2020-Aug,3395,3152,243,7.2
Jack County,2020-Sep,3345,3104,241,7.2
Jack County,2020-Oct,3365,3153,212,6.3
Jack County,2020-Nov,3355,3125,230,6.9
Jack County,2020-Dec,3361,3142,219,6.5
Jack County,2021-Jan,3372,3142,230,6.8
Jack County,2021-Feb,3405,3170,235,6.9
Jack County,2021-Mar,3390,3169,221,6.5
Jack County,2021-Apr,3406,3217,189,5.5
Jack County,2021-May,3425,3235,190,5.5
Jack County,2021-Jun,3417,3212,205,6
Jack County,2021-Jul,3387,3202,185,5.5
Jack County,2021-Aug,3407,3227,180,5.3
Jack County,2021-Sep,3394,3229,165,4.9
Jack County,2021-Oct,3398,3244,154,4.5
Jack County,2021-Nov,3380,3239,141,4.2
Jack County,2021-Dec,3393,3257,136,4
Jack County,2022-Jan,3396,3249,147,4.3
Jack County,2022-Feb,3431,3273,158,4.6
Jack County,2022-Mar,3435,3304,131,3.8
Jack County,2022-Apr,3448,3323,125,3.6
Jack County,2022-May,3463,3338,125,3.6
Jack County,2022-Jun,3457,3316,141,4.1
Jack County,2022-Jul,3432(P),3297(P),135(P),3.9(P)
Jackson County,2012-Jan,7381,6974,407,5.5
Jackson County,2012-Feb,7363,6956,407,5.5
Jackson County,2012-Mar,7425,7052,373,5
Jackson County,2012-Apr,7479,7129,350,4.7
Jackson County,2012-May,7515,7145,370,4.9
Jackson County,2012-Jun,7604,7177,427,5.6
Jackson County,2012-Jul,7617,7183,434,5.7
Jackson County,2012-Aug,7425,7031,394,5.3
Jackson County,2012-Sep,7353,7000,353,4.8
Jackson County,2012-Oct,7365,7025,340,4.6
Jackson County,2012-Nov,7307,6977,330,4.5
Jackson County,2012-Dec,7218,6874,344,4.8
Jackson County,2013-Jan,7166,6772,394,5.5
Jackson County,2013-Feb,7221,6858,363,5
Jackson County,2013-Mar,7312,6936,376,5.1
Jackson County,2013-Apr,7393,7050,343,4.6
Jackson County,2013-May,7469,7091,378,5.1
Jackson County,2013-Jun,7552,7118,434,5.7
Jackson County,2013-Jul,7658,7228,430,5.6
Jackson County,2013-Aug,7501,7093,408,5.4
Jackson County,2013-Sep,7506,7135,371,4.9
Jackson County,2013-Oct,7444,7100,344,4.6
Jackson County,2013-Nov,7442,7111,331,4.4
Jackson County,2013-Dec,7454,7133,321,4.3
Jackson County,2014-Jan,7371,7032,339,4.6
Jackson County,2014-Feb,7473,7144,329,4.4
Jackson County,2014-Mar,7568,7237,331,4.4
Jackson County,2014-Apr,7614,7342,272,3.6
Jackson County,2014-May,7685,7399,286,3.7
Jackson County,2014-Jun,7771,7439,332,4.3
Jackson County,2014-Jul,7758,7402,356,4.6
Jackson County,2014-Aug,7698,7369,329,4.3
Jackson County,2014-Sep,7797,7508,289,3.7
Jackson County,2014-Oct,7641,7378,263,3.4
Jackson County,2014-Nov,7600,7336,264,3.5
Jackson County,2014-Dec,7463,7219,244,3.3
Jackson County,2015-Jan,7399,7128,271,3.7
Jackson County,2015-Feb,7462,7201,261,3.5
Jackson County,2015-Mar,7464,7204,260,3.5
Jackson County,2015-Apr,7388,7138,250,3.4
Jackson County,2015-May,7426,7154,272,3.7
Jackson County,2015-Jun,7402,7097,305,4.1
Jackson County,2015-Jul,7375,7061,314,4.3
Jackson County,2015-Aug,7359,7066,293,4
Jackson County,2015-Sep,7350,7066,284,3.9
Jackson County,2015-Oct,7289,7011,278,3.8
Jackson County,2015-Nov,7248,6963,285,3.9
Jackson County,2015-Dec,7286,7013,273,3.7
Jackson County,2016-Jan,7079,6792,287,4.1
Jackson County,2016-Feb,7209,6900,309,4.3
Jackson County,2016-Mar,7247,6932,315,4.3
Jackson County,2016-Apr,7257,6936,321,4.4
Jackson County,2016-May,7368,7041,327,4.4
Jackson County,2016-Jun,7360,6975,385,5.2
Jackson County,2016-Jul,7328,6934,394,5.4
Jackson County,2016-Aug,7382,7001,381,5.2
Jackson County,2016-Sep,7292,6923,369,5.1
Jackson County,2016-Oct,7225,6883,342,4.7
Jackson County,2016-Nov,7297,6965,332,4.5
Jackson County,2016-Dec,7282,6955,327,4.5
Jackson County,2017-Jan,7198,6863,335,4.7
Jackson County,2017-Feb,7278,6944,334,4.6
Jackson County,2017-Mar,7388,7070,318,4.3
Jackson County,2017-Apr,7300,7035,265,3.6
Jackson County,2017-May,7294,7014,280,3.8
Jackson County,2017-Jun,7364,7039,325,4.4
Jackson County,2017-Jul,7377,7060,317,4.3
Jackson County,2017-Aug,7396,7089,307,4.2
Jackson County,2017-Sep,7327,7033,294,4
Jackson County,2017-Oct,7299,7048,251,3.4
Jackson County,2017-Nov,7277,7016,261,3.6
Jackson County,2017-Dec,7327,7078,249,3.4
Jackson County,2018-Jan,7169,6899,270,3.8
Jackson County,2018-Feb,7253,6995,258,3.6
Jackson County,2018-Mar,7323,7063,260,3.6
Jackson County,2018-Apr,7271,7046,225,3.1
Jackson County,2018-May,7343,7115,228,3.1
Jackson County,2018-Jun,7375,7112,263,3.6
Jackson County,2018-Jul,7403,7153,250,3.4
Jackson County,2018-Aug,7397,7158,239,3.2
Jackson County,2018-Sep,7303,7070,233,3.2
Jackson County,2018-Oct,7243,7021,222,3.1
Jackson County,2018-Nov,7224,7011,213,2.9
Jackson County,2018-Dec,7245,7025,220,3
Jackson County,2019-Jan,7277,7025,252,3.5
Jackson County,2019-Feb,7298,7067,231,3.2
Jackson County,2019-Mar,7347,7124,223,3
Jackson County,2019-Apr,7384,7186,198,2.7
Jackson County,2019-May,7413,7218,195,2.6
Jackson County,2019-Jun,7497,7253,244,3.3
Jackson County,2019-Jul,7583,7325,258,3.4
Jackson County,2019-Aug,7618,7395,223,2.9
Jackson County,2019-Sep,7523,7310,213,2.8
Jackson County,2019-Oct,7484,7274,210,2.8
Jackson County,2019-Nov,7413,7195,218,2.9
Jackson County,2019-Dec,7435,7227,208,2.8
Jackson County,2020-Jan,7472,7220,252,3.4
Jackson County,2020-Feb,7516,7290,226,3
Jackson County,2020-Mar,7444,7101,343,4.6
Jackson County,2020-Apr,7006,6505,501,7.2
Jackson County,2020-May,7140,6617,523,7.3
Jackson County,2020-Jun,7187,6651,536,7.5
Jackson County,2020-Jul,7249,6686,563,7.8
Jackson County,2020-Aug,7257,6807,450,6.2
Jackson County,2020-Sep,7159,6736,423,5.9
Jackson County,2020-Oct,7127,6739,388,5.4
Jackson County,2020-Nov,7123,6723,400,5.6
Jackson County,2020-Dec,7060,6647,413,5.8
Jackson County,2021-Jan,7059,6637,422,6
Jackson County,2021-Feb,7160,6736,424,5.9
Jackson County,2021-Mar,7247,6847,400,5.5
Jackson County,2021-Apr,7210,6835,375,5.2
Jackson County,2021-May,7106,6762,344,4.8
Jackson County,2021-Jun,7146,6743,403,5.6
Jackson County,2021-Jul,7157,6783,374,5.2
Jackson County,2021-Aug,7142,6805,337,4.7
Jackson County,2021-Sep,7110,6791,319,4.5
Jackson County,2021-Oct,7005,6706,299,4.3
Jackson County,2021-Nov,7004,6709,295,4.2
Jackson County,2021-Dec,6950,6673,277,4
Jackson County,2022-Jan,6962,6667,295,4.2
Jackson County,2022-Feb,7113,6825,288,4
Jackson County,2022-Mar,7224,6986,238,3.3
Jackson County,2022-Apr,7138,6923,215,3
Jackson County,2022-May,7055,6827,228,3.2
Jackson County,2022-Jun,7059,6792,267,3.8
Jackson County,2022-Jul,7178(P),6910(P),268(P),3.7(P)
Jasper County,2012-Jan,14935,13250,1685,11.3
Jasper County,2012-Feb,14956,13298,1658,11.1
Jasper County,2012-Mar,14836,13313,1523,10.3
Jasper County,2012-Apr,14851,13390,1461,9.8
Jasper County,2012-May,14952,13404,1548,10.4
Jasper County,2012-Jun,15109,13397,1712,11.3
Jasper County,2012-Jul,15028,13354,1674,11.1
Jasper County,2012-Aug,14906,13297,1609,10.8
Jasper County,2012-Sep,14903,13391,1512,10.1
Jasper County,2012-Oct,14763,13280,1483,10
Jasper County,2012-Nov,14633,13170,1463,10
Jasper County,2012-Dec,14652,13084,1568,10.7
Jasper County,2013-Jan,14663,12947,1716,11.7
Jasper County,2013-Feb,14573,13011,1562,10.7
Jasper County,2013-Mar,14503,12960,1543,10.6
Jasper County,2013-Apr,14457,12964,1493,10.3
Jasper County,2013-May,14561,13018,1543,10.6
Jasper County,2013-Jun,14648,12996,1652,11.3
Jasper County,2013-Jul,14498,12880,1618,11.2
Jasper County,2013-Aug,14343,12826,1517,10.6
Jasper County,2013-Sep,14428,12927,1501,10.4
Jasper County,2013-Oct,14364,12933,1431,10
Jasper County,2013-Nov,14423,13016,1407,9.8
Jasper County,2013-Dec,14521,13156,1365,9.4
Jasper County,2014-Jan,14334,12955,1379,9.6
Jasper County,2014-Feb,14445,13114,1331,9.2
Jasper County,2014-Mar,14653,13362,1291,8.8
Jasper County,2014-Apr,14399,13285,1114,7.7
Jasper County,2014-May,14454,13299,1155,8
Jasper County,2014-Jun,14566,13346,1220,8.4
Jasper County,2014-Jul,14473,13193,1280,8.8
Jasper County,2014-Aug,14438,13182,1256,8.7
Jasper County,2014-Sep,14440,13298,1142,7.9
Jasper County,2014-Oct,14314,13267,1047,7.3
Jasper County,2014-Nov,14382,13306,1076,7.5
Jasper County,2014-Dec,14278,13271,1007,7.1
Jasper County,2015-Jan,14154,13011,1143,8.1
Jasper County,2015-Feb,14157,13107,1050,7.4
Jasper County,2015-Mar,14238,13218,1020,7.2
Jasper County,2015-Apr,14012,13060,952,6.8
Jasper County,2015-May,14092,13116,976,6.9
Jasper County,2015-Jun,14209,13113,1096,7.7
Jasper County,2015-Jul,13764,12668,1096,8
Jasper County,2015-Aug,13665,12592,1073,7.9
Jasper County,2015-Sep,13708,12698,1010,7.4
Jasper County,2015-Oct,13557,12523,1034,7.6
Jasper County,2015-Nov,13546,12500,1046,7.7
Jasper County,2015-Dec,13538,12486,1052,7.8
Jasper County,2016-Jan,13321,12299,1022,7.7
Jasper County,2016-Feb,13475,12464,1011,7.5
Jasper County,2016-Mar,13576,12558,1018,7.5
Jasper County,2016-Apr,13351,12397,954,7.1
Jasper County,2016-May,13415,12494,921,6.9
Jasper County,2016-Jun,13553,12480,1073,7.9
Jasper County,2016-Jul,13458,12354,1104,8.2
Jasper County,2016-Aug,13563,12439,1124,8.3
Jasper County,2016-Sep,13584,12508,1076,7.9
Jasper County,2016-Oct,13343,12385,958,7.2
Jasper County,2016-Nov,13511,12482,1029,7.6
Jasper County,2016-Dec,13515,12384,1131,8.4
Jasper County,2017-Jan,13378,12175,1203,9
Jasper County,2017-Feb,13497,12355,1142,8.5
Jasper County,2017-Mar,13589,12537,1052,7.7
Jasper County,2017-Apr,13320,12357,963,7.2
Jasper County,2017-May,13333,12390,943,7.1
Jasper County,2017-Jun,13446,12429,1017,7.6
Jasper County,2017-Jul,13264,12249,1015,7.7
Jasper County,2017-Aug,13302,12277,1025,7.7
Jasper County,2017-Sep,13189,12243,946,7.2
Jasper County,2017-Oct,13178,12319,859,6.5
Jasper County,2017-Nov,13332,12408,924,6.9
Jasper County,2017-Dec,13398,12449,949,7.1
Jasper County,2018-Jan,13167,12137,1030,7.8
Jasper County,2018-Feb,13227,12278,949,7.2
Jasper County,2018-Mar,13367,12470,897,6.7
Jasper County,2018-Apr,13287,12455,832,6.3
Jasper County,2018-May,13300,12502,798,6
Jasper County,2018-Jun,13338,12440,898,6.7
Jasper County,2018-Jul,13115,12218,897,6.8
Jasper County,2018-Aug,13062,12187,875,6.7
Jasper County,2018-Sep,13015,12225,790,6.1
Jasper County,2018-Oct,12800,12046,754,5.9
Jasper County,2018-Nov,12845,12079,766,6
Jasper County,2018-Dec,12802,11956,846,6.6
Jasper County,2019-Jan,12809,11877,932,7.3
Jasper County,2019-Feb,12794,11975,819,6.4
Jasper County,2019-Mar,12776,12014,762,6
Jasper County,2019-Apr,12596,11932,664,5.3
Jasper County,2019-May,12574,11906,668,5.3
Jasper County,2019-Jun,12672,11859,813,6.4
Jasper County,2019-Jul,12664,11814,850,6.7
Jasper County,2019-Aug,12678,11863,815,6.4
Jasper County,2019-Sep,12633,11891,742,5.9
Jasper County,2019-Oct,12602,11913,689,5.5
Jasper County,2019-Nov,12630,11876,754,6
Jasper County,2019-Dec,12689,11884,805,6.3
Jasper County,2020-Jan,12601,11709,892,7.1
Jasper County,2020-Feb,12552,11751,801,6.4
Jasper County,2020-Mar,12732,11495,1237,9.7
Jasper County,2020-Apr,12471,10570,1901,15.2
Jasper County,2020-May,12745,10825,1920,15.1
Jasper County,2020-Jun,12880,11100,1780,13.8
Jasper County,2020-Jul,12913,11187,1726,13.4
Jasper County,2020-Aug,12867,11397,1470,11.4
Jasper County,2020-Sep,12787,11320,1467,11.5
Jasper County,2020-Oct,12769,11510,1259,9.9
Jasper County,2020-Nov,12821,11503,1318,10.3
Jasper County,2020-Dec,12873,11469,1404,10.9
Jasper County,2021-Jan,12933,11414,1519,11.7
Jasper County,2021-Feb,12978,11509,1469,11.3
Jasper County,2021-Mar,12908,11600,1308,10.1
Jasper County,2021-Apr,12853,11608,1245,9.7
Jasper County,2021-May,12744,11514,1230,9.7
Jasper County,2021-Jun,12826,11458,1368,10.7
Jasper County,2021-Jul,12829,11519,1310,10.2
Jasper County,2021-Aug,12770,11553,1217,9.5
Jasper County,2021-Sep,12792,11645,1147,9
Jasper County,2021-Oct,12755,11700,1055,8.3
Jasper County,2021-Nov,12813,11747,1066,8.3
Jasper County,2021-Dec,12785,11750,1035,8.1
Jasper County,2022-Jan,12867,11713,1154,9
Jasper County,2022-Feb,12960,11862,1098,8.5
Jasper County,2022-Mar,12952,12055,897,6.9
Jasper County,2022-Apr,12835,12005,830,6.5
Jasper County,2022-May,12786,11910,876,6.9
Jasper County,2022-Jun,12853,11859,994,7.7
Jasper County,2022-Jul,12924(P),11964(P),960(P),7.4(P)
Jeff Davis County,2012-Jan,1174,1104,70,6
Jeff Davis County,2012-Feb,1148,1082,66,5.7
Jeff Davis County,2012-Mar,1202,1143,59,4.9
Jeff Davis County,2012-Apr,1229,1174,55,4.5
Jeff Davis County,2012-May,1223,1166,57,4.7
Jeff Davis County,2012-Jun,1271,1207,64,5
Jeff Davis County,2012-Jul,1260,1196,64,5.1
Jeff Davis County,2012-Aug,1220,1163,57,4.7
Jeff Davis County,2012-Sep,1216,1160,56,4.6
Jeff Davis County,2012-Oct,1218,1166,52,4.3
Jeff Davis County,2012-Nov,1211,1159,52,4.3
Jeff Davis County,2012-Dec,1176,1124,52,4.4
Jeff Davis County,2013-Jan,1111,1056,55,5
Jeff Davis County,2013-Feb,1107,1060,47,4.2
Jeff Davis County,2013-Mar,1130,1079,51,4.5
Jeff Davis County,2013-Apr,1156,1112,44,3.8
Jeff Davis County,2013-May,1166,1122,44,3.8
Jeff Davis County,2013-Jun,1209,1158,51,4.2
Jeff Davis County,2013-Jul,1237,1184,53,4.3
Jeff Davis County,2013-Aug,1169,1122,47,4
Jeff Davis County,2013-Sep,1158,1112,46,4
Jeff Davis County,2013-Oct,1158,1113,45,3.9
Jeff Davis County,2013-Nov,1142,1091,51,4.5
Jeff Davis County,2013-Dec,1172,1125,47,4
Jeff Davis County,2014-Jan,1118,1068,50,4.5
Jeff Davis County,2014-Feb,1149,1100,49,4.3
Jeff Davis County,2014-Mar,1196,1148,48,4
Jeff Davis County,2014-Apr,1171,1136,35,3
Jeff Davis County,2014-May,1184,1143,41,3.5
Jeff Davis County,2014-Jun,1194,1152,42,3.5
Jeff Davis County,2014-Jul,1198,1155,43,3.6
Jeff Davis County,2014-Aug,1131,1090,41,3.6
Jeff Davis County,2014-Sep,1143,1105,38,3.3
Jeff Davis County,2014-Oct,1119,1080,39,3.5
Jeff Davis County,2014-Nov,1086,1048,38,3.5
Jeff Davis County,2014-Dec,1058,1022,36,3.4
Jeff Davis County,2015-Jan,1027,982,45,4.4
Jeff Davis County,2015-Feb,1070,1031,39,3.6
Jeff Davis County,2015-Mar,1118,1079,39,3.5
Jeff Davis County,2015-Apr,1090,1059,31,2.8
Jeff Davis County,2015-May,1119,1085,34,3
Jeff Davis County,2015-Jun,1133,1099,34,3
Jeff Davis County,2015-Jul,1121,1084,37,3.3
Jeff Davis County,2015-Aug,1053,1021,32,3
Jeff Davis County,2015-Sep,1075,1042,33,3.1
Jeff Davis County,2015-Oct,1076,1042,34,3.2
Jeff Davis County,2015-Nov,1042,1007,35,3.4
Jeff Davis County,2015-Dec,1038,1004,34,3.3
Jeff Davis County,2016-Jan,996,963,33,3.3
Jeff Davis County,2016-Feb,1074,1041,33,3.1
Jeff Davis County,2016-Mar,1135,1099,36,3.2
Jeff Davis County,2016-Apr,1116,1088,28,2.5
Jeff Davis County,2016-May,1136,1109,27,2.4
Jeff Davis County,2016-Jun,1117,1087,30,2.7
Jeff Davis County,2016-Jul,1091,1054,37,3.4
Jeff Davis County,2016-Aug,1079,1048,31,2.9
Jeff Davis County,2016-Sep,1051,1019,32,3
Jeff Davis County,2016-Oct,1049,1017,32,3.1
Jeff Davis County,2016-Nov,1022,991,31,3
Jeff Davis County,2016-Dec,1016,986,30,3
Jeff Davis County,2017-Jan,1013,978,35,3.5
Jeff Davis County,2017-Feb,1052,1012,40,3.8
Jeff Davis County,2017-Mar,1102,1067,35,3.2
Jeff Davis County,2017-Apr,1091,1059,32,2.9
Jeff Davis County,2017-May,1101,1065,36,3.3
Jeff Davis County,2017-Jun,1107,1072,35,3.2
Jeff Davis County,2017-Jul,1053,1019,34,3.2
Jeff Davis County,2017-Aug,1054,1018,36,3.4
Jeff Davis County,2017-Sep,1030,997,33,3.2
Jeff Davis County,2017-Oct,1055,1027,28,2.7
Jeff Davis County,2017-Nov,1019,988,31,3
Jeff Davis County,2017-Dec,1025,996,29,2.8
Jeff Davis County,2018-Jan,1013,983,30,3
Jeff Davis County,2018-Feb,1036,1004,32,3.1
Jeff Davis County,2018-Mar,1090,1059,31,2.8
Jeff Davis County,2018-Apr,1063,1035,28,2.6
Jeff Davis County,2018-May,1093,1064,29,2.7
Jeff Davis County,2018-Jun,1104,1071,33,3
Jeff Davis County,2018-Jul,1086,1054,32,2.9
Jeff Davis County,2018-Aug,1090,1058,32,2.9
Jeff Davis County,2018-Sep,1068,1037,31,2.9
Jeff Davis County,2018-Oct,1032,1002,30,2.9
Jeff Davis County,2018-Nov,1024,991,33,3.2
Jeff Davis County,2018-Dec,996,967,29,2.9
Jeff Davis County,2019-Jan,1007,966,41,4.1
Jeff Davis County,2019-Feb,1015,985,30,3
Jeff Davis County,2019-Mar,1072,1041,31,2.9
Jeff Davis County,2019-Apr,1043,1019,24,2.3
Jeff Davis County,2019-May,1052,1028,24,2.3
Jeff Davis County,2019-Jun,1049,1021,28,2.7
Jeff Davis County,2019-Jul,1069,1035,34,3.2
Jeff Davis County,2019-Aug,1060,1027,33,3.1
Jeff Davis County,2019-Sep,1006,975,31,3.1
Jeff Davis County,2019-Oct,1036,1008,28,2.7
Jeff Davis County,2019-Nov,1001,971,30,3
Jeff Davis County,2019-Dec,998,970,28,2.8
Jeff Davis County,2020-Jan,983,953,30,3.1
Jeff Davis County,2020-Feb,1002,975,27,2.7
Jeff Davis County,2020-Mar,1001,952,49,4.9
Jeff Davis County,2020-Apr,828,757,71,8.6
Jeff Davis County,2020-May,892,822,70,7.8
Jeff Davis County,2020-Jun,944,884,60,6.4
Jeff Davis County,2020-Jul,955,899,56,5.9
Jeff Davis County,2020-Aug,981,936,45,4.6
Jeff Davis County,2020-Sep,952,908,44,4.6
Jeff Davis County,2020-Oct,993,954,39,3.9
Jeff Davis County,2020-Nov,952,909,43,4.5
Jeff Davis County,2020-Dec,948,900,48,5.1
Jeff Davis County,2021-Jan,964,916,48,5
Jeff Davis County,2021-Feb,1001,949,52,5.2
Jeff Davis County,2021-Mar,1029,979,50,4.9
Jeff Davis County,2021-Apr,1043,999,44,4.2
Jeff Davis County,2021-May,1067,1019,48,4.5
Jeff Davis County,2021-Jun,1052,1007,45,4.3
Jeff Davis County,2021-Jul,1065,1024,41,3.8
Jeff Davis County,2021-Aug,1071,1030,41,3.8
Jeff Davis County,2021-Sep,1018,976,42,4.1
Jeff Davis County,2021-Oct,1016,978,38,3.7
Jeff Davis County,2021-Nov,982,942,40,4.1
Jeff Davis County,2021-Dec,964,930,34,3.5
Jeff Davis County,2022-Jan,969,930,39,4
Jeff Davis County,2022-Feb,1035,997,38,3.7
Jeff Davis County,2022-Mar,1075,1044,31,2.9
Jeff Davis County,2022-Apr,1037,1010,27,2.6
Jeff Davis County,2022-May,1063,1030,33,3.1
Jeff Davis County,2022-Jun,1059,1026,33,3.1
Jeff Davis County,2022-Jul,1112(P),1078(P),34(P),3.1(P)
Jefferson County,2012-Jan,114172,101688,12484,10.9
Jefferson County,2012-Feb,114502,102271,12231,10.7
Jefferson County,2012-Mar,113772,102185,11587,10.2
Jefferson County,2012-Apr,114233,102856,11377,10
Jefferson County,2012-May,114352,102132,12220,10.7
Jefferson County,2012-Jun,114806,101007,13799,12
Jefferson County,2012-Jul,113662,99905,13757,12.1
Jefferson County,2012-Aug,112244,99174,13070,11.6
Jefferson County,2012-Sep,112162,99906,12256,10.9
Jefferson County,2012-Oct,112422,100354,12068,10.7
Jefferson County,2012-Nov,111355,99647,11708,10.5
Jefferson County,2012-Dec,111880,99121,12759,11.4
Jefferson County,2013-Jan,112330,98551,13779,12.3
Jefferson County,2013-Feb,112583,99957,12626,11.2
Jefferson County,2013-Mar,112009,99867,12142,10.8
Jefferson County,2013-Apr,111805,99786,12019,10.7
Jefferson County,2013-May,111808,99727,12081,10.8
Jefferson County,2013-Jun,111894,98944,12950,11.6
Jefferson County,2013-Jul,110409,97864,12545,11.4
Jefferson County,2013-Aug,109802,97507,12295,11.2
Jefferson County,2013-Sep,110069,98187,11882,10.8
Jefferson County,2013-Oct,110004,98477,11527,10.5
Jefferson County,2013-Nov,110401,99090,11311,10.2
Jefferson County,2013-Dec,109912,99086,10826,9.8
Jefferson County,2014-Jan,109537,98362,11175,10.2
Jefferson County,2014-Feb,110063,99337,10726,9.7
Jefferson County,2014-Mar,109914,99858,10056,9.1
Jefferson County,2014-Apr,109857,100978,8879,8.1
Jefferson County,2014-May,110178,101454,8724,7.9
Jefferson County,2014-Jun,110038,100778,9260,8.4
Jefferson County,2014-Jul,110229,100513,9716,8.8
Jefferson County,2014-Aug,110017,100314,9703,8.8
Jefferson County,2014-Sep,109971,101216,8755,8
Jefferson County,2014-Oct,110511,102606,7905,7.2
Jefferson County,2014-Nov,110365,102233,8132,7.4
Jefferson County,2014-Dec,109724,101937,7787,7.1
Jefferson County,2015-Jan,109347,100790,8557,7.8
Jefferson County,2015-Feb,109286,101695,7591,6.9
Jefferson County,2015-Mar,108456,101064,7392,6.8
Jefferson County,2015-Apr,107878,100883,6995,6.5
Jefferson County,2015-May,108577,101361,7216,6.6
Jefferson County,2015-Jun,108362,100713,7649,7.1
Jefferson County,2015-Jul,107813,99869,7944,7.4
Jefferson County,2015-Aug,107211,99499,7712,7.2
Jefferson County,2015-Sep,107397,99928,7469,7
Jefferson County,2015-Oct,107287,99842,7445,6.9
Jefferson County,2015-Nov,107273,99625,7648,7.1
Jefferson County,2015-Dec,107491,100111,7380,6.9
Jefferson County,2016-Jan,108049,100467,7582,7
Jefferson County,2016-Feb,108515,101305,7210,6.6
Jefferson County,2016-Mar,108001,100864,7137,6.6
Jefferson County,2016-Apr,107471,100671,6800,6.3
Jefferson County,2016-May,106555,99876,6679,6.3
Jefferson County,2016-Jun,107429,99697,7732,7.2
Jefferson County,2016-Jul,107269,99080,8189,7.6
Jefferson County,2016-Aug,107031,98891,8140,7.6
Jefferson County,2016-Sep,107874,99881,7993,7.4
Jefferson County,2016-Oct,107578,100349,7229,6.7
Jefferson County,2016-Nov,107366,99804,7562,7
Jefferson County,2016-Dec,107418,99107,8311,7.7
Jefferson County,2017-Jan,107520,98311,9209,8.6
Jefferson County,2017-Feb,108216,99624,8592,7.9
Jefferson County,2017-Mar,107973,99950,8023,7.4
Jefferson County,2017-Apr,107515,99950,7565,7
Jefferson County,2017-May,106529,99384,7145,6.7
Jefferson County,2017-Jun,106847,99144,7703,7.2
Jefferson County,2017-Jul,106577,99017,7560,7.1
Jefferson County,2017-Aug,105602,97856,7746,7.3
Jefferson County,2017-Sep,107103,97792,9311,8.7
Jefferson County,2017-Oct,106029,98661,7368,6.9
Jefferson County,2017-Nov,106206,98745,7461,7
Jefferson County,2017-Dec,105881,98305,7576,7.2
Jefferson County,2018-Jan,106917,98569,8348,7.8
Jefferson County,2018-Feb,107659,99965,7694,7.1
Jefferson County,2018-Mar,106526,99321,7205,6.8
Jefferson County,2018-Apr,106347,99716,6631,6.2
Jefferson County,2018-May,106047,99818,6229,5.9
Jefferson County,2018-Jun,106705,99682,7023,6.6
Jefferson County,2018-Jul,106086,99047,7039,6.6
Jefferson County,2018-Aug,105558,98660,6898,6.5
Jefferson County,2018-Sep,105823,99355,6468,6.1
Jefferson County,2018-Oct,105452,99702,5750,5.5
Jefferson County,2018-Nov,105754,99907,5847,5.5
Jefferson County,2018-Dec,105584,99145,6439,6.1
Jefferson County,2019-Jan,105009,97798,7211,6.9
Jefferson County,2019-Feb,105389,98969,6420,6.1
Jefferson County,2019-Mar,104728,98930,5798,5.5
Jefferson County,2019-Apr,103971,98859,5112,4.9
Jefferson County,2019-May,103718,98380,5338,5.1
Jefferson County,2019-Jun,104362,97808,6554,6.3
Jefferson County,2019-Jul,104307,97371,6936,6.6
Jefferson County,2019-Aug,104307,97595,6712,6.4
Jefferson County,2019-Sep,104782,98659,6123,5.8
Jefferson County,2019-Oct,105128,99486,5642,5.4
Jefferson County,2019-Nov,105175,99471,5704,5.4
Jefferson County,2019-Dec,104957,99041,5916,5.6
Jefferson County,2020-Jan,104675,98133,6542,6.2
Jefferson County,2020-Feb,105154,99315,5839,5.6
Jefferson County,2020-Mar,104875,95463,9412,9
Jefferson County,2020-Apr,101467,83687,17780,17.5
Jefferson County,2020-May,104398,86054,18344,17.6
Jefferson County,2020-Jun,104483,87910,16573,15.9
Jefferson County,2020-Jul,104324,88699,15625,15
Jefferson County,2020-Aug,103764,90871,12893,12.4
Jefferson County,2020-Sep,103886,91177,12709,12.2
Jefferson County,2020-Oct,103229,92372,10857,10.5
Jefferson County,2020-Nov,104207,92941,11266,10.8
Jefferson County,2020-Dec,103832,92204,11628,11.2
Jefferson County,2021-Jan,103149,90721,12428,12
Jefferson County,2021-Feb,103234,91048,12186,11.8
Jefferson County,2021-Mar,102919,91869,11050,10.7
Jefferson County,2021-Apr,102334,91726,10608,10.4
Jefferson County,2021-May,101442,91069,10373,10.2
Jefferson County,2021-Jun,101879,90502,11377,11.2
Jefferson County,2021-Jul,101460,90743,10717,10.6
Jefferson County,2021-Aug,101094,91037,10057,9.9
Jefferson County,2021-Sep,100543,91548,8995,8.9
Jefferson County,2021-Oct,100463,92075,8388,8.3
Jefferson County,2021-Nov,101045,92865,8180,8.1
Jefferson County,2021-Dec,101135,93130,8005,7.9
Jefferson County,2022-Jan,102226,93113,9113,8.9
Jefferson County,2022-Feb,102681,94098,8583,8.4
Jefferson County,2022-Mar,101771,94715,7056,6.9
Jefferson County,2022-Apr,101060,94384,6676,6.6
Jefferson County,2022-May,101009,94113,6896,6.8
Jefferson County,2022-Jun,101699,93924,7775,7.6
Jefferson County,2022-Jul,101459(P),93615(P),7844(P),7.7(P)
Jim Hogg County,2012-Jan,2326,2165,161,6.9
Jim Hogg County,2012-Feb,2345,2178,167,7.1
Jim Hogg County,2012-Mar,2307,2156,151,6.5
Jim Hogg County,2012-Apr,2332,2187,145,6.2
Jim Hogg County,2012-May,2331,2182,149,6.4
Jim Hogg County,2012-Jun,2335,2173,162,6.9
Jim Hogg County,2012-Jul,2379,2217,162,6.8
Jim Hogg County,2012-Aug,2368,2212,156,6.6
Jim Hogg County,2012-Sep,2395,2251,144,6
Jim Hogg County,2012-Oct,2368,2225,143,6
Jim Hogg County,2012-Nov,2317,2170,147,6.3
Jim Hogg County,2012-Dec,2332,2179,153,6.6
Jim Hogg County,2013-Jan,2371,2194,177,7.5
Jim Hogg County,2013-Feb,2373,2214,159,6.7
Jim Hogg County,2013-Mar,2335,2175,160,6.9
Jim Hogg County,2013-Apr,2312,2162,150,6.5
Jim Hogg County,2013-May,2290,2132,158,6.9
Jim Hogg County,2013-Jun,2304,2119,185,8
Jim Hogg County,2013-Jul,2351,2173,178,7.6
Jim Hogg County,2013-Aug,2301,2125,176,7.6
Jim Hogg County,2013-Sep,2301,2126,175,7.6
Jim Hogg County,2013-Oct,2302,2134,168,7.3
Jim Hogg County,2013-Nov,2311,2154,157,6.8
Jim Hogg County,2013-Dec,2300,2153,147,6.4
Jim Hogg County,2014-Jan,2245,2087,158,7
Jim Hogg County,2014-Feb,2262,2104,158,7
Jim Hogg County,2014-Mar,2216,2064,152,6.9
Jim Hogg County,2014-Apr,2253,2126,127,5.6
Jim Hogg County,2014-May,2258,2124,134,5.9
Jim Hogg County,2014-Jun,2245,2103,142,6.3
Jim Hogg County,2014-Jul,2270,2127,143,6.3
Jim Hogg County,2014-Aug,2196,2056,140,6.4
Jim Hogg County,2014-Sep,2208,2084,124,5.6
Jim Hogg County,2014-Oct,2109,1990,119,5.6
Jim Hogg County,2014-Nov,2076,1956,120,5.8
Jim Hogg County,2014-Dec,2011,1909,102,5.1
Jim Hogg County,2015-Jan,2030,1914,116,5.7
Jim Hogg County,2015-Feb,2021,1897,124,6.1
Jim Hogg County,2015-Mar,2035,1903,132,6.5
Jim Hogg County,2015-Apr,2043,1906,137,6.7
Jim Hogg County,2015-May,2055,1902,153,7.4
Jim Hogg County,2015-Jun,2050,1877,173,8.4
Jim Hogg County,2015-Jul,2071,1902,169,8.2
Jim Hogg County,2015-Aug,2054,1895,159,7.7
Jim Hogg County,2015-Sep,2045,1903,142,6.9
Jim Hogg County,2015-Oct,1976,1830,146,7.4
Jim Hogg County,2015-Nov,1987,1830,157,7.9
Jim Hogg County,2015-Dec,1979,1821,158,8
Jim Hogg County,2016-Jan,1949,1787,162,8.3
Jim Hogg County,2016-Feb,1985,1810,175,8.8
Jim Hogg County,2016-Mar,1988,1800,188,9.5
Jim Hogg County,2016-Apr,1986,1796,190,9.6
Jim Hogg County,2016-May,1930,1756,174,9
Jim Hogg County,2016-Jun,1932,1736,196,10.1
Jim Hogg County,2016-Jul,1937,1733,204,10.5
Jim Hogg County,2016-Aug,1924,1730,194,10.1
Jim Hogg County,2016-Sep,1956,1754,202,10.3
Jim Hogg County,2016-Oct,1918,1737,181,9.4
Jim Hogg County,2016-Nov,1903,1725,178,9.4
Jim Hogg County,2016-Dec,1935,1745,190,9.8
Jim Hogg County,2017-Jan,1904,1710,194,10.2
Jim Hogg County,2017-Feb,1912,1735,177,9.3
Jim Hogg County,2017-Mar,1903,1749,154,8.1
Jim Hogg County,2017-Apr,1898,1759,139,7.3
Jim Hogg County,2017-May,1876,1740,136,7.2
Jim Hogg County,2017-Jun,1912,1768,144,7.5
Jim Hogg County,2017-Jul,1875,1736,139,7.4
Jim Hogg County,2017-Aug,1867,1729,138,7.4
Jim Hogg County,2017-Sep,1907,1789,118,6.2
Jim Hogg County,2017-Oct,1884,1774,110,5.8
Jim Hogg County,2017-Nov,1878,1763,115,6.1
Jim Hogg County,2017-Dec,1892,1784,108,5.7
Jim Hogg County,2018-Jan,1833,1716,117,6.4
Jim Hogg County,2018-Feb,1861,1749,112,6
Jim Hogg County,2018-Mar,1849,1742,107,5.8
Jim Hogg County,2018-Apr,1867,1770,97,5.2
Jim Hogg County,2018-May,1851,1754,97,5.2
Jim Hogg County,2018-Jun,1852,1740,112,6
Jim Hogg County,2018-Jul,1852,1738,114,6.2
Jim Hogg County,2018-Aug,1855,1741,114,6.1
Jim Hogg County,2018-Sep,1867,1759,108,5.8
Jim Hogg County,2018-Oct,1859,1754,105,5.6
Jim Hogg County,2018-Nov,1885,1790,95,5
Jim Hogg County,2018-Dec,1903,1800,103,5.4
Jim Hogg County,2019-Jan,1890,1778,112,5.9
Jim Hogg County,2019-Feb,1889,1783,106,5.6
Jim Hogg County,2019-Mar,1879,1783,96,5.1
Jim Hogg County,2019-Apr,1880,1800,80,4.3
Jim Hogg County,2019-May,1853,1775,78,4.2
Jim Hogg County,2019-Jun,1828,1733,95,5.2
Jim Hogg County,2019-Jul,1827,1735,92,5
Jim Hogg County,2019-Aug,1830,1739,91,5
Jim Hogg County,2019-Sep,1851,1770,81,4.4
Jim Hogg County,2019-Oct,1866,1786,80,4.3
Jim Hogg County,2019-Nov,1855,1772,83,4.5
Jim Hogg County,2019-Dec,1866,1787,79,4.2
Jim Hogg County,2020-Jan,1861,1773,88,4.7
Jim Hogg County,2020-Feb,1864,1783,81,4.3
Jim Hogg County,2020-Mar,1839,1720,119,6.5
Jim Hogg County,2020-Apr,1755,1573,182,10.4
Jim Hogg County,2020-May,1835,1619,216,11.8
Jim Hogg County,2020-Jun,1880,1648,232,12.3
Jim Hogg County,2020-Jul,1914,1677,237,12.4
Jim Hogg County,2020-Aug,1922,1716,206,10.7
Jim Hogg County,2020-Sep,1887,1682,205,10.9
Jim Hogg County,2020-Oct,1871,1685,186,9.9
Jim Hogg County,2020-Nov,1868,1669,199,10.7
Jim Hogg County,2020-Dec,1859,1670,189,10.2
Jim Hogg County,2021-Jan,1811,1606,205,11.3
Jim Hogg County,2021-Feb,1838,1654,184,10
Jim Hogg County,2021-Mar,1860,1686,174,9.4
Jim Hogg County,2021-Apr,1879,1709,170,9
Jim Hogg County,2021-May,1871,1706,165,8.8
Jim Hogg County,2021-Jun,1862,1679,183,9.8
Jim Hogg County,2021-Jul,1902,1730,172,9
Jim Hogg County,2021-Aug,1876,1715,161,8.6
Jim Hogg County,2021-Sep,1867,1721,146,7.8
Jim Hogg County,2021-Oct,1853,1713,140,7.6
Jim Hogg County,2021-Nov,1847,1708,139,7.5
Jim Hogg County,2021-Dec,1849,1718,131,7.1
Jim Hogg County,2022-Jan,1806,1661,145,8
Jim Hogg County,2022-Feb,1850,1699,151,8.2
Jim Hogg County,2022-Mar,1855,1737,118,6.4
Jim Hogg County,2022-Apr,1819,1707,112,6.2
Jim Hogg County,2022-May,1821,1711,110,6
Jim Hogg County,2022-Jun,1808,1688,120,6.6
Jim Hogg County,2022-Jul,1828(P),1716(P),112(P),6.1(P)
Jim Wells County,2012-Jan,20502,19119,1383,6.7
Jim Wells County,2012-Feb,20607,19258,1349,6.5
Jim Wells County,2012-Mar,20669,19443,1226,5.9
Jim Wells County,2012-Apr,20773,19601,1172,5.6
Jim Wells County,2012-May,20885,19646,1239,5.9
Jim Wells County,2012-Jun,20998,19589,1409,6.7
Jim Wells County,2012-Jul,20783,19379,1404,6.8
Jim Wells County,2012-Aug,20559,19250,1309,6.4
Jim Wells County,2012-Sep,20462,19273,1189,5.8
Jim Wells County,2012-Oct,20436,19261,1175,5.7
Jim Wells County,2012-Nov,20307,19155,1152,5.7
Jim Wells County,2012-Dec,20293,19099,1194,5.9
Jim Wells County,2013-Jan,20230,18916,1314,6.5
Jim Wells County,2013-Feb,20224,18965,1259,6.2
Jim Wells County,2013-Mar,20123,18917,1206,6
Jim Wells County,2013-Apr,20105,18962,1143,5.7
Jim Wells County,2013-May,20134,18908,1226,6.1
Jim Wells County,2013-Jun,20353,18967,1386,6.8
Jim Wells County,2013-Jul,20307,18933,1374,6.8
Jim Wells County,2013-Aug,20126,18826,1300,6.5
Jim Wells County,2013-Sep,20048,18787,1261,6.3
Jim Wells County,2013-Oct,19856,18672,1184,6
Jim Wells County,2013-Nov,19860,18706,1154,5.8
Jim Wells County,2013-Dec,19866,18778,1088,5.5
Jim Wells County,2014-Jan,19956,18809,1147,5.7
Jim Wells County,2014-Feb,20030,18853,1177,5.9
Jim Wells County,2014-Mar,19994,18875,1119,5.6
Jim Wells County,2014-Apr,19949,18954,995,5
Jim Wells County,2014-May,20018,18952,1066,5.3
Jim Wells County,2014-Jun,20179,19004,1175,5.8
Jim Wells County,2014-Jul,20222,19023,1199,5.9
Jim Wells County,2014-Aug,20007,18900,1107,5.5
Jim Wells County,2014-Sep,20136,19133,1003,5
Jim Wells County,2014-Oct,20234,19271,963,4.8
Jim Wells County,2014-Nov,20183,19240,943,4.7
Jim Wells County,2014-Dec,20018,19165,853,4.3
Jim Wells County,2015-Jan,19911,18888,1023,5.1
Jim Wells County,2015-Feb,19853,18737,1116,5.6
Jim Wells County,2015-Mar,19695,18462,1233,6.3
Jim Wells County,2015-Apr,19499,18123,1376,7.1
Jim Wells County,2015-May,19561,18035,1526,7.8
Jim Wells County,2015-Jun,19497,17785,1712,8.8
Jim Wells County,2015-Jul,19103,17360,1743,9.1
Jim Wells County,2015-Aug,18963,17200,1763,9.3
Jim Wells County,2015-Sep,18820,17090,1730,9.2
Jim Wells County,2015-Oct,18697,17000,1697,9.1
Jim Wells County,2015-Nov,18654,16900,1754,9.4
Jim Wells County,2015-Dec,18511,16845,1666,9
Jim Wells County,2016-Jan,18018,16336,1682,9.3
Jim Wells County,2016-Feb,18092,16380,1712,9.5
Jim Wells County,2016-Mar,18213,16292,1921,10.5
Jim Wells County,2016-Apr,17623,15729,1894,10.7
Jim Wells County,2016-May,17414,15552,1862,10.7
Jim Wells County,2016-Jun,17457,15369,2088,12
Jim Wells County,2016-Jul,17265,15194,2071,12
Jim Wells County,2016-Aug,17155,15166,1989,11.6
Jim Wells County,2016-Sep,17132,15231,1901,11.1
Jim Wells County,2016-Oct,17156,15444,1712,10
Jim Wells County,2016-Nov,17158,15491,1667,9.7
Jim Wells County,2016-Dec,16960,15314,1646,9.7
Jim Wells County,2017-Jan,16734,15022,1712,10.2
Jim Wells County,2017-Feb,16832,15222,1610,9.6
Jim Wells County,2017-Mar,16871,15428,1443,8.6
Jim Wells County,2017-Apr,16756,15424,1332,7.9
Jim Wells County,2017-May,16691,15474,1217,7.3
Jim Wells County,2017-Jun,16887,15596,1291,7.6
Jim Wells County,2017-Jul,16437,15203,1234,7.5
Jim Wells County,2017-Aug,16316,15079,1237,7.6
Jim Wells County,2017-Sep,16356,15271,1085,6.6
Jim Wells County,2017-Oct,16148,15157,991,6.1
Jim Wells County,2017-Nov,16062,15038,1024,6.4
Jim Wells County,2017-Dec,16341,15338,1003,6.1
Jim Wells County,2018-Jan,16636,15550,1086,6.5
Jim Wells County,2018-Feb,16828,15769,1059,6.3
Jim Wells County,2018-Mar,16926,15931,995,5.9
Jim Wells County,2018-Apr,16963,16053,910,5.4
Jim Wells County,2018-May,16907,16035,872,5.2
Jim Wells County,2018-Jun,16991,15980,1011,6
Jim Wells County,2018-Jul,16924,15949,975,5.8
Jim Wells County,2018-Aug,16814,15914,900,5.4
Jim Wells County,2018-Sep,16848,15999,849,5
Jim Wells County,2018-Oct,16703,15919,784,4.7
Jim Wells County,2018-Nov,16714,15917,797,4.8
Jim Wells County,2018-Dec,16667,15868,799,4.8
Jim Wells County,2019-Jan,16787,15924,863,5.1
Jim Wells County,2019-Feb,16866,16044,822,4.9
Jim Wells County,2019-Mar,16751,15970,781,4.7
Jim Wells County,2019-Apr,16746,16080,666,4
Jim Wells County,2019-May,16651,15973,678,4.1
Jim Wells County,2019-Jun,16752,15914,838,5
Jim Wells County,2019-Jul,16677,15828,849,5.1
Jim Wells County,2019-Aug,16579,15777,802,4.8
Jim Wells County,2019-Sep,16476,15751,725,4.4
Jim Wells County,2019-Oct,16568,15808,760,4.6
Jim Wells County,2019-Nov,16542,15730,812,4.9
Jim Wells County,2019-Dec,16471,15662,809,4.9
Jim Wells County,2020-Jan,16500,15613,887,5.4
Jim Wells County,2020-Feb,16477,15656,821,5
Jim Wells County,2020-Mar,16430,15075,1355,8.2
Jim Wells County,2020-Apr,15754,13271,2483,15.8
Jim Wells County,2020-May,16159,13287,2872,17.8
Jim Wells County,2020-Jun,16104,13272,2832,17.6
Jim Wells County,2020-Jul,16044,13242,2802,17.5
Jim Wells County,2020-Aug,15775,13432,2343,14.9
Jim Wells County,2020-Sep,15757,13452,2305,14.6
Jim Wells County,2020-Oct,15698,13616,2082,13.3
Jim Wells County,2020-Nov,15677,13552,2125,13.6
Jim Wells County,2020-Dec,15590,13564,2026,13
Jim Wells County,2021-Jan,15758,13752,2006,12.7
Jim Wells County,2021-Feb,15805,13898,1907,12.1
Jim Wells County,2021-Mar,15838,14027,1811,11.4
Jim Wells County,2021-Apr,15816,14114,1702,10.8
Jim Wells County,2021-May,15585,13988,1597,10.2
Jim Wells County,2021-Jun,15764,13976,1788,11.3
Jim Wells County,2021-Jul,15743,14083,1660,10.5
Jim Wells County,2021-Aug,15530,14028,1502,9.7
Jim Wells County,2021-Sep,15487,14115,1372,8.9
Jim Wells County,2021-Oct,15404,14093,1311,8.5
Jim Wells County,2021-Nov,15301,14077,1224,8
Jim Wells County,2021-Dec,15256,14077,1179,7.7
Jim Wells County,2022-Jan,15495,14191,1304,8.4
Jim Wells County,2022-Feb,15606,14329,1277,8.2
Jim Wells County,2022-Mar,15588,14512,1076,6.9
Jim Wells County,2022-Apr,15399,14423,976,6.3
Jim Wells County,2022-May,15358,14366,992,6.5
Jim Wells County,2022-Jun,15418,14285,1133,7.3
Jim Wells County,2022-Jul,15515(P),14380(P),1135(P),7.3(P)
Johnson County,2012-Jan,72071,66876,5195,7.2
Johnson County,2012-Feb,72507,67386,5121,7.1
Johnson County,2012-Mar,72560,67692,4868,6.7
Johnson County,2012-Apr,72486,68030,4456,6.1
Johnson County,2012-May,72931,68208,4723,6.5
Johnson County,2012-Jun,73570,68235,5335,7.3
Johnson County,2012-Jul,73483,68160,5323,7.2
Johnson County,2012-Aug,73134,68143,4991,6.8
Johnson County,2012-Sep,73119,68550,4569,6.2
Johnson County,2012-Oct,73242,68777,4465,6.1
Johnson County,2012-Nov,73299,68955,4344,5.9
Johnson County,2012-Dec,73426,69005,4421,6
Johnson County,2013-Jan,72817,67739,5078,7
Johnson County,2013-Feb,72915,68205,4710,6.5
Johnson County,2013-Mar,72982,68376,4606,6.3
Johnson County,2013-Apr,73233,68925,4308,5.9
Johnson County,2013-May,73706,69195,4511,6.1
Johnson County,2013-Jun,74179,69117,5062,6.8
Johnson County,2013-Jul,74089,69222,4867,6.6
Johnson County,2013-Aug,73809,69256,4553,6.2
Johnson County,2013-Sep,73964,69516,4448,6
Johnson County,2013-Oct,73363,69045,4318,5.9
Johnson County,2013-Nov,73757,69670,4087,5.5
Johnson County,2013-Dec,73670,69800,3870,5.3
Johnson County,2014-Jan,73278,69130,4148,5.7
Johnson County,2014-Feb,73788,69632,4156,5.6
Johnson County,2014-Mar,74163,70095,4068,5.5
Johnson County,2014-Apr,73977,70478,3499,4.7
Johnson County,2014-May,74371,70581,3790,5.1
Johnson County,2014-Jun,74815,70638,4177,5.6
Johnson County,2014-Jul,74777,70547,4230,5.7
Johnson County,2014-Aug,74469,70458,4011,5.4
Johnson County,2014-Sep,74339,70683,3656,4.9
Johnson County,2014-Oct,74411,70991,3420,4.6
Johnson County,2014-Nov,74480,71142,3338,4.5
Johnson County,2014-Dec,74286,71262,3024,4.1
Johnson County,2015-Jan,73657,70273,3384,4.6
Johnson County,2015-Feb,73761,70506,3255,4.4
Johnson County,2015-Mar,73661,70406,3255,4.4
Johnson County,2015-Apr,74014,71029,2985,4
Johnson County,2015-May,74423,71244,3179,4.3
Johnson County,2015-Jun,74524,71002,3522,4.7
Johnson County,2015-Jul,74632,71016,3616,4.8
Johnson County,2015-Aug,74486,71104,3382,4.5
Johnson County,2015-Sep,74317,71016,3301,4.4
Johnson County,2015-Oct,74549,71262,3287,4.4
Johnson County,2015-Nov,74848,71598,3250,4.3
Johnson County,2015-Dec,74974,71928,3046,4.1
Johnson County,2016-Jan,74755,71500,3255,4.4
Johnson County,2016-Feb,75501,72224,3277,4.3
Johnson County,2016-Mar,75612,72336,3276,4.3
Johnson County,2016-Apr,75755,72671,3084,4.1
Johnson County,2016-May,75788,72741,3047,4
Johnson County,2016-Jun,76191,72580,3611,4.7
Johnson County,2016-Jul,76529,72839,3690,4.8
Johnson County,2016-Aug,76426,72885,3541,4.6
Johnson County,2016-Sep,76561,73110,3451,4.5
Johnson County,2016-Oct,76299,73055,3244,4.3
Johnson County,2016-Nov,76800,73604,3196,4.2
Johnson County,2016-Dec,76649,73489,3160,4.1
Johnson County,2017-Jan,76434,73031,3403,4.5
Johnson County,2017-Feb,76907,73455,3452,4.5
Johnson County,2017-Mar,77155,73862,3293,4.3
Johnson County,2017-Apr,77102,74320,2782,3.6
Johnson County,2017-May,76935,74108,2827,3.7
Johnson County,2017-Jun,77461,74300,3161,4.1
Johnson County,2017-Jul,77896,74738,3158,4.1
Johnson County,2017-Aug,77874,74790,3084,4
Johnson County,2017-Sep,78144,75438,2706,3.5
Johnson County,2017-Oct,77744,75257,2487,3.2
Johnson County,2017-Nov,78305,75655,2650,3.4
Johnson County,2017-Dec,78093,75524,2569,3.3
Johnson County,2018-Jan,78505,75579,2926,3.7
Johnson County,2018-Feb,79291,76393,2898,3.7
Johnson County,2018-Mar,79184,76344,2840,3.6
Johnson County,2018-Apr,79294,76770,2524,3.2
Johnson County,2018-May,79366,76846,2520,3.2
Johnson County,2018-Jun,79967,76912,3055,3.8
Johnson County,2018-Jul,80147,77136,3011,3.8
Johnson County,2018-Aug,79684,76827,2857,3.6
Johnson County,2018-Sep,79851,77161,2690,3.4
Johnson County,2018-Oct,80153,77578,2575,3.2
Johnson County,2018-Nov,80378,77789,2589,3.2
Johnson County,2018-Dec,80442,77816,2626,3.3
Johnson County,2019-Jan,81475,78296,3179,3.9
Johnson County,2019-Feb,81693,78953,2740,3.4
Johnson County,2019-Mar,81701,78999,2702,3.3
Johnson County,2019-Apr,81277,79070,2207,2.7
Johnson County,2019-May,81393,79139,2254,2.8
Johnson County,2019-Jun,82175,79316,2859,3.5
Johnson County,2019-Jul,82604,79688,2916,3.5
Johnson County,2019-Aug,82539,79757,2782,3.4
Johnson County,2019-Sep,82880,80273,2607,3.1
Johnson County,2019-Oct,83273,80714,2559,3.1
Johnson County,2019-Nov,83761,81208,2553,3
Johnson County,2019-Dec,83600,81225,2375,2.8
Johnson County,2020-Jan,83912,81184,2728,3.3
Johnson County,2020-Feb,84397,81786,2611,3.1
Johnson County,2020-Mar,82953,78935,4018,4.8
Johnson County,2020-Apr,77423,69299,8124,10.5
Johnson County,2020-May,80103,72059,8044,10
Johnson County,2020-Jun,82031,74661,7370,9
Johnson County,2020-Jul,82581,75915,6666,8.1
Johnson County,2020-Aug,82979,77639,5340,6.4
Johnson County,2020-Sep,83192,78028,5164,6.2
Johnson County,2020-Oct,84483,79896,4587,5.4
Johnson County,2020-Nov,84884,80007,4877,5.7
Johnson County,2020-Dec,85055,80154,4901,5.8
Johnson County,2021-Jan,84524,79374,5150,6.1
Johnson County,2021-Feb,84894,79816,5078,6
Johnson County,2021-Mar,85060,80261,4799,5.6
Johnson County,2021-Apr,84825,80600,4225,5
Johnson County,2021-May,84718,80631,4087,4.8
Johnson County,2021-Jun,85427,80724,4703,5.5
Johnson County,2021-Jul,85507,81287,4220,4.9
Johnson County,2021-Aug,85517,81594,3923,4.6
Johnson County,2021-Sep,85710,82025,3685,4.3
Johnson County,2021-Oct,86268,82726,3542,4.1
Johnson County,2021-Nov,87178,83839,3339,3.8
Johnson County,2021-Dec,87049,83989,3060,3.5
Johnson County,2022-Jan,86806,83315,3491,4
Johnson County,2022-Feb,87934,84434,3500,4
Johnson County,2022-Mar,88115,85254,2861,3.2
Johnson County,2022-Apr,87708,85051,2657,3
Johnson County,2022-May,87951,85126,2825,3.2
Johnson County,2022-Jun,88201,84856,3345,3.8
Johnson County,2022-Jul,88719(P),85355(P),3364(P),3.8(P)
Jones County,2012-Jan,5890,5420,470,8
Jones County,2012-Feb,5896,5438,458,7.8
Jones County,2012-Mar,5912,5475,437,7.4
Jones County,2012-Apr,5914,5502,412,7
Jones County,2012-May,5901,5476,425,7.2
Jones County,2012-Jun,5933,5466,467,7.9
Jones County,2012-Jul,5946,5483,463,7.8
Jones County,2012-Aug,5862,5436,426,7.3
Jones County,2012-Sep,5880,5490,390,6.6
Jones County,2012-Oct,5883,5506,377,6.4
Jones County,2012-Nov,5853,5494,359,6.1
Jones County,2012-Dec,5816,5441,375,6.4
Jones County,2013-Jan,5768,5347,421,7.3
Jones County,2013-Feb,5780,5384,396,6.9
Jones County,2013-Mar,5750,5366,384,6.7
Jones County,2013-Apr,5839,5472,367,6.3
Jones County,2013-May,5879,5482,397,6.8
Jones County,2013-Jun,5912,5467,445,7.5
Jones County,2013-Jul,5905,5474,431,7.3
Jones County,2013-Aug,5814,5402,412,7.1
Jones County,2013-Sep,5864,5464,400,6.8
Jones County,2013-Oct,5869,5489,380,6.5
Jones County,2013-Nov,5847,5480,367,6.3
Jones County,2013-Dec,5825,5478,347,6
Jones County,2014-Jan,5768,5409,359,6.2
Jones County,2014-Feb,5817,5470,347,6
Jones County,2014-Mar,5826,5478,348,6
Jones County,2014-Apr,5861,5557,304,5.2
Jones County,2014-May,5887,5558,329,5.6
Jones County,2014-Jun,5863,5519,344,5.9
Jones County,2014-Jul,5847,5493,354,6.1
Jones County,2014-Aug,5768,5422,346,6
Jones County,2014-Sep,5772,5463,309,5.4
Jones County,2014-Oct,5768,5469,299,5.2
Jones County,2014-Nov,5733,5445,288,5
Jones County,2014-Dec,5660,5408,252,4.5
Jones County,2015-Jan,5627,5329,298,5.3
Jones County,2015-Feb,5686,5389,297,5.2
Jones County,2015-Mar,5709,5399,310,5.4
Jones County,2015-Apr,5720,5427,293,5.1
Jones County,2015-May,5769,5441,328,5.7
Jones County,2015-Jun,5736,5396,340,5.9
Jones County,2015-Jul,5680,5336,344,6.1
Jones County,2015-Aug,5610,5294,316,5.6
Jones County,2015-Sep,5650,5323,327,5.8
Jones County,2015-Oct,5649,5327,322,5.7
Jones County,2015-Nov,5633,5315,318,5.6
Jones County,2015-Dec,5589,5311,278,5
Jones County,2016-Jan,5543,5235,308,5.6
Jones County,2016-Feb,5669,5366,303,5.3
Jones County,2016-Mar,5710,5374,336,5.9
Jones County,2016-Apr,5648,5357,291,5.2
Jones County,2016-May,5663,5363,300,5.3
Jones County,2016-Jun,5649,5307,342,6.1
Jones County,2016-Jul,5599,5248,351,6.3
Jones County,2016-Aug,5620,5277,343,6.1
Jones County,2016-Sep,5656,5287,369,6.5
Jones County,2016-Oct,5603,5270,333,5.9
Jones County,2016-Nov,5604,5275,329,5.9
Jones County,2016-Dec,5562,5246,316,5.7
Jones County,2017-Jan,5521,5176,345,6.2
Jones County,2017-Feb,5600,5271,329,5.9
Jones County,2017-Mar,5657,5369,288,5.1
Jones County,2017-Apr,5666,5377,289,5.1
Jones County,2017-May,5669,5361,308,5.4
Jones County,2017-Jun,5622,5308,314,5.6
Jones County,2017-Jul,5557,5237,320,5.8
Jones County,2017-Aug,5603,5289,314,5.6
Jones County,2017-Sep,5601,5323,278,5
Jones County,2017-Oct,5610,5342,268,4.8
Jones County,2017-Nov,5601,5313,288,5.1
Jones County,2017-Dec,5587,5317,270,4.8
Jones County,2018-Jan,5457,5159,298,5.5
Jones County,2018-Feb,5552,5257,295,5.3
Jones County,2018-Mar,5600,5328,272,4.9
Jones County,2018-Apr,5603,5350,253,4.5
Jones County,2018-May,5628,5385,243,4.3
Jones County,2018-Jun,5596,5314,282,5
Jones County,2018-Jul,5560,5285,275,4.9
Jones County,2018-Aug,5556,5282,274,4.9
Jones County,2018-Sep,5574,5304,270,4.8
Jones County,2018-Oct,5579,5320,259,4.6
Jones County,2018-Nov,5567,5312,255,4.6
Jones County,2018-Dec,5526,5276,250,4.5
Jones County,2019-Jan,5574,5290,284,5.1
Jones County,2019-Feb,5648,5392,256,4.5
Jones County,2019-Mar,5722,5453,269,4.7
Jones County,2019-Apr,5657,5457,200,3.5
Jones County,2019-May,5672,5468,204,3.6
Jones County,2019-Jun,5688,5429,259,4.6
Jones County,2019-Jul,5731,5460,271,4.7
Jones County,2019-Aug,5782,5517,265,4.6
Jones County,2019-Sep,5777,5537,240,4.2
Jones County,2019-Oct,5813,5588,225,3.9
Jones County,2019-Nov,5766,5547,219,3.8
Jones County,2019-Dec,5771,5549,222,3.8
Jones County,2020-Jan,5630,5396,234,4.2
Jones County,2020-Feb,5666,5453,213,3.8
Jones County,2020-Mar,5617,5274,343,6.1
Jones County,2020-Apr,5177,4725,452,8.7
Jones County,2020-May,5373,4874,499,9.3
Jones County,2020-Jun,5498,4988,510,9.3
Jones County,2020-Jul,5597,5093,504,9
Jones County,2020-Aug,5643,5238,405,7.2
Jones County,2020-Sep,5638,5236,402,7.1
Jones County,2020-Oct,5725,5353,372,6.5
Jones County,2020-Nov,5717,5323,394,6.9
Jones County,2020-Dec,5730,5324,406,7.1
Jones County,2021-Jan,5732,5313,419,7.3
Jones County,2021-Feb,5782,5362,420,7.3
Jones County,2021-Mar,5849,5410,439,7.5
Jones County,2021-Apr,5765,5416,349,6.1
Jones County,2021-May,5698,5357,341,6
Jones County,2021-Jun,5728,5331,397,6.9
Jones County,2021-Jul,5714,5351,363,6.4
Jones County,2021-Aug,5674,5346,328,5.8
Jones County,2021-Sep,5721,5405,316,5.5
Jones County,2021-Oct,5720,5414,306,5.3
Jones County,2021-Nov,5702,5413,289,5.1
Jones County,2021-Dec,5670,5405,265,4.7
Jones County,2022-Jan,5694,5395,299,5.3
Jones County,2022-Feb,5820,5526,294,5.1
Jones County,2022-Mar,5843,5610,233,4
Jones County,2022-Apr,5779,5555,224,3.9
Jones County,2022-May,5726,5484,242,4.2
Jones County,2022-Jun,5736,5444,292,5.1
Jones County,2022-Jul,5832(P),5536(P),296(P),5.1(P)
Karnes County,2012-Jan,4938,4605,333,6.7
Karnes County,2012-Feb,4964,4636,328,6.6
Karnes County,2012-Mar,5034,4722,312,6.2
Karnes County,2012-Apr,5117,4829,288,5.6
Karnes County,2012-May,5180,4869,311,6
Karnes County,2012-Jun,5268,4895,373,7.1
Karnes County,2012-Jul,5503,5127,376,6.8
Karnes County,2012-Aug,5429,5095,334,6.2
Karnes County,2012-Sep,5446,5138,308,5.7
Karnes County,2012-Oct,5465,5167,298,5.5
Karnes County,2012-Nov,5492,5206,286,5.2
Karnes County,2012-Dec,5466,5180,286,5.2
Karnes County,2013-Jan,5521,5201,320,5.8
Karnes County,2013-Feb,5522,5213,309,5.6
Karnes County,2013-Mar,5527,5215,312,5.6
Karnes County,2013-Apr,5546,5266,280,5
Karnes County,2013-May,5565,5264,301,5.4
Karnes County,2013-Jun,5637,5282,355,6.3
Karnes County,2013-Jul,5692,5350,342,6
Karnes County,2013-Aug,5643,5329,314,5.6
Karnes County,2013-Sep,5654,5355,299,5.3
Karnes County,2013-Oct,5675,5390,285,5
Karnes County,2013-Nov,5672,5404,268,4.7
Karnes County,2013-Dec,5695,5444,251,4.4
Karnes County,2014-Jan,5835,5565,270,4.6
Karnes County,2014-Feb,5944,5677,267,4.5
Karnes County,2014-Mar,5999,5753,246,4.1
Karnes County,2014-Apr,6028,5817,211,3.5
Karnes County,2014-May,6142,5912,230,3.7
Karnes County,2014-Jun,6192,5947,245,4
Karnes County,2014-Jul,6544,6290,254,3.9
Karnes County,2014-Aug,6433,6200,233,3.6
Karnes County,2014-Sep,6390,6166,224,3.5
Karnes County,2014-Oct,6590,6372,218,3.3
Karnes County,2014-Nov,6560,6356,204,3.1
Karnes County,2014-Dec,6528,6341,187,2.9
Karnes County,2015-Jan,6537,6314,223,3.4
Karnes County,2015-Feb,6593,6358,235,3.6
Karnes County,2015-Mar,6613,6376,237,3.6
Karnes County,2015-Apr,6589,6338,251,3.8
Karnes County,2015-May,6561,6295,266,4.1
Karnes County,2015-Jun,6510,6211,299,4.6
Karnes County,2015-Jul,6429,6115,314,4.9
Karnes County,2015-Aug,6286,5992,294,4.7
Karnes County,2015-Sep,6238,5937,301,4.8
Karnes County,2015-Oct,6291,5987,304,4.8
Karnes County,2015-Nov,6342,6045,297,4.7
Karnes County,2015-Dec,6157,5890,267,4.3
Karnes County,2016-Jan,6356,6074,282,4.4
Karnes County,2016-Feb,6386,6093,293,4.6
Karnes County,2016-Mar,6243,5928,315,5
Karnes County,2016-Apr,6321,6003,318,5
Karnes County,2016-May,6292,5992,300,4.8
Karnes County,2016-Jun,6332,5994,338,5.3
Karnes County,2016-Jul,6273,5941,332,5.3
Karnes County,2016-Aug,6181,5854,327,5.3
Karnes County,2016-Sep,6272,5962,310,4.9
Karnes County,2016-Oct,6244,5955,289,4.6
Karnes County,2016-Nov,6241,5947,294,4.7
Karnes County,2016-Dec,6211,5922,289,4.7
Karnes County,2017-Jan,6346,6043,303,4.8
Karnes County,2017-Feb,6337,6070,267,4.2
Karnes County,2017-Mar,6435,6189,246,3.8
Karnes County,2017-Apr,6442,6218,224,3.5
Karnes County,2017-May,6403,6183,220,3.4
Karnes County,2017-Jun,6398,6166,232,3.6
Karnes County,2017-Jul,6446,6218,228,3.5
Karnes County,2017-Aug,6371,6144,227,3.6
Karnes County,2017-Sep,6389,6185,204,3.2
Karnes County,2017-Oct,6391,6216,175,2.7
Karnes County,2017-Nov,6432,6241,191,3
Karnes County,2017-Dec,6387,6214,173,2.7
Karnes County,2018-Jan,6497,6303,194,3
Karnes County,2018-Feb,6521,6317,204,3.1
Karnes County,2018-Mar,6610,6400,210,3.2
Karnes County,2018-Apr,6798,6618,180,2.6
Karnes County,2018-May,6825,6639,186,2.7
Karnes County,2018-Jun,6839,6621,218,3.2
Karnes County,2018-Jul,6888,6675,213,3.1
Karnes County,2018-Aug,6889,6690,199,2.9
Karnes County,2018-Sep,6833,6644,189,2.8
Karnes County,2018-Oct,6963,6778,185,2.7
Karnes County,2018-Nov,6962,6780,182,2.6
Karnes County,2018-Dec,6907,6730,177,2.6
Karnes County,2019-Jan,6943,6748,195,2.8
Karnes County,2019-Feb,7022,6836,186,2.6
Karnes County,2019-Mar,6963,6793,170,2.4
Karnes County,2019-Apr,7001,6848,153,2.2
Karnes County,2019-May,6989,6833,156,2.2
Karnes County,2019-Jun,7080,6889,191,2.7
Karnes County,2019-Jul,7134,6937,197,2.8
Karnes County,2019-Aug,7099,6916,183,2.6
Karnes County,2019-Sep,7140,6958,182,2.5
Karnes County,2019-Oct,7191,7015,176,2.4
Karnes County,2019-Nov,7148,6969,179,2.5
Karnes County,2019-Dec,7145,6982,163,2.3
Karnes County,2020-Jan,7399,7219,180,2.4
Karnes County,2020-Feb,7493,7312,181,2.4
Karnes County,2020-Mar,7360,7080,280,3.8
Karnes County,2020-Apr,6835,6392,443,6.5
Karnes County,2020-May,6796,6212,584,8.6
Karnes County,2020-Jun,6711,6121,590,8.8
Karnes County,2020-Jul,6782,6178,604,8.9
Karnes County,2020-Aug,6723,6220,503,7.5
Karnes County,2020-Sep,6692,6200,492,7.4
Karnes County,2020-Oct,6836,6379,457,6.7
Karnes County,2020-Nov,6890,6417,473,6.9
Karnes County,2020-Dec,6813,6366,447,6.6
Karnes County,2021-Jan,6953,6499,454,6.5
Karnes County,2021-Feb,7023,6590,433,6.2
Karnes County,2021-Mar,6997,6578,419,6
Karnes County,2021-Apr,6939,6570,369,5.3
Karnes County,2021-May,6887,6535,352,5.1
Karnes County,2021-Jun,6882,6482,400,5.8
Karnes County,2021-Jul,6769,6403,366,5.4
Karnes County,2021-Aug,6759,6426,333,4.9
Karnes County,2021-Sep,6689,6366,323,4.8
Karnes County,2021-Oct,6745,6447,298,4.4
Karnes County,2021-Nov,6766,6491,275,4.1
Karnes County,2021-Dec,6715,6460,255,3.8
Karnes County,2022-Jan,6912,6629,283,4.1
Karnes County,2022-Feb,6997,6720,277,4
Karnes County,2022-Mar,6982,6763,219,3.1
Karnes County,2022-Apr,6951,6736,215,3.1
Karnes County,2022-May,6910,6692,218,3.2
Karnes County,2022-Jun,6879,6625,254,3.7
Karnes County,2022-Jul,6936(P),6686(P),250(P),3.6(P)
Kaufman County,2012-Jan,50932,47123,3809,7.5
Kaufman County,2012-Feb,51242,47486,3756,7.3
Kaufman County,2012-Mar,51237,47657,3580,7
Kaufman County,2012-Apr,51222,47923,3299,6.4
Kaufman County,2012-May,51511,47999,3512,6.8
Kaufman County,2012-Jun,51816,47884,3932,7.6
Kaufman County,2012-Jul,51825,47919,3906,7.5
Kaufman County,2012-Aug,51537,47855,3682,7.1
Kaufman County,2012-Sep,51549,48179,3370,6.5
Kaufman County,2012-Oct,51721,48400,3321,6.4
Kaufman County,2012-Nov,51682,48465,3217,6.2
Kaufman County,2012-Dec,51691,48401,3290,6.4
Kaufman County,2013-Jan,51697,47990,3707,7.2
Kaufman County,2013-Feb,51731,48209,3522,6.8
Kaufman County,2013-Mar,51781,48363,3418,6.6
Kaufman County,2013-Apr,51948,48719,3229,6.2
Kaufman County,2013-May,52166,48838,3328,6.4
Kaufman County,2013-Jun,52597,48899,3698,7
Kaufman County,2013-Jul,52731,49174,3557,6.7
Kaufman County,2013-Aug,52679,49286,3393,6.4
Kaufman County,2013-Sep,52731,49429,3302,6.3
Kaufman County,2013-Oct,52440,49290,3150,6
Kaufman County,2013-Nov,52888,49868,3020,5.7
Kaufman County,2013-Dec,52757,49880,2877,5.5
Kaufman County,2014-Jan,52852,49775,3077,5.8
Kaufman County,2014-Feb,53052,49942,3110,5.9
Kaufman County,2014-Mar,53259,50224,3035,5.7
Kaufman County,2014-Apr,53158,50576,2582,4.9
Kaufman County,2014-May,53275,50557,2718,5.1
Kaufman County,2014-Jun,53668,50656,3012,5.6
Kaufman County,2014-Jul,53947,50876,3071,5.7
Kaufman County,2014-Aug,53834,50895,2939,5.5
Kaufman County,2014-Sep,53729,51026,2703,5
Kaufman County,2014-Oct,53809,51289,2520,4.7
Kaufman County,2014-Nov,53999,51513,2486,4.6
Kaufman County,2014-Dec,53803,51547,2256,4.2
Kaufman County,2015-Jan,54350,51798,2552,4.7
Kaufman County,2015-Feb,54456,52067,2389,4.4
Kaufman County,2015-Mar,54335,52015,2320,4.3
Kaufman County,2015-Apr,54653,52614,2039,3.7
Kaufman County,2015-May,54819,52661,2158,3.9
Kaufman County,2015-Jun,55166,52741,2425,4.4
Kaufman County,2015-Jul,55396,52987,2409,4.3
Kaufman County,2015-Aug,55358,53108,2250,4.1
Kaufman County,2015-Sep,55229,53018,2211,4
Kaufman County,2015-Oct,55491,53334,2157,3.9
Kaufman County,2015-Nov,55856,53678,2178,3.9
Kaufman County,2015-Dec,55896,53862,2034,3.6
Kaufman County,2016-Jan,56794,54609,2185,3.8
Kaufman County,2016-Feb,57301,55148,2153,3.8
Kaufman County,2016-Mar,57374,55158,2216,3.9
Kaufman County,2016-Apr,57429,55445,1984,3.5
Kaufman County,2016-May,57434,55476,1958,3.4
Kaufman County,2016-Jun,57865,55516,2349,4.1
Kaufman County,2016-Jul,58297,55866,2431,4.2
Kaufman County,2016-Aug,58295,55958,2337,4
Kaufman County,2016-Sep,58431,56140,2291,3.9
Kaufman County,2016-Oct,58537,56326,2211,3.8
Kaufman County,2016-Nov,58809,56686,2123,3.6
Kaufman County,2016-Dec,58716,56581,2135,3.6
Kaufman County,2017-Jan,59073,56708,2365,4
Kaufman County,2017-Feb,59439,57053,2386,4
Kaufman County,2017-Mar,59468,57184,2284,3.8
Kaufman County,2017-Apr,59626,57638,1988,3.3
Kaufman County,2017-May,59446,57409,2037,3.4
Kaufman County,2017-Jun,59849,57531,2318,3.9
Kaufman County,2017-Jul,60192,57918,2274,3.8
Kaufman County,2017-Aug,60150,57882,2268,3.8
Kaufman County,2017-Sep,60364,58353,2011,3.3
Kaufman County,2017-Oct,60122,58253,1869,3.1
Kaufman County,2017-Nov,60548,58566,1982,3.3
Kaufman County,2017-Dec,60297,58390,1907,3.2
Kaufman County,2018-Jan,61672,59489,2183,3.5
Kaufman County,2018-Feb,62273,60017,2256,3.6
Kaufman County,2018-Mar,62059,59826,2233,3.6
Kaufman County,2018-Apr,62135,60136,1999,3.2
Kaufman County,2018-May,62117,60122,1995,3.2
Kaufman County,2018-Jun,62703,60280,2423,3.9
Kaufman County,2018-Jul,62971,60579,2392,3.8
Kaufman County,2018-Aug,62548,60267,2281,3.6
Kaufman County,2018-Sep,62643,60453,2190,3.5
Kaufman County,2018-Oct,62894,60845,2049,3.3
Kaufman County,2018-Nov,63189,61121,2068,3.3
Kaufman County,2018-Dec,63157,61046,2111,3.3
Kaufman County,2019-Jan,65662,63179,2483,3.8
Kaufman County,2019-Feb,65922,63630,2292,3.5
Kaufman County,2019-Mar,65764,63575,2189,3.3
Kaufman County,2019-Apr,65740,63909,1831,2.8
Kaufman County,2019-May,65781,63887,1894,2.9
Kaufman County,2019-Jun,66438,64116,2322,3.5
Kaufman County,2019-Jul,66904,64519,2385,3.6
Kaufman County,2019-Aug,66789,64536,2253,3.4
Kaufman County,2019-Sep,66976,64865,2111,3.2
Kaufman County,2019-Oct,67487,65414,2073,3.1
Kaufman County,2019-Nov,67698,65640,2058,3
Kaufman County,2019-Dec,67535,65616,1919,2.8
Kaufman County,2020-Jan,69614,67371,2243,3.2
Kaufman County,2020-Feb,70013,67863,2150,3.1
Kaufman County,2020-Mar,68563,65308,3255,4.7
Kaufman County,2020-Apr,64252,57789,6463,10.1
Kaufman County,2020-May,66471,60018,6453,9.7
Kaufman County,2020-Jun,67954,61913,6041,8.9
Kaufman County,2020-Jul,68519,63029,5490,8
Kaufman County,2020-Aug,69266,64809,4457,6.4
Kaufman County,2020-Sep,69529,65231,4298,6.2
Kaufman County,2020-Oct,70399,66555,3844,5.5
Kaufman County,2020-Nov,70814,66813,4001,5.7
Kaufman County,2020-Dec,70910,66881,4029,5.7
Kaufman County,2021-Jan,70730,66486,4244,6
Kaufman County,2021-Feb,71212,66992,4220,5.9
Kaufman County,2021-Mar,70985,67049,3936,5.5
Kaufman County,2021-Apr,71237,67670,3567,5
Kaufman County,2021-May,71255,67784,3471,4.9
Kaufman County,2021-Jun,71737,67726,4011,5.6
Kaufman County,2021-Jul,72023,68407,3616,5
Kaufman County,2021-Aug,72144,68727,3417,4.7
Kaufman County,2021-Sep,72240,69081,3159,4.4
Kaufman County,2021-Oct,72787,69724,3063,4.2
Kaufman County,2021-Nov,73561,70701,2860,3.9
Kaufman County,2021-Dec,73382,70724,2658,3.6
Kaufman County,2022-Jan,73780,70737,3043,4.1
Kaufman County,2022-Feb,74561,71513,3048,4.1
Kaufman County,2022-Mar,74607,72083,2524,3.4
Kaufman County,2022-Apr,74764,72373,2391,3.2
Kaufman County,2022-May,75266,72720,2546,3.4
Kaufman County,2022-Jun,75527,72564,2963,3.9
Kaufman County,2022-Jul,75606(P),72593(P),3013(P),4.0(P)
Kendall County,2012-Jan,17175,16178,997,5.8
Kendall County,2012-Feb,17211,16236,975,5.7
Kendall County,2012-Mar,17262,16344,918,5.3
Kendall County,2012-Apr,17331,16468,863,5
Kendall County,2012-May,17354,16442,912,5.3
Kendall County,2012-Jun,17582,16545,1037,5.9
Kendall County,2012-Jul,17605,16553,1052,6
Kendall County,2012-Aug,17504,16528,976,5.6
Kendall County,2012-Sep,17588,16677,911,5.2
Kendall County,2012-Oct,17557,16662,895,5.1
Kendall County,2012-Nov,17556,16712,844,4.8
Kendall County,2012-Dec,17497,16630,867,5
Kendall County,2013-Jan,17909,16906,1003,5.6
Kendall County,2013-Feb,17987,17032,955,5.3
Kendall County,2013-Mar,17951,17019,932,5.2
Kendall County,2013-Apr,18160,17285,875,4.8
Kendall County,2013-May,18223,17301,922,5.1
Kendall County,2013-Jun,18411,17366,1045,5.7
Kendall County,2013-Jul,18472,17457,1015,5.5
Kendall County,2013-Aug,18272,17323,949,5.2
Kendall County,2013-Sep,18354,17404,950,5.2
Kendall County,2013-Oct,18209,17330,879,4.8
Kendall County,2013-Nov,18278,17428,850,4.7
Kendall County,2013-Dec,18260,17470,790,4.3
Kendall County,2014-Jan,18304,17454,850,4.6
Kendall County,2014-Feb,18526,17672,854,4.6
Kendall County,2014-Mar,18598,17782,816,4.4
Kendall County,2014-Apr,18615,17927,688,3.7
Kendall County,2014-May,18695,17941,754,4
Kendall County,2014-Jun,18809,17986,823,4.4
Kendall County,2014-Jul,18836,17979,857,4.5
Kendall County,2014-Aug,18630,17847,783,4.2
Kendall County,2014-Sep,18697,17962,735,3.9
Kendall County,2014-Oct,18780,18074,706,3.8
Kendall County,2014-Nov,18780,18079,701,3.7
Kendall County,2014-Dec,18544,17930,614,3.3
Kendall County,2015-Jan,18841,18141,700,3.7
Kendall County,2015-Feb,18946,18289,657,3.5
Kendall County,2015-Mar,19054,18429,625,3.3
Kendall County,2015-Apr,19158,18601,557,2.9
Kendall County,2015-May,19325,18698,627,3.2
Kendall County,2015-Jun,19288,18611,677,3.5
Kendall County,2015-Jul,19269,18574,695,3.6
Kendall County,2015-Aug,19105,18481,624,3.3
Kendall County,2015-Sep,19194,18557,637,3.3
Kendall County,2015-Oct,19258,18642,616,3.2
Kendall County,2015-Nov,19309,18692,617,3.2
Kendall County,2015-Dec,19258,18683,575,3
Kendall County,2016-Jan,19823,19199,624,3.1
Kendall County,2016-Feb,20170,19547,623,3.1
Kendall County,2016-Mar,20329,19701,628,3.1
Kendall County,2016-Apr,20378,19800,578,2.8
Kendall County,2016-May,20457,19865,592,2.9
Kendall County,2016-Jun,20482,19780,702,3.4
Kendall County,2016-Jul,20460,19732,728,3.6
Kendall County,2016-Aug,20454,19755,699,3.4
Kendall County,2016-Sep,20403,19697,706,3.5
Kendall County,2016-Oct,20404,19731,673,3.3
Kendall County,2016-Nov,20444,19808,636,3.1
Kendall County,2016-Dec,20435,19809,626,3.1
Kendall County,2017-Jan,20602,19906,696,3.4
Kendall County,2017-Feb,20830,20102,728,3.5
Kendall County,2017-Mar,21006,20314,692,3.3
Kendall County,2017-Apr,20968,20375,593,2.8
Kendall County,2017-May,20940,20316,624,3
Kendall County,2017-Jun,21052,20356,696,3.3
Kendall County,2017-Jul,20980,20278,702,3.3
Kendall County,2017-Aug,20975,20291,684,3.3
Kendall County,2017-Sep,20993,20374,619,2.9
Kendall County,2017-Oct,20932,20353,579,2.8
Kendall County,2017-Nov,20955,20350,605,2.9
Kendall County,2017-Dec,20990,20420,570,2.7
Kendall County,2018-Jan,21291,20644,647,3
Kendall County,2018-Feb,21540,20877,663,3.1
Kendall County,2018-Mar,21729,21080,649,3
Kendall County,2018-Apr,21719,21148,571,2.6
Kendall County,2018-May,21706,21132,574,2.6
Kendall County,2018-Jun,21757,21069,688,3.2
Kendall County,2018-Jul,21731,21065,666,3.1
Kendall County,2018-Aug,21663,21007,656,3
Kendall County,2018-Sep,21640,21005,635,2.9
Kendall County,2018-Oct,21626,21014,612,2.8
Kendall County,2018-Nov,21683,21044,639,2.9
Kendall County,2018-Dec,21660,21043,617,2.8
Kendall County,2019-Jan,22105,21411,694,3.1
Kendall County,2019-Feb,22272,21618,654,2.9
Kendall County,2019-Mar,22349,21724,625,2.8
Kendall County,2019-Apr,22235,21715,520,2.3
Kendall County,2019-May,22247,21711,536,2.4
Kendall County,2019-Jun,22407,21749,658,2.9
Kendall County,2019-Jul,22470,21788,682,3
Kendall County,2019-Aug,22551,21908,643,2.9
Kendall County,2019-Sep,22493,21887,606,2.7
Kendall County,2019-Oct,22520,21939,581,2.6
Kendall County,2019-Nov,22494,21916,578,2.6
Kendall County,2019-Dec,22534,22004,530,2.4
Kendall County,2020-Jan,22605,21980,625,2.8
Kendall County,2020-Feb,22804,22200,604,2.6
Kendall County,2020-Mar,22322,21402,920,4.1
Kendall County,2020-Apr,20347,18634,1713,8.4
Kendall County,2020-May,21148,19452,1696,8
Kendall County,2020-Jun,21723,20221,1502,6.9
Kendall County,2020-Jul,21798,20452,1346,6.2
Kendall County,2020-Aug,22137,21075,1062,4.8
Kendall County,2020-Sep,22139,21102,1037,4.7
Kendall County,2020-Oct,22372,21450,922,4.1
Kendall County,2020-Nov,22367,21385,982,4.4
Kendall County,2020-Dec,22429,21441,988,4.4
Kendall County,2021-Jan,22324,21275,1049,4.7
Kendall County,2021-Feb,22532,21501,1031,4.6
Kendall County,2021-Mar,22726,21755,971,4.3
Kendall County,2021-Apr,22675,21829,846,3.7
Kendall County,2021-May,22655,21825,830,3.7
Kendall County,2021-Jun,22815,21822,993,4.4
Kendall County,2021-Jul,22909,22015,894,3.9
Kendall County,2021-Aug,22893,22048,845,3.7
Kendall County,2021-Sep,22974,22151,823,3.6
Kendall County,2021-Oct,22975,22185,790,3.4
Kendall County,2021-Nov,22969,22234,735,3.2
Kendall County,2021-Dec,22918,22251,667,2.9
Kendall County,2022-Jan,22910,22142,768,3.4
Kendall County,2022-Feb,23380,22593,787,3.4
Kendall County,2022-Mar,23478,22846,632,2.7
Kendall County,2022-Apr,23278,22699,579,2.5
Kendall County,2022-May,23299,22656,643,2.8
Kendall County,2022-Jun,23443,22671,772,3.3
Kendall County,2022-Jul,23600(P),22841(P),759(P),3.2(P)
Kenedy County,2012-Jan,227,214,13,5.7
Kenedy County,2012-Feb,223,211,12,5.4
Kenedy County,2012-Mar,233,221,12,5.2
Kenedy County,2012-Apr,238,227,11,4.6
Kenedy County,2012-May,243,232,11,4.5
Kenedy County,2012-Jun,253,240,13,5.1
Kenedy County,2012-Jul,260,247,13,5
Kenedy County,2012-Aug,266,249,17,6.4
Kenedy County,2012-Sep,270,256,14,5.2
Kenedy County,2012-Oct,271,259,12,4.4
Kenedy County,2012-Nov,273,262,11,4
Kenedy County,2012-Dec,276,264,12,4.3
Kenedy County,2013-Jan,269,257,12,4.5
Kenedy County,2013-Feb,269,258,11,4.1
Kenedy County,2013-Mar,269,258,11,4.1
Kenedy County,2013-Apr,289,279,10,3.5
Kenedy County,2013-May,299,288,11,3.7
Kenedy County,2013-Jun,306,294,12,3.9
Kenedy County,2013-Jul,313,302,11,3.5
Kenedy County,2013-Aug,299,288,11,3.7
Kenedy County,2013-Sep,307,291,16,5.2
Kenedy County,2013-Oct,315,303,12,3.8
Kenedy County,2013-Nov,304,292,12,3.9
Kenedy County,2013-Dec,310,298,12,3.9
Kenedy County,2014-Jan,348,336,12,3.4
Kenedy County,2014-Feb,357,344,13,3.6
Kenedy County,2014-Mar,361,345,16,4.4
Kenedy County,2014-Apr,337,327,10,3
Kenedy County,2014-May,339,330,9,2.7
Kenedy County,2014-Jun,340,330,10,2.9
Kenedy County,2014-Jul,334,326,8,2.4
Kenedy County,2014-Aug,328,320,8,2.4
Kenedy County,2014-Sep,334,325,9,2.7
Kenedy County,2014-Oct,325,316,9,2.8
Kenedy County,2014-Nov,320,312,8,2.5
Kenedy County,2014-Dec,328,321,7,2.1
Kenedy County,2015-Jan,324,314,10,3.1
Kenedy County,2015-Feb,330,321,9,2.7
Kenedy County,2015-Mar,339,329,10,2.9
Kenedy County,2015-Apr,304,295,9,3
Kenedy County,2015-May,305,296,9,3
Kenedy County,2015-Jun,307,296,11,3.6
Kenedy County,2015-Jul,255,247,8,3.1
Kenedy County,2015-Aug,251,242,9,3.6
Kenedy County,2015-Sep,252,244,8,3.2
Kenedy County,2015-Oct,244,237,7,2.9
Kenedy County,2015-Nov,239,230,9,3.8
Kenedy County,2015-Dec,238,229,9,3.8
Kenedy County,2016-Jan,215,206,9,4.2
Kenedy County,2016-Feb,233,223,10,4.3
Kenedy County,2016-Mar,240,229,11,4.6
Kenedy County,2016-Apr,229,220,9,3.9
Kenedy County,2016-May,236,227,9,3.8
Kenedy County,2016-Jun,225,214,11,4.9
Kenedy County,2016-Jul,196,185,11,5.6
Kenedy County,2016-Aug,205,194,11,5.4
Kenedy County,2016-Sep,197,186,11,5.6
Kenedy County,2016-Oct,213,204,9,4.2
Kenedy County,2016-Nov,213,203,10,4.7
Kenedy County,2016-Dec,208,198,10,4.8
Kenedy County,2017-Jan,225,216,9,4
Kenedy County,2017-Feb,234,224,10,4.3
Kenedy County,2017-Mar,251,240,11,4.4
Kenedy County,2017-Apr,258,248,10,3.9
Kenedy County,2017-May,256,248,8,3.1
Kenedy County,2017-Jun,249,242,7,2.8
Kenedy County,2017-Jul,240,232,8,3.3
Kenedy County,2017-Aug,244,237,7,2.9
Kenedy County,2017-Sep,238,231,7,2.9
Kenedy County,2017-Oct,230,224,6,2.6
Kenedy County,2017-Nov,228,220,8,3.5
Kenedy County,2017-Dec,227,220,7,3.1
Kenedy County,2018-Jan,216,209,7,3.2
Kenedy County,2018-Feb,230,221,9,3.9
Kenedy County,2018-Mar,251,241,10,4
Kenedy County,2018-Apr,239,232,7,2.9
Kenedy County,2018-May,254,246,8,3.1
Kenedy County,2018-Jun,252,239,13,5.2
Kenedy County,2018-Jul,244,234,10,4.1
Kenedy County,2018-Aug,254,244,10,3.9
Kenedy County,2018-Sep,250,241,9,3.6
Kenedy County,2018-Oct,250,241,9,3.6
Kenedy County,2018-Nov,250,242,8,3.2
Kenedy County,2018-Dec,241,231,10,4.1
Kenedy County,2019-Jan,229,221,8,3.5
Kenedy County,2019-Feb,230,223,7,3
Kenedy County,2019-Mar,240,232,8,3.3
Kenedy County,2019-Apr,233,227,6,2.6
Kenedy County,2019-May,234,228,6,2.6
Kenedy County,2019-Jun,225,218,7,3.1
Kenedy County,2019-Jul,224,216,8,3.6
Kenedy County,2019-Aug,234,225,9,3.8
Kenedy County,2019-Sep,221,213,8,3.6
Kenedy County,2019-Oct,227,219,8,3.5
Kenedy County,2019-Nov,216,207,9,4.2
Kenedy County,2019-Dec,220,212,8,3.6
Kenedy County,2020-Jan,223,215,8,3.6
Kenedy County,2020-Feb,222,217,5,2.3
Kenedy County,2020-Mar,221,212,9,4.1
Kenedy County,2020-Apr,174,164,10,5.7
Kenedy County,2020-May,152,143,9,5.9
Kenedy County,2020-Jun,159,147,12,7.5
Kenedy County,2020-Jul,162,149,13,8
Kenedy County,2020-Aug,164,154,10,6.1
Kenedy County,2020-Sep,158,150,8,5.1
Kenedy County,2020-Oct,171,160,11,6.4
Kenedy County,2020-Nov,166,155,11,6.6
Kenedy County,2020-Dec,166,157,9,5.4
Kenedy County,2021-Jan,175,161,14,8
Kenedy County,2021-Feb,178,166,12,6.7
Kenedy County,2021-Mar,185,175,10,5.4
Kenedy County,2021-Apr,183,172,11,6
Kenedy County,2021-May,181,170,11,6.1
Kenedy County,2021-Jun,183,171,12,6.6
Kenedy County,2021-Jul,191,179,12,6.3
Kenedy County,2021-Aug,191,179,12,6.3
Kenedy County,2021-Sep,187,175,12,6.4
Kenedy County,2021-Oct,184,174,10,5.4
Kenedy County,2021-Nov,180,170,10,5.6
Kenedy County,2021-Dec,180,171,9,5
Kenedy County,2022-Jan,188,176,12,6.4
Kenedy County,2022-Feb,201,190,11,5.5
Kenedy County,2022-Mar,211,202,9,4.3
Kenedy County,2022-Apr,199,190,9,4.5
Kenedy County,2022-May,187,179,8,4.3
Kenedy County,2022-Jun,189,179,10,5.3
Kenedy County,2022-Jul,207(P),198(P),9(P),4.3(P)
Kent County,2012-Jan,548,523,25,4.6
Kent County,2012-Feb,541,519,22,4.1
Kent County,2012-Mar,540,519,21,3.9
Kent County,2012-Apr,561,540,21,3.7
Kent County,2012-May,561,540,21,3.7
Kent County,2012-Jun,564,540,24,4.3
Kent County,2012-Jul,558,535,23,4.1
Kent County,2012-Aug,550,527,23,4.2
Kent County,2012-Sep,562,543,19,3.4
Kent County,2012-Oct,549,530,19,3.5
Kent County,2012-Nov,541,523,18,3.3
Kent County,2012-Dec,534,514,20,3.7
Kent County,2013-Jan,524,505,19,3.6
Kent County,2013-Feb,532,511,21,3.9
Kent County,2013-Mar,511,491,20,3.9
Kent County,2013-Apr,543,526,17,3.1
Kent County,2013-May,551,531,20,3.6
Kent County,2013-Jun,564,541,23,4.1
Kent County,2013-Jul,544,521,23,4.2
Kent County,2013-Aug,533,512,21,3.9
Kent County,2013-Sep,522,499,23,4.4
Kent County,2013-Oct,514,493,21,4.1
Kent County,2013-Nov,505,485,20,4
Kent County,2013-Dec,515,496,19,3.7
Kent County,2014-Jan,516,495,21,4.1
Kent County,2014-Feb,516,495,21,4.1
Kent County,2014-Mar,508,486,22,4.3
Kent County,2014-Apr,517,500,17,3.3
Kent County,2014-May,529,510,19,3.6
Kent County,2014-Jun,538,519,19,3.5
Kent County,2014-Jul,553,533,20,3.6
Kent County,2014-Aug,508,489,19,3.7
Kent County,2014-Sep,500,483,17,3.4
Kent County,2014-Oct,496,480,16,3.2
Kent County,2014-Nov,482,469,13,2.7
Kent County,2014-Dec,482,471,11,2.3
Kent County,2015-Jan,492,480,12,2.4
Kent County,2015-Feb,501,490,11,2.2
Kent County,2015-Mar,504,493,11,2.2
Kent County,2015-Apr,490,480,10,2
Kent County,2015-May,498,485,13,2.6
Kent County,2015-Jun,530,517,13,2.5
Kent County,2015-Jul,520,505,15,2.9
Kent County,2015-Aug,506,490,16,3.2
Kent County,2015-Sep,499,487,12,2.4
Kent County,2015-Oct,486,474,12,2.5
Kent County,2015-Nov,462,448,14,3
Kent County,2015-Dec,479,464,15,3.1
Kent County,2016-Jan,463,446,17,3.7
Kent County,2016-Feb,476,459,17,3.6
Kent County,2016-Mar,491,476,15,3.1
Kent County,2016-Apr,492,481,11,2.2
Kent County,2016-May,476,467,9,1.9
Kent County,2016-Jun,506,493,13,2.6
Kent County,2016-Jul,476,461,15,3.2
Kent County,2016-Aug,478,464,14,2.9
Kent County,2016-Sep,453,439,14,3.1
Kent County,2016-Oct,438,425,13,3
Kent County,2016-Nov,438,426,12,2.7
Kent County,2016-Dec,442,430,12,2.7
Kent County,2017-Jan,432,418,14,3.2
Kent County,2017-Feb,434,421,13,3
Kent County,2017-Mar,458,444,14,3.1
Kent County,2017-Apr,447,435,12,2.7
Kent County,2017-May,452,440,12,2.7
Kent County,2017-Jun,463,452,11,2.4
Kent County,2017-Jul,463,452,11,2.4
Kent County,2017-Aug,474,464,10,2.1
Kent County,2017-Sep,465,453,12,2.6
Kent County,2017-Oct,441,432,9,2
Kent County,2017-Nov,439,427,12,2.7
Kent County,2017-Dec,434,423,11,2.5
Kent County,2018-Jan,421,409,12,2.9
Kent County,2018-Feb,424,412,12,2.8
Kent County,2018-Mar,441,427,14,3.2
Kent County,2018-Apr,479,469,10,2.1
Kent County,2018-May,482,473,9,1.9
Kent County,2018-Jun,478,468,10,2.1
Kent County,2018-Jul,453,443,10,2.2
Kent County,2018-Aug,458,448,10,2.2
Kent County,2018-Sep,455,445,10,2.2
Kent County,2018-Oct,441,430,11,2.5
Kent County,2018-Nov,422,411,11,2.6
Kent County,2018-Dec,409,399,10,2.4
Kent County,2019-Jan,441,427,14,3.2
Kent County,2019-Feb,445,435,10,2.2
Kent County,2019-Mar,456,446,10,2.2
Kent County,2019-Apr,482,473,9,1.9
Kent County,2019-May,492,483,9,1.8
Kent County,2019-Jun,486,474,12,2.5
Kent County,2019-Jul,488,478,10,2
Kent County,2019-Aug,501,491,10,2
Kent County,2019-Sep,488,477,11,2.3
Kent County,2019-Oct,452,441,11,2.4
Kent County,2019-Nov,440,427,13,3
Kent County,2019-Dec,438,425,13,3
Kent County,2020-Jan,448,431,17,3.8
Kent County,2020-Feb,451,437,14,3.1
Kent County,2020-Mar,476,448,28,5.9
Kent County,2020-Apr,440,421,19,4.3
Kent County,2020-May,443,423,20,4.5
Kent County,2020-Jun,463,441,22,4.8
Kent County,2020-Jul,472,452,20,4.2
Kent County,2020-Aug,490,471,19,3.9
Kent County,2020-Sep,466,449,17,3.6
Kent County,2020-Oct,460,446,14,3
Kent County,2020-Nov,444,430,14,3.2
Kent County,2020-Dec,453,442,11,2.4
Kent County,2021-Jan,448,433,15,3.3
Kent County,2021-Feb,450,437,13,2.9
Kent County,2021-Mar,458,443,15,3.3
Kent County,2021-Apr,474,460,14,3
Kent County,2021-May,463,449,14,3
Kent County,2021-Jun,455,439,16,3.5
Kent County,2021-Jul,432,419,13,3
Kent County,2021-Aug,441,428,13,2.9
Kent County,2021-Sep,461,448,13,2.8
Kent County,2021-Oct,433,422,11,2.5
Kent County,2021-Nov,422,411,11,2.6
Kent County,2021-Dec,426,416,10,2.3
Kent County,2022-Jan,428,415,13,3
Kent County,2022-Feb,453,440,13,2.9
Kent County,2022-Mar,471,460,11,2.3
Kent County,2022-Apr,474,465,9,1.9
Kent County,2022-May,467,455,12,2.6
Kent County,2022-Jun,461,449,12,2.6
Kent County,2022-Jul,476(P),464(P),12(P),2.5(P)
Kerr County,2012-Jan,21354,19970,1384,6.5
Kerr County,2012-Feb,21523,20218,1305,6.1
Kerr County,2012-Mar,21439,20217,1222,5.7
Kerr County,2012-Apr,21669,20504,1165,5.4
Kerr County,2012-May,21713,20464,1249,5.8
Kerr County,2012-Jun,22103,20721,1382,6.3
Kerr County,2012-Jul,22107,20730,1377,6.2
Kerr County,2012-Aug,21671,20371,1300,6
Kerr County,2012-Sep,21546,20347,1199,5.6
Kerr County,2012-Oct,21573,20401,1172,5.4
Kerr County,2012-Nov,21634,20495,1139,5.3
Kerr County,2012-Dec,21423,20262,1161,5.4
Kerr County,2013-Jan,21139,19823,1316,6.2
Kerr County,2013-Feb,21267,20042,1225,5.8
Kerr County,2013-Mar,21122,19954,1168,5.5
Kerr County,2013-Apr,21411,20290,1121,5.2
Kerr County,2013-May,21365,20156,1209,5.7
Kerr County,2013-Jun,21941,20616,1325,6
Kerr County,2013-Jul,22148,20857,1291,5.8
Kerr County,2013-Aug,21404,20194,1210,5.7
Kerr County,2013-Sep,21321,20110,1211,5.7
Kerr County,2013-Oct,21238,20103,1135,5.3
Kerr County,2013-Nov,21465,20389,1076,5
Kerr County,2013-Dec,21445,20436,1009,4.7
Kerr County,2014-Jan,21041,19997,1044,5
Kerr County,2014-Feb,21398,20339,1059,4.9
Kerr County,2014-Mar,21286,20283,1003,4.7
Kerr County,2014-Apr,21383,20532,851,4
Kerr County,2014-May,21219,20274,945,4.5
Kerr County,2014-Jun,21872,20859,1013,4.6
Kerr County,2014-Jul,21951,20897,1054,4.8
Kerr County,2014-Aug,21390,20401,989,4.6
Kerr County,2014-Sep,21349,20407,942,4.4
Kerr County,2014-Oct,21289,20408,881,4.1
Kerr County,2014-Nov,21463,20600,863,4
Kerr County,2014-Dec,21145,20378,767,3.6
Kerr County,2015-Jan,20696,19822,874,4.2
Kerr County,2015-Feb,20921,20106,815,3.9
Kerr County,2015-Mar,20980,20204,776,3.7
Kerr County,2015-Apr,21102,20402,700,3.3
Kerr County,2015-May,21088,20306,782,3.7
Kerr County,2015-Jun,21540,20702,838,3.9
Kerr County,2015-Jul,21506,20655,851,4
Kerr County,2015-Aug,21124,20361,763,3.6
Kerr County,2015-Sep,21245,20464,781,3.7
Kerr County,2015-Oct,21259,20494,765,3.6
Kerr County,2015-Nov,21443,20684,759,3.5
Kerr County,2015-Dec,21346,20635,711,3.3
Kerr County,2016-Jan,20805,20031,774,3.7
Kerr County,2016-Feb,21455,20706,749,3.5
Kerr County,2016-Mar,21481,20722,759,3.5
Kerr County,2016-Apr,21463,20794,669,3.1
Kerr County,2016-May,21506,20809,697,3.2
Kerr County,2016-Jun,21952,21142,810,3.7
Kerr County,2016-Jul,21851,20985,866,4
Kerr County,2016-Aug,21197,20384,813,3.8
Kerr County,2016-Sep,21112,20281,831,3.9
Kerr County,2016-Oct,21169,20383,786,3.7
Kerr County,2016-Nov,21225,20474,751,3.5
Kerr County,2016-Dec,21179,20454,725,3.4
Kerr County,2017-Jan,20564,19763,801,3.9
Kerr County,2017-Feb,21052,20240,812,3.9
Kerr County,2017-Mar,21105,20354,751,3.6
Kerr County,2017-Apr,21063,20417,646,3.1
Kerr County,2017-May,21136,20438,698,3.3
Kerr County,2017-Jun,21527,20778,749,3.5
Kerr County,2017-Jul,21653,20885,768,3.5
Kerr County,2017-Aug,21055,20302,753,3.6
Kerr County,2017-Sep,21144,20432,712,3.4
Kerr County,2017-Oct,21061,20400,661,3.1
Kerr County,2017-Nov,21386,20670,716,3.3
Kerr County,2017-Dec,21367,20699,668,3.1
Kerr County,2018-Jan,20995,20242,753,3.6
Kerr County,2018-Feb,21351,20577,774,3.6
Kerr County,2018-Mar,21389,20650,739,3.5
Kerr County,2018-Apr,21802,21152,650,3
Kerr County,2018-May,21949,21302,647,2.9
Kerr County,2018-Jun,22051,21281,770,3.5
Kerr County,2018-Jul,22063,21323,740,3.4
Kerr County,2018-Aug,21386,20675,711,3.3
Kerr County,2018-Sep,21441,20734,707,3.3
Kerr County,2018-Oct,21250,20592,658,3.1
Kerr County,2018-Nov,21707,21064,643,3
Kerr County,2018-Dec,21679,21040,639,2.9
Kerr County,2019-Jan,21579,20810,769,3.6
Kerr County,2019-Feb,21893,21203,690,3.2
Kerr County,2019-Mar,21910,21247,663,3
Kerr County,2019-Apr,21747,21203,544,2.5
Kerr County,2019-May,22014,21447,567,2.6
Kerr County,2019-Jun,22067,21380,687,3.1
Kerr County,2019-Jul,22504,21792,712,3.2
Kerr County,2019-Aug,22007,21314,693,3.1
Kerr County,2019-Sep,21948,21299,649,3
Kerr County,2019-Oct,21969,21340,629,2.9
Kerr County,2019-Nov,22075,21455,620,2.8
Kerr County,2019-Dec,22045,21486,559,2.5
Kerr County,2020-Jan,21720,21003,717,3.3
Kerr County,2020-Feb,21957,21285,672,3.1
Kerr County,2020-Mar,21557,20544,1013,4.7
Kerr County,2020-Apr,20291,18154,2137,10.5
Kerr County,2020-May,20913,18949,1964,9.4
Kerr County,2020-Jun,21360,19670,1690,7.9
Kerr County,2020-Jul,21924,20404,1520,6.9
Kerr County,2020-Aug,21635,20485,1150,5.3
Kerr County,2020-Sep,21267,20143,1124,5.3
Kerr County,2020-Oct,21872,20878,994,4.5
Kerr County,2020-Nov,21984,20924,1060,4.8
Kerr County,2020-Dec,21938,20884,1054,4.8
Kerr County,2021-Jan,21845,20688,1157,5.3
Kerr County,2021-Feb,22041,20888,1153,5.2
Kerr County,2021-Mar,22036,20922,1114,5.1
Kerr County,2021-Apr,22005,21049,956,4.3
Kerr County,2021-May,21999,21032,967,4.4
Kerr County,2021-Jun,22315,21190,1125,5
Kerr County,2021-Jul,22694,21681,1013,4.5
Kerr County,2021-Aug,21930,20960,970,4.4
Kerr County,2021-Sep,21765,20832,933,4.3
Kerr County,2021-Oct,21997,21106,891,4.1
Kerr County,2021-Nov,22094,21251,843,3.8
Kerr County,2021-Dec,22009,21251,758,3.4
Kerr County,2022-Jan,21757,20881,876,4
Kerr County,2022-Feb,22086,21194,892,4
Kerr County,2022-Mar,22215,21488,727,3.3
Kerr County,2022-Apr,21893,21234,659,3
Kerr County,2022-May,21777,21052,725,3.3
Kerr County,2022-Jun,22066,21242,824,3.7
Kerr County,2022-Jul,22519(P),21720(P),799(P),3.5(P)
Kimble County,2012-Jan,2148,2032,116,5.4
Kimble County,2012-Feb,2103,1994,109,5.2
Kimble County,2012-Mar,2138,2033,105,4.9
Kimble County,2012-Apr,2175,2079,96,4.4
Kimble County,2012-May,2185,2075,110,5
Kimble County,2012-Jun,2267,2152,115,5.1
Kimble County,2012-Jul,2256,2138,118,5.2
Kimble County,2012-Aug,2219,2111,108,4.9
Kimble County,2012-Sep,2179,2075,104,4.8
Kimble County,2012-Oct,2178,2081,97,4.5
Kimble County,2012-Nov,2198,2102,96,4.4
Kimble County,2012-Dec,2166,2068,98,4.5
Kimble County,2013-Jan,2100,1990,110,5.2
Kimble County,2013-Feb,2092,1989,103,4.9
Kimble County,2013-Mar,2076,1978,98,4.7
Kimble County,2013-Apr,2104,2010,94,4.5
Kimble County,2013-May,2167,2063,104,4.8
Kimble County,2013-Jun,2225,2103,122,5.5
Kimble County,2013-Jul,2278,2161,117,5.1
Kimble County,2013-Aug,2225,2113,112,5
Kimble County,2013-Sep,2205,2096,109,4.9
Kimble County,2013-Oct,2166,2060,106,4.9
Kimble County,2013-Nov,2103,2006,97,4.6
Kimble County,2013-Dec,2140,2048,92,4.3
Kimble County,2014-Jan,2075,1979,96,4.6
Kimble County,2014-Feb,2105,2008,97,4.6
Kimble County,2014-Mar,2130,2040,90,4.2
Kimble County,2014-Apr,2107,2033,74,3.5
Kimble County,2014-May,2161,2079,82,3.8
Kimble County,2014-Jun,2216,2128,88,4
Kimble County,2014-Jul,2181,2090,91,4.2
Kimble County,2014-Aug,2124,2040,84,4
Kimble County,2014-Sep,2087,2004,83,4
Kimble County,2014-Oct,2073,1996,77,3.7
Kimble County,2014-Nov,2054,1984,70,3.4
Kimble County,2014-Dec,2003,1941,62,3.1
Kimble County,2015-Jan,1963,1891,72,3.7
Kimble County,2015-Feb,1985,1917,68,3.4
Kimble County,2015-Mar,2015,1947,68,3.4
Kimble County,2015-Apr,2007,1945,62,3.1
Kimble County,2015-May,2063,1994,69,3.3
Kimble County,2015-Jun,2077,1999,78,3.8
Kimble County,2015-Jul,2056,1975,81,3.9
Kimble County,2015-Aug,2012,1936,76,3.8
Kimble County,2015-Sep,1949,1873,76,3.9
Kimble County,2015-Oct,1966,1893,73,3.7
Kimble County,2015-Nov,1951,1874,77,3.9
Kimble County,2015-Dec,1962,1882,80,4.1
Kimble County,2016-Jan,1869,1795,74,4
Kimble County,2016-Feb,1949,1872,77,4
Kimble County,2016-Mar,1965,1886,79,4
Kimble County,2016-Apr,1989,1915,74,3.7
Kimble County,2016-May,2002,1934,68,3.4
Kimble County,2016-Jun,2014,1942,72,3.6
Kimble County,2016-Jul,1969,1892,77,3.9
Kimble County,2016-Aug,1970,1897,73,3.7
Kimble County,2016-Sep,1896,1818,78,4.1
Kimble County,2016-Oct,1960,1879,81,4.1
Kimble County,2016-Nov,1919,1851,68,3.5
Kimble County,2016-Dec,1933,1862,71,3.7
Kimble County,2017-Jan,1825,1751,74,4.1
Kimble County,2017-Feb,1817,1742,75,4.1
Kimble County,2017-Mar,1929,1856,73,3.8
Kimble County,2017-Apr,1887,1824,63,3.3
Kimble County,2017-May,1905,1837,68,3.6
Kimble County,2017-Jun,1925,1853,72,3.7
Kimble County,2017-Jul,1882,1811,71,3.8
Kimble County,2017-Aug,1899,1830,69,3.6
Kimble County,2017-Sep,1855,1788,67,3.6
Kimble County,2017-Oct,1881,1823,58,3.1
Kimble County,2017-Nov,1857,1795,62,3.3
Kimble County,2017-Dec,1859,1805,54,2.9
Kimble County,2018-Jan,1846,1787,59,3.2
Kimble County,2018-Feb,1847,1786,61,3.3
Kimble County,2018-Mar,1900,1842,58,3.1
Kimble County,2018-Apr,1860,1811,49,2.6
Kimble County,2018-May,1897,1844,53,2.8
Kimble County,2018-Jun,1916,1855,61,3.2
Kimble County,2018-Jul,1897,1838,59,3.1
Kimble County,2018-Aug,1901,1840,61,3.2
Kimble County,2018-Sep,1823,1771,52,2.9
Kimble County,2018-Oct,1778,1728,50,2.8
Kimble County,2018-Nov,1810,1755,55,3
Kimble County,2018-Dec,1800,1743,57,3.2
Kimble County,2019-Jan,1751,1687,64,3.7
Kimble County,2019-Feb,1794,1737,57,3.2
Kimble County,2019-Mar,1820,1765,55,3
Kimble County,2019-Apr,1824,1780,44,2.4
Kimble County,2019-May,1831,1783,48,2.6
Kimble County,2019-Jun,1885,1824,61,3.2
Kimble County,2019-Jul,1904,1839,65,3.4
Kimble County,2019-Aug,1916,1857,59,3.1
Kimble County,2019-Sep,1805,1747,58,3.2
Kimble County,2019-Oct,1836,1786,50,2.7
Kimble County,2019-Nov,1812,1758,54,3
Kimble County,2019-Dec,1817,1767,50,2.8
Kimble County,2020-Jan,1776,1718,58,3.3
Kimble County,2020-Feb,1804,1749,55,3
Kimble County,2020-Mar,1778,1692,86,4.8
Kimble County,2020-Apr,1666,1590,76,4.6
Kimble County,2020-May,1716,1618,98,5.7
Kimble County,2020-Jun,1785,1676,109,6.1
Kimble County,2020-Jul,1852,1737,115,6.2
Kimble County,2020-Aug,1877,1776,101,5.4
Kimble County,2020-Sep,1820,1718,102,5.6
Kimble County,2020-Oct,1928,1837,91,4.7
Kimble County,2020-Nov,1902,1802,100,5.3
Kimble County,2020-Dec,1912,1811,101,5.3
Kimble County,2021-Jan,1897,1794,103,5.4
Kimble County,2021-Feb,1918,1820,98,5.1
Kimble County,2021-Mar,1967,1879,88,4.5
Kimble County,2021-Apr,1932,1853,79,4.1
Kimble County,2021-May,1898,1822,76,4
Kimble County,2021-Jun,1905,1820,85,4.5
Kimble County,2021-Jul,1919,1842,77,4
Kimble County,2021-Aug,1898,1822,76,4
Kimble County,2021-Sep,1868,1795,73,3.9
Kimble County,2021-Oct,1906,1838,68,3.6
Kimble County,2021-Nov,1876,1812,64,3.4
Kimble County,2021-Dec,1877,1820,57,3
Kimble County,2022-Jan,1849,1781,68,3.7
Kimble County,2022-Feb,1924,1854,70,3.6
Kimble County,2022-Mar,1984,1927,57,2.9
Kimble County,2022-Apr,1940,1888,52,2.7
Kimble County,2022-May,1914,1858,56,2.9
Kimble County,2022-Jun,1926,1864,62,3.2
Kimble County,2022-Jul,2004(P),1943(P),61(P),3.0(P)
King County,2012-Jan,241,229,12,5
King County,2012-Feb,233,219,14,6
King County,2012-Mar,243,231,12,4.9
King County,2012-Apr,253,242,11,4.3
King County,2012-May,255,244,11,4.3
King County,2012-Jun,267,256,11,4.1
King County,2012-Jul,262,251,11,4.2
King County,2012-Aug,249,239,10,4
King County,2012-Sep,255,246,9,3.5
King County,2012-Oct,241,232,9,3.7
King County,2012-Nov,233,223,10,4.3
King County,2012-Dec,226,217,9,4
King County,2013-Jan,214,204,10,4.7
King County,2013-Feb,218,207,11,5
King County,2013-Mar,215,206,9,4.2
King County,2013-Apr,235,225,10,4.3
King County,2013-May,246,236,10,4.1
King County,2013-Jun,259,249,10,3.9
King County,2013-Jul,262,251,11,4.2
King County,2013-Aug,249,238,11,4.4
King County,2013-Sep,249,238,11,4.4
King County,2013-Oct,245,234,11,4.5
King County,2013-Nov,228,215,13,5.7
King County,2013-Dec,236,223,13,5.5
King County,2014-Jan,206,194,12,5.8
King County,2014-Feb,217,205,12,5.5
King County,2014-Mar,220,209,11,5
King County,2014-Apr,229,219,10,4.4
King County,2014-May,230,222,8,3.5
King County,2014-Jun,239,229,10,4.2
King County,2014-Jul,240,230,10,4.2
King County,2014-Aug,231,223,8,3.5
King County,2014-Sep,233,225,8,3.4
King County,2014-Oct,220,213,7,3.2
King County,2014-Nov,216,208,8,3.7
King County,2014-Dec,212,203,9,4.2
King County,2015-Jan,203,195,8,3.9
King County,2015-Feb,209,202,7,3.3
King County,2015-Mar,213,206,7,3.3
King County,2015-Apr,219,212,7,3.2
King County,2015-May,224,217,7,3.1
King County,2015-Jun,225,217,8,3.6
King County,2015-Jul,209,202,7,3.3
King County,2015-Aug,199,193,6,3
King County,2015-Sep,193,187,6,3.1
King County,2015-Oct,175,169,6,3.4
King County,2015-Nov,168,160,8,4.8
King County,2015-Dec,164,157,7,4.3
King County,2016-Jan,158,152,6,3.8
King County,2016-Feb,180,174,6,3.3
King County,2016-Mar,189,183,6,3.2
King County,2016-Apr,188,182,6,3.2
King County,2016-May,195,189,6,3.1
King County,2016-Jun,194,188,6,3.1
King County,2016-Jul,179,173,6,3.4
King County,2016-Aug,187,179,8,4.3
King County,2016-Sep,182,174,8,4.4
King County,2016-Oct,163,155,8,4.9
King County,2016-Nov,157,149,8,5.1
King County,2016-Dec,158,150,8,5.1
King County,2017-Jan,150,144,6,4
King County,2017-Feb,160,154,6,3.8
King County,2017-Mar,178,172,6,3.4
King County,2017-Apr,170,166,4,2.4
King County,2017-May,174,169,5,2.9
King County,2017-Jun,176,169,7,4
King County,2017-Jul,158,151,7,4.4
King County,2017-Aug,169,163,6,3.6
King County,2017-Sep,158,153,5,3.2
King County,2017-Oct,158,153,5,3.2
King County,2017-Nov,149,144,5,3.4
King County,2017-Dec,158,153,5,3.2
King County,2018-Jan,191,185,6,3.1
King County,2018-Feb,196,189,7,3.6
King County,2018-Mar,207,202,5,2.4
King County,2018-Apr,216,210,6,2.8
King County,2018-May,230,225,5,2.2
King County,2018-Jun,226,220,6,2.7
King County,2018-Jul,211,205,6,2.8
King County,2018-Aug,218,212,6,2.8
King County,2018-Sep,209,203,6,2.9
King County,2018-Oct,199,193,6,3
King County,2018-Nov,199,193,6,3
King County,2018-Dec,197,193,4,2
King County,2019-Jan,198,192,6,3
King County,2019-Feb,203,197,6,3
King County,2019-Mar,215,210,5,2.3
King County,2019-Apr,229,225,4,1.7
King County,2019-May,240,236,4,1.7
King County,2019-Jun,225,220,5,2.2
King County,2019-Jul,231,225,6,2.6
King County,2019-Aug,245,239,6,2.4
King County,2019-Sep,246,242,4,1.6
King County,2019-Oct,260,256,4,1.5
King County,2019-Nov,244,240,4,1.6
King County,2019-Dec,252,248,4,1.6
King County,2020-Jan,238,234,4,1.7
King County,2020-Feb,246,241,5,2
King County,2020-Mar,238,231,7,2.9
King County,2020-Apr,203,199,4,2
King County,2020-May,188,183,5,2.7
King County,2020-Jun,208,202,6,2.9
King County,2020-Jul,205,202,3,1.5
King County,2020-Aug,263,259,4,1.5
King County,2020-Sep,255,252,3,1.2
King County,2020-Oct,265,262,3,1.1
King County,2020-Nov,249,245,4,1.6
King County,2020-Dec,259,255,4,1.5
King County,2021-Jan,289,285,4,1.4
King County,2021-Feb,324,320,4,1.2
King County,2021-Mar,407,403,4,1
King County,2021-Apr,415,411,4,1
King County,2021-May,432,428,4,0.9
King County,2021-Jun,468,463,5,1.1
King County,2021-Jul,451,447,4,0.9
King County,2021-Aug,450,446,4,0.9
King County,2021-Sep,536,532,4,0.7
King County,2021-Oct,540,536,4,0.7
King County,2021-Nov,524,520,4,0.8
King County,2021-Dec,543,539,4,0.7
King County,2022-Jan,575,571,4,0.7
King County,2022-Feb,631,627,4,0.6
King County,2022-Mar,646,642,4,0.6
King County,2022-Apr,645,642,3,0.5
King County,2022-May,630,626,4,0.6
King County,2022-Jun,627,621,6,1
King County,2022-Jul,650(P),645(P),5(P),0.8(P)
Kinney County,2012-Jan,1237,1112,125,10.1
Kinney County,2012-Feb,1216,1094,122,10
Kinney County,2012-Mar,1227,1105,122,9.9
Kinney County,2012-Apr,1228,1122,106,8.6
Kinney County,2012-May,1234,1128,106,8.6
Kinney County,2012-Jun,1277,1162,115,9
Kinney County,2012-Jul,1303,1181,122,9.4
Kinney County,2012-Aug,1288,1177,111,8.6
Kinney County,2012-Sep,1298,1198,100,7.7
Kinney County,2012-Oct,1288,1192,96,7.5
Kinney County,2012-Nov,1294,1198,96,7.4
Kinney County,2012-Dec,1232,1131,101,8.2
Kinney County,2013-Jan,1236,1102,134,10.8
Kinney County,2013-Feb,1226,1094,132,10.8
Kinney County,2013-Mar,1203,1086,117,9.7
Kinney County,2013-Apr,1215,1100,115,9.5
Kinney County,2013-May,1215,1101,114,9.4
Kinney County,2013-Jun,1238,1117,121,9.8
Kinney County,2013-Jul,1250,1133,117,9.4
Kinney County,2013-Aug,1203,1095,108,9
Kinney County,2013-Sep,1225,1112,113,9.2
Kinney County,2013-Oct,1198,1084,114,9.5
Kinney County,2013-Nov,1184,1073,111,9.4
Kinney County,2013-Dec,1207,1098,109,9
Kinney County,2014-Jan,1207,1097,110,9.1
Kinney County,2014-Feb,1234,1124,110,8.9
Kinney County,2014-Mar,1220,1126,94,7.7
Kinney County,2014-Apr,1231,1150,81,6.6
Kinney County,2014-May,1242,1166,76,6.1
Kinney County,2014-Jun,1259,1176,83,6.6
Kinney County,2014-Jul,1266,1168,98,7.7
Kinney County,2014-Aug,1264,1156,108,8.5
Kinney County,2014-Sep,1245,1152,93,7.5
Kinney County,2014-Oct,1221,1143,78,6.4
Kinney County,2014-Nov,1178,1103,75,6.4
Kinney County,2014-Dec,1157,1084,73,6.3
Kinney County,2015-Jan,1174,1088,86,7.3
Kinney County,2015-Feb,1190,1108,82,6.9
Kinney County,2015-Mar,1191,1116,75,6.3
Kinney County,2015-Apr,1190,1120,70,5.9
Kinney County,2015-May,1211,1141,70,5.8
Kinney County,2015-Jun,1218,1144,74,6.1
Kinney County,2015-Jul,1209,1126,83,6.9
Kinney County,2015-Aug,1184,1104,80,6.8
Kinney County,2015-Sep,1169,1092,77,6.6
Kinney County,2015-Oct,1181,1107,74,6.3
Kinney County,2015-Nov,1155,1078,77,6.7
Kinney County,2015-Dec,1153,1088,65,5.6
Kinney County,2016-Jan,1122,1053,69,6.1
Kinney County,2016-Feb,1183,1111,72,6.1
Kinney County,2016-Mar,1203,1136,67,5.6
Kinney County,2016-Apr,1212,1144,68,5.6
Kinney County,2016-May,1192,1130,62,5.2
Kinney County,2016-Jun,1178,1112,66,5.6
Kinney County,2016-Jul,1173,1100,73,6.2
Kinney County,2016-Aug,1168,1099,69,5.9
Kinney County,2016-Sep,1122,1055,67,6
Kinney County,2016-Oct,1114,1050,64,5.7
Kinney County,2016-Nov,1110,1047,63,5.7
Kinney County,2016-Dec,1100,1033,67,6.1
Kinney County,2017-Jan,1117,1040,77,6.9
Kinney County,2017-Feb,1134,1050,84,7.4
Kinney County,2017-Mar,1166,1095,71,6.1
Kinney County,2017-Apr,1167,1104,63,5.4
Kinney County,2017-May,1214,1150,64,5.3
Kinney County,2017-Jun,1215,1151,64,5.3
Kinney County,2017-Jul,1155,1093,62,5.4
Kinney County,2017-Aug,1183,1118,65,5.5
Kinney County,2017-Sep,1129,1071,58,5.1
Kinney County,2017-Oct,1146,1093,53,4.6
Kinney County,2017-Nov,1125,1067,58,5.2
Kinney County,2017-Dec,1131,1071,60,5.3
Kinney County,2018-Jan,1361,1293,68,5
Kinney County,2018-Feb,1344,1275,69,5.1
Kinney County,2018-Mar,1384,1314,70,5.1
Kinney County,2018-Apr,1382,1315,67,4.8
Kinney County,2018-May,1431,1370,61,4.3
Kinney County,2018-Jun,1389,1325,64,4.6
Kinney County,2018-Jul,1329,1271,58,4.4
Kinney County,2018-Aug,1323,1270,53,4
Kinney County,2018-Sep,1329,1279,50,3.8
Kinney County,2018-Oct,1278,1230,48,3.8
Kinney County,2018-Nov,1260,1212,48,3.8
Kinney County,2018-Dec,1251,1200,51,4.1
Kinney County,2019-Jan,1266,1206,60,4.7
Kinney County,2019-Feb,1286,1227,59,4.6
Kinney County,2019-Mar,1371,1317,54,3.9
Kinney County,2019-Apr,1346,1300,46,3.4
Kinney County,2019-May,1350,1307,43,3.2
Kinney County,2019-Jun,1364,1316,48,3.5
Kinney County,2019-Jul,1359,1309,50,3.7
Kinney County,2019-Aug,1399,1356,43,3.1
Kinney County,2019-Sep,1370,1330,40,2.9
Kinney County,2019-Oct,1361,1319,42,3.1
Kinney County,2019-Nov,1363,1317,46,3.4
Kinney County,2019-Dec,1363,1312,51,3.7
Kinney County,2020-Jan,1336,1268,68,5.1
Kinney County,2020-Feb,1376,1316,60,4.4
Kinney County,2020-Mar,1367,1279,88,6.4
Kinney County,2020-Apr,1237,1156,81,6.5
Kinney County,2020-May,1233,1143,90,7.3
Kinney County,2020-Jun,1207,1112,95,7.9
Kinney County,2020-Jul,1249,1166,83,6.6
Kinney County,2020-Aug,1305,1241,64,4.9
Kinney County,2020-Sep,1295,1221,74,5.7
Kinney County,2020-Oct,1340,1275,65,4.9
Kinney County,2020-Nov,1327,1251,76,5.7
Kinney County,2020-Dec,1333,1252,81,6.1
Kinney County,2021-Jan,1249,1158,91,7.3
Kinney County,2021-Feb,1264,1176,88,7
Kinney County,2021-Mar,1298,1218,80,6.2
Kinney County,2021-Apr,1267,1203,64,5.1
Kinney County,2021-May,1253,1190,63,5
Kinney County,2021-Jun,1250,1172,78,6.2
Kinney County,2021-Jul,1239,1169,70,5.6
Kinney County,2021-Aug,1224,1162,62,5.1
Kinney County,2021-Sep,1232,1172,60,4.9
Kinney County,2021-Oct,1231,1170,61,5
Kinney County,2021-Nov,1215,1155,60,4.9
Kinney County,2021-Dec,1205,1149,56,4.6
Kinney County,2022-Jan,1154,1088,66,5.7
Kinney County,2022-Feb,1214,1144,70,5.8
Kinney County,2022-Mar,1256,1197,59,4.7
Kinney County,2022-Apr,1219,1168,51,4.2
Kinney County,2022-May,1196,1141,55,4.6
Kinney County,2022-Jun,1179,1117,62,5.3
Kinney County,2022-Jul,1218(P),1157(P),61(P),5.0(P)
Kleberg County,2012-Jan,15227,14055,1172,7.7
Kleberg County,2012-Feb,15669,14548,1121,7.2
Kleberg County,2012-Mar,15522,14491,1031,6.6
Kleberg County,2012-Apr,15503,14540,963,6.2
Kleberg County,2012-May,15536,14519,1017,6.5
Kleberg County,2012-Jun,15397,14207,1190,7.7
Kleberg County,2012-Jul,15209,14026,1183,7.8
Kleberg County,2012-Aug,15162,14057,1105,7.3
Kleberg County,2012-Sep,15221,14242,979,6.4
Kleberg County,2012-Oct,15462,14497,965,6.2
Kleberg County,2012-Nov,15386,14430,956,6.2
Kleberg County,2012-Dec,15314,14344,970,6.3
Kleberg County,2013-Jan,14980,13887,1093,7.3
Kleberg County,2013-Feb,15380,14353,1027,6.7
Kleberg County,2013-Mar,15321,14332,989,6.5
Kleberg County,2013-Apr,15572,14632,940,6
Kleberg County,2013-May,15700,14679,1021,6.5
Kleberg County,2013-Jun,15262,14100,1162,7.6
Kleberg County,2013-Jul,15577,14451,1126,7.2
Kleberg County,2013-Aug,15283,14224,1059,6.9
Kleberg County,2013-Sep,15719,14733,986,6.3
Kleberg County,2013-Oct,15404,14473,931,6
Kleberg County,2013-Nov,15403,14507,896,5.8
Kleberg County,2013-Dec,15373,14529,844,5.5
Kleberg County,2014-Jan,15240,14378,862,5.7
Kleberg County,2014-Feb,15460,14561,899,5.8
Kleberg County,2014-Mar,15575,14699,876,5.6
Kleberg County,2014-Apr,15511,14745,766,4.9
Kleberg County,2014-May,15420,14579,841,5.5
Kleberg County,2014-Jun,15126,14166,960,6.3
Kleberg County,2014-Jul,15113,14145,968,6.4
Kleberg County,2014-Aug,15055,14132,923,6.1
Kleberg County,2014-Sep,15135,14315,820,5.4
Kleberg County,2014-Oct,15324,14565,759,5
Kleberg County,2014-Nov,15062,14310,752,5
Kleberg County,2014-Dec,14857,14180,677,4.6
Kleberg County,2015-Jan,14573,13786,787,5.4
Kleberg County,2015-Feb,14906,14131,775,5.2
Kleberg County,2015-Mar,14895,14099,796,5.3
Kleberg County,2015-Apr,14728,13948,780,5.3
Kleberg County,2015-May,14559,13712,847,5.8
Kleberg County,2015-Jun,14389,13438,951,6.6
Kleberg County,2015-Jul,14007,13038,969,6.9
Kleberg County,2015-Aug,13885,12954,931,6.7
Kleberg County,2015-Sep,14041,13169,872,6.2
Kleberg County,2015-Oct,14314,13448,866,6.1
Kleberg County,2015-Nov,14281,13410,871,6.1
Kleberg County,2015-Dec,14278,13440,838,5.9
Kleberg County,2016-Jan,13897,12997,900,6.5
Kleberg County,2016-Feb,14362,13458,904,6.3
Kleberg County,2016-Mar,14521,13574,947,6.5
Kleberg County,2016-Apr,14490,13564,926,6.4
Kleberg County,2016-May,14423,13515,908,6.3
Kleberg County,2016-Jun,14039,12985,1054,7.5
Kleberg County,2016-Jul,13743,12695,1048,7.6
Kleberg County,2016-Aug,13787,12747,1040,7.5
Kleberg County,2016-Sep,13982,13001,981,7
Kleberg County,2016-Oct,14113,13203,910,6.4
Kleberg County,2016-Nov,14120,13244,876,6.2
Kleberg County,2016-Dec,13901,13002,899,6.5
Kleberg County,2017-Jan,13110,12138,972,7.4
Kleberg County,2017-Feb,13547,12621,926,6.8
Kleberg County,2017-Mar,13819,12955,864,6.3
Kleberg County,2017-Apr,13780,12987,793,5.8
Kleberg County,2017-May,13565,12809,756,5.6
Kleberg County,2017-Jun,13140,12285,855,6.5
Kleberg County,2017-Jul,12841,11986,855,6.7
Kleberg County,2017-Aug,12845,12008,837,6.5
Kleberg County,2017-Sep,13027,12328,699,5.4
Kleberg County,2017-Oct,13314,12678,636,4.8
Kleberg County,2017-Nov,13283,12616,667,5
Kleberg County,2017-Dec,13314,12656,658,4.9
Kleberg County,2018-Jan,12996,12277,719,5.5
Kleberg County,2018-Feb,13377,12683,694,5.2
Kleberg County,2018-Mar,13637,12965,672,4.9
Kleberg County,2018-Apr,13236,12584,652,4.9
Kleberg County,2018-May,13490,12861,629,4.7
Kleberg County,2018-Jun,13091,12365,726,5.5
Kleberg County,2018-Jul,12941,12230,711,5.5
Kleberg County,2018-Aug,12972,12312,660,5.1
Kleberg County,2018-Sep,12963,12329,634,4.9
Kleberg County,2018-Oct,13201,12607,594,4.5
Kleberg County,2018-Nov,13193,12597,596,4.5
Kleberg County,2018-Dec,13131,12521,610,4.6
Kleberg County,2019-Jan,13000,12343,657,5.1
Kleberg County,2019-Feb,13426,12806,620,4.6
Kleberg County,2019-Mar,13499,12941,558,4.1
Kleberg County,2019-Apr,13266,12784,482,3.6
Kleberg County,2019-May,13458,12956,502,3.7
Kleberg County,2019-Jun,13133,12513,620,4.7
Kleberg County,2019-Jul,12958,12320,638,4.9
Kleberg County,2019-Aug,13281,12664,617,4.6
Kleberg County,2019-Sep,13176,12609,567,4.3
Kleberg County,2019-Oct,13673,13118,555,4.1
Kleberg County,2019-Nov,13542,12983,559,4.1
Kleberg County,2019-Dec,13490,12972,518,3.8
Kleberg County,2020-Jan,13283,12697,586,4.4
Kleberg County,2020-Feb,13413,12852,561,4.2
Kleberg County,2020-Mar,13366,12496,870,6.5
Kleberg County,2020-Apr,12585,11181,1404,11.2
Kleberg County,2020-May,12994,11439,1555,12
Kleberg County,2020-Jun,13087,11621,1466,11.2
Kleberg County,2020-Jul,12898,11428,1470,11.4
Kleberg County,2020-Aug,12979,11775,1204,9.3
Kleberg County,2020-Sep,13072,11934,1138,8.7
Kleberg County,2020-Oct,13381,12380,1001,7.5
Kleberg County,2020-Nov,13402,12346,1056,7.9
Kleberg County,2020-Dec,13243,12212,1031,7.8
Kleberg County,2021-Jan,13244,12136,1108,8.4
Kleberg County,2021-Feb,13435,12326,1109,8.3
Kleberg County,2021-Mar,13508,12450,1058,7.8
Kleberg County,2021-Apr,13453,12474,979,7.3
Kleberg County,2021-May,13619,12679,940,6.9
Kleberg County,2021-Jun,13016,11954,1062,8.2
Kleberg County,2021-Jul,12794,11810,984,7.7
Kleberg County,2021-Aug,12892,11960,932,7.2
Kleberg County,2021-Sep,12988,12132,856,6.6
Kleberg County,2021-Oct,13236,12435,801,6.1
Kleberg County,2021-Nov,13188,12430,758,5.7
Kleberg County,2021-Dec,13052,12348,704,5.4
Kleberg County,2022-Jan,13082,12249,833,6.4
Kleberg County,2022-Feb,13362,12572,790,5.9
Kleberg County,2022-Mar,13493,12835,658,4.9
Kleberg County,2022-Apr,13364,12740,624,4.7
Kleberg County,2022-May,13578,12930,648,4.8
Kleberg County,2022-Jun,12905,12171,734,5.7
Kleberg County,2022-Jul,12898(P),12170(P),728(P),5.6(P)
Knox County,2012-Jan,1810,1702,108,6
Knox County,2012-Feb,1779,1682,97,5.5
Knox County,2012-Mar,1811,1719,92,5.1
Knox County,2012-Apr,1816,1727,89,4.9
Knox County,2012-May,1835,1742,93,5.1
Knox County,2012-Jun,1841,1739,102,5.5
Knox County,2012-Jul,1856,1749,107,5.8
Knox County,2012-Aug,1827,1728,99,5.4
Knox County,2012-Sep,1817,1727,90,5
Knox County,2012-Oct,1809,1719,90,5
Knox County,2012-Nov,1791,1709,82,4.6
Knox County,2012-Dec,1767,1681,86,4.9
Knox County,2013-Jan,1689,1581,108,6.4
Knox County,2013-Feb,1677,1584,93,5.5
Knox County,2013-Mar,1698,1608,90,5.3
Knox County,2013-Apr,1750,1665,85,4.9
Knox County,2013-May,1795,1700,95,5.3
Knox County,2013-Jun,1821,1720,101,5.5
Knox County,2013-Jul,1813,1710,103,5.7
Knox County,2013-Aug,1763,1666,97,5.5
Knox County,2013-Sep,1777,1682,95,5.3
Knox County,2013-Oct,1774,1682,92,5.2
Knox County,2013-Nov,1684,1596,88,5.2
Knox County,2013-Dec,1745,1664,81,4.6
Knox County,2014-Jan,1714,1626,88,5.1
Knox County,2014-Feb,1756,1665,91,5.2
Knox County,2014-Mar,1766,1680,86,4.9
Knox County,2014-Apr,1743,1670,73,4.2
Knox County,2014-May,1777,1701,76,4.3
Knox County,2014-Jun,1784,1705,79,4.4
Knox County,2014-Jul,1760,1679,81,4.6
Knox County,2014-Aug,1706,1627,79,4.6
Knox County,2014-Sep,1725,1651,74,4.3
Knox County,2014-Oct,1733,1668,65,3.8
Knox County,2014-Nov,1700,1638,62,3.6
Knox County,2014-Dec,1670,1618,52,3.1
Knox County,2015-Jan,1688,1625,63,3.7
Knox County,2015-Feb,1718,1661,57,3.3
Knox County,2015-Mar,1733,1675,58,3.3
Knox County,2015-Apr,1712,1654,58,3.4
Knox County,2015-May,1734,1672,62,3.6
Knox County,2015-Jun,1766,1695,71,4
Knox County,2015-Jul,1693,1625,68,4
Knox County,2015-Aug,1632,1565,67,4.1
Knox County,2015-Sep,1661,1594,67,4
Knox County,2015-Oct,1652,1586,66,4
Knox County,2015-Nov,1593,1530,63,4
Knox County,2015-Dec,1607,1542,65,4
Knox County,2016-Jan,1530,1467,63,4.1
Knox County,2016-Feb,1607,1541,66,4.1
Knox County,2016-Mar,1633,1568,65,4
Knox County,2016-Apr,1632,1574,58,3.6
Knox County,2016-May,1679,1619,60,3.6
Knox County,2016-Jun,1639,1562,77,4.7
Knox County,2016-Jul,1560,1483,77,4.9
Knox County,2016-Aug,1541,1464,77,5
Knox County,2016-Sep,1502,1435,67,4.5
Knox County,2016-Oct,1476,1412,64,4.3
Knox County,2016-Nov,1449,1390,59,4.1
Knox County,2016-Dec,1465,1407,58,4
Knox County,2017-Jan,1401,1339,62,4.4
Knox County,2017-Feb,1457,1386,71,4.9
Knox County,2017-Mar,1528,1472,56,3.7
Knox County,2017-Apr,1523,1464,59,3.9
Knox County,2017-May,1522,1467,55,3.6
Knox County,2017-Jun,1493,1427,66,4.4
Knox County,2017-Jul,1444,1381,63,4.4
Knox County,2017-Aug,1488,1425,63,4.2
Knox County,2017-Sep,1440,1382,58,4
Knox County,2017-Oct,1474,1425,49,3.3
Knox County,2017-Nov,1437,1382,55,3.8
Knox County,2017-Dec,1460,1412,48,3.3
Knox County,2018-Jan,1406,1350,56,4
Knox County,2018-Feb,1439,1385,54,3.8
Knox County,2018-Mar,1488,1435,53,3.6
Knox County,2018-Apr,1435,1383,52,3.6
Knox County,2018-May,1490,1436,54,3.6
Knox County,2018-Jun,1499,1438,61,4.1
Knox County,2018-Jul,1427,1371,56,3.9
Knox County,2018-Aug,1464,1409,55,3.8
Knox County,2018-Sep,1434,1384,50,3.5
Knox County,2018-Oct,1420,1375,45,3.2
Knox County,2018-Nov,1390,1346,44,3.2
Knox County,2018-Dec,1358,1315,43,3.2
Knox County,2019-Jan,1376,1318,58,4.2
Knox County,2019-Feb,1409,1357,52,3.7
Knox County,2019-Mar,1441,1391,50,3.5
Knox County,2019-Apr,1421,1381,40,2.8
Knox County,2019-May,1451,1410,41,2.8
Knox County,2019-Jun,1440,1393,47,3.3
Knox County,2019-Jul,1422,1372,50,3.5
Knox County,2019-Aug,1472,1423,49,3.3
Knox County,2019-Sep,1417,1373,44,3.1
Knox County,2019-Oct,1454,1413,41,2.8
Knox County,2019-Nov,1393,1352,41,2.9
Knox County,2019-Dec,1412,1374,38,2.7
Knox County,2020-Jan,1433,1381,52,3.6
Knox County,2020-Feb,1450,1403,47,3.2
Knox County,2020-Mar,1459,1381,78,5.3
Knox County,2020-Apr,1367,1280,87,6.4
Knox County,2020-May,1406,1301,105,7.5
Knox County,2020-Jun,1430,1322,108,7.6
Knox County,2020-Jul,1425,1334,91,6.4
Knox County,2020-Aug,1459,1379,80,5.5
Knox County,2020-Sep,1437,1357,80,5.6
Knox County,2020-Oct,1486,1409,77,5.2
Knox County,2020-Nov,1439,1356,83,5.8
Knox County,2020-Dec,1457,1377,80,5.5
Knox County,2021-Jan,1463,1377,86,5.9
Knox County,2021-Feb,1504,1421,83,5.5
Knox County,2021-Mar,1566,1483,83,5.3
Knox County,2021-Apr,1522,1458,64,4.2
Knox County,2021-May,1482,1417,65,4.4
Knox County,2021-Jun,1448,1377,71,4.9
Knox County,2021-Jul,1440,1375,65,4.5
Knox County,2021-Aug,1444,1377,67,4.6
Knox County,2021-Sep,1436,1371,65,4.5
Knox County,2021-Oct,1423,1362,61,4.3
Knox County,2021-Nov,1376,1322,54,3.9
Knox County,2021-Dec,1384,1333,51,3.7
Knox County,2022-Jan,1394,1334,60,4.3
Knox County,2022-Feb,1505,1438,67,4.5
Knox County,2022-Mar,1569,1515,54,3.4
Knox County,2022-Apr,1552,1502,50,3.2
Knox County,2022-May,1502,1451,51,3.4
Knox County,2022-Jun,1467,1408,59,4
Knox County,2022-Jul,1545(P),1481(P),64(P),4.1(P)
Lamar County,2012-Jan,22612,20373,2239,9.9
Lamar County,2012-Feb,22750,20501,2249,9.9
Lamar County,2012-Mar,22653,20547,2106,9.3
Lamar County,2012-Apr,22634,20708,1926,8.5
Lamar County,2012-May,22757,20760,1997,8.8
Lamar County,2012-Jun,22890,20727,2163,9.4
Lamar County,2012-Jul,22893,20616,2277,9.9
Lamar County,2012-Aug,22524,20520,2004,8.9
Lamar County,2012-Sep,22654,20638,2016,8.9
Lamar County,2012-Oct,22227,20248,1979,8.9
Lamar County,2012-Nov,22278,20365,1913,8.6
Lamar County,2012-Dec,22178,20234,1944,8.8
Lamar County,2013-Jan,22190,20096,2094,9.4
Lamar County,2013-Feb,22423,20428,1995,8.9
Lamar County,2013-Mar,22302,20445,1857,8.3
Lamar County,2013-Apr,22330,20533,1797,8
Lamar County,2013-May,22401,20563,1838,8.2
Lamar County,2013-Jun,22438,20472,1966,8.8
Lamar County,2013-Jul,22374,20491,1883,8.4
Lamar County,2013-Aug,22175,20366,1809,8.2
Lamar County,2013-Sep,22238,20492,1746,7.9
Lamar County,2013-Oct,22082,20389,1693,7.7
Lamar County,2013-Nov,22129,20503,1626,7.3
Lamar County,2013-Dec,22091,20564,1527,6.9
Lamar County,2014-Jan,21933,20381,1552,7.1
Lamar County,2014-Feb,22252,20696,1556,7
Lamar County,2014-Mar,22303,20817,1486,6.7
Lamar County,2014-Apr,22256,20938,1318,5.9
Lamar County,2014-May,22205,20850,1355,6.1
Lamar County,2014-Jun,22123,20690,1433,6.5
Lamar County,2014-Jul,22336,20865,1471,6.6
Lamar County,2014-Aug,21972,20568,1404,6.4
Lamar County,2014-Sep,22052,20746,1306,5.9
Lamar County,2014-Oct,22030,20814,1216,5.5
Lamar County,2014-Nov,22036,20822,1214,5.5
Lamar County,2014-Dec,21902,20804,1098,5
Lamar County,2015-Jan,21939,20741,1198,5.5
Lamar County,2015-Feb,22166,21019,1147,5.2
Lamar County,2015-Mar,22120,21026,1094,4.9
Lamar County,2015-Apr,22271,21266,1005,4.5
Lamar County,2015-May,22347,21278,1069,4.8
Lamar County,2015-Jun,22367,21233,1134,5.1
Lamar County,2015-Jul,22346,21208,1138,5.1
Lamar County,2015-Aug,22105,21037,1068,4.8
Lamar County,2015-Sep,22193,21129,1064,4.8
Lamar County,2015-Oct,22095,21090,1005,4.5
Lamar County,2015-Nov,22187,21197,990,4.5
Lamar County,2015-Dec,22217,21271,946,4.3
Lamar County,2016-Jan,22561,21565,996,4.4
Lamar County,2016-Feb,22981,22009,972,4.2
Lamar County,2016-Mar,23126,22155,971,4.2
Lamar County,2016-Apr,23064,22115,949,4.1
Lamar County,2016-May,23133,22176,957,4.1
Lamar County,2016-Jun,23445,22245,1200,5.1
Lamar County,2016-Jul,23537,22325,1212,5.1
Lamar County,2016-Aug,23598,22392,1206,5.1
Lamar County,2016-Sep,23620,22418,1202,5.1
Lamar County,2016-Oct,23435,22312,1123,4.8
Lamar County,2016-Nov,23138,22061,1077,4.7
Lamar County,2016-Dec,23222,22159,1063,4.6
Lamar County,2017-Jan,23465,22313,1152,4.9
Lamar County,2017-Feb,23598,22438,1160,4.9
Lamar County,2017-Mar,23628,22552,1076,4.6
Lamar County,2017-Apr,23676,22734,942,4
Lamar County,2017-May,23494,22551,943,4
Lamar County,2017-Jun,23700,22695,1005,4.2
Lamar County,2017-Jul,23473,22483,990,4.2
Lamar County,2017-Aug,23285,22270,1015,4.4
Lamar County,2017-Sep,23478,22551,927,3.9
Lamar County,2017-Oct,23749,22883,866,3.6
Lamar County,2017-Nov,23701,22749,952,4
Lamar County,2017-Dec,23687,22754,933,3.9
Lamar County,2018-Jan,23383,22364,1019,4.4
Lamar County,2018-Feb,23656,22646,1010,4.3
Lamar County,2018-Mar,23789,22784,1005,4.2
Lamar County,2018-Apr,23726,22839,887,3.7
Lamar County,2018-May,23733,22893,840,3.5
Lamar County,2018-Jun,23663,22695,968,4.1
Lamar County,2018-Jul,23395,22498,897,3.8
Lamar County,2018-Aug,23593,22744,849,3.6
Lamar County,2018-Sep,23431,22604,827,3.5
Lamar County,2018-Oct,23392,22589,803,3.4
Lamar County,2018-Nov,23420,22601,819,3.5
Lamar County,2018-Dec,23273,22434,839,3.6
Lamar County,2019-Jan,23319,22370,949,4.1
Lamar County,2019-Feb,23626,22728,898,3.8
Lamar County,2019-Mar,23692,22881,811,3.4
Lamar County,2019-Apr,23581,22863,718,3
Lamar County,2019-May,23477,22760,717,3.1
Lamar County,2019-Jun,23487,22656,831,3.5
Lamar County,2019-Jul,23624,22779,845,3.6
Lamar County,2019-Aug,23901,23090,811,3.4
Lamar County,2019-Sep,23955,23172,783,3.3
Lamar County,2019-Oct,23951,23197,754,3.1
Lamar County,2019-Nov,23704,22934,770,3.2
Lamar County,2019-Dec,23522,22809,713,3
Lamar County,2020-Jan,23384,22591,793,3.4
Lamar County,2020-Feb,23479,22743,736,3.1
Lamar County,2020-Mar,22990,21908,1082,4.7
Lamar County,2020-Apr,21416,19284,2132,10
Lamar County,2020-May,22370,20379,1991,8.9
Lamar County,2020-Jun,23054,20924,2130,9.2
Lamar County,2020-Jul,23573,21579,1994,8.5
Lamar County,2020-Aug,23771,22262,1509,6.3
Lamar County,2020-Sep,23977,22504,1473,6.1
Lamar County,2020-Oct,24181,22856,1325,5.5
Lamar County,2020-Nov,24150,22747,1403,5.8
Lamar County,2020-Dec,24184,22720,1464,6.1
Lamar County,2021-Jan,24316,22725,1591,6.5
Lamar County,2021-Feb,24769,23117,1652,6.7
Lamar County,2021-Mar,24846,23295,1551,6.2
Lamar County,2021-Apr,24817,23471,1346,5.4
Lamar County,2021-May,24524,23229,1295,5.3
Lamar County,2021-Jun,24474,23054,1420,5.8
Lamar County,2021-Jul,24395,23069,1326,5.4
Lamar County,2021-Aug,24282,23046,1236,5.1
Lamar County,2021-Sep,24462,23178,1284,5.2
Lamar County,2021-Oct,24476,23261,1215,5
Lamar County,2021-Nov,24344,23193,1151,4.7
Lamar County,2021-Dec,24213,23150,1063,4.4
Lamar County,2022-Jan,24304,23078,1226,5
Lamar County,2022-Feb,24612,23390,1222,5
Lamar County,2022-Mar,24724,23734,990,4
Lamar County,2022-Apr,23931,23018,913,3.8
Lamar County,2022-May,24114,23155,959,4
Lamar County,2022-Jun,24093,23010,1083,4.5
Lamar County,2022-Jul,24207(P),23121(P),1086(P),4.5(P)
Lamb County,2012-Jan,6445,5950,495,7.7
Lamb County,2012-Feb,6737,5827,910,13.5
Lamb County,2012-Mar,6777,5854,923,13.6
Lamb County,2012-Apr,6418,6004,414,6.5
Lamb County,2012-May,6436,6004,432,6.7
Lamb County,2012-Jun,6514,6044,470,7.2
Lamb County,2012-Jul,6523,6051,472,7.2
Lamb County,2012-Aug,6390,5945,445,7
Lamb County,2012-Sep,6400,5997,403,6.3
Lamb County,2012-Oct,6322,5937,385,6.1
Lamb County,2012-Nov,6278,5899,379,6
Lamb County,2012-Dec,6148,5754,394,6.4
Lamb County,2013-Jan,6036,5581,455,7.5
Lamb County,2013-Feb,6033,5581,452,7.5
Lamb County,2013-Mar,5972,5533,439,7.4
Lamb County,2013-Apr,6116,5692,424,6.9
Lamb County,2013-May,6219,5773,446,7.2
Lamb County,2013-Jun,6339,5855,484,7.6
Lamb County,2013-Jul,6404,5949,455,7.1
Lamb County,2013-Aug,6214,5788,426,6.9
Lamb County,2013-Sep,6235,5828,407,6.5
Lamb County,2013-Oct,6130,5737,393,6.4
Lamb County,2013-Nov,5931,5577,354,6
Lamb County,2013-Dec,6002,5658,344,5.7
Lamb County,2014-Jan,5998,5630,368,6.1
Lamb County,2014-Feb,6132,5770,362,5.9
Lamb County,2014-Mar,6143,5798,345,5.6
Lamb County,2014-Apr,6162,5854,308,5
Lamb County,2014-May,6186,5854,332,5.4
Lamb County,2014-Jun,6264,5918,346,5.5
Lamb County,2014-Jul,6407,5690,717,11.2
Lamb County,2014-Aug,5915,5594,321,5.4
Lamb County,2014-Sep,5842,5523,319,5.5
Lamb County,2014-Oct,5840,5550,290,5
Lamb County,2014-Nov,5767,5478,289,5
Lamb County,2014-Dec,5606,5339,267,4.8
Lamb County,2015-Jan,5680,5110,570,10
Lamb County,2015-Feb,5747,5182,565,9.8
Lamb County,2015-Mar,5725,5175,550,9.6
Lamb County,2015-Apr,5623,5130,493,8.8
Lamb County,2015-May,5650,5159,491,8.7
Lamb County,2015-Jun,5681,5157,524,9.2
Lamb County,2015-Jul,5514,5003,511,9.3
Lamb County,2015-Aug,5380,4882,498,9.3
Lamb County,2015-Sep,5396,4920,476,8.8
Lamb County,2015-Oct,5323,4869,454,8.5
Lamb County,2015-Nov,5209,4782,427,8.2
Lamb County,2015-Dec,5227,4833,394,7.5
Lamb County,2016-Jan,5119,4722,397,7.8
Lamb County,2016-Feb,5363,4989,374,7
Lamb County,2016-Mar,5430,5065,365,6.7
Lamb County,2016-Apr,5407,5067,340,6.3
Lamb County,2016-May,5484,5155,329,6
Lamb County,2016-Jun,5398,5039,359,6.7
Lamb County,2016-Jul,5211,4857,354,6.8
Lamb County,2016-Aug,5186,4838,348,6.7
Lamb County,2016-Sep,5101,4769,332,6.5
Lamb County,2016-Oct,5120,4813,307,6
Lamb County,2016-Nov,5081,4786,295,5.8
Lamb County,2016-Dec,5093,4797,296,5.8
Lamb County,2017-Jan,4994,4674,320,6.4
Lamb County,2017-Feb,5108,4767,341,6.7
Lamb County,2017-Mar,5296,4994,302,5.7
Lamb County,2017-Apr,5249,4979,270,5.1
Lamb County,2017-May,5251,4981,270,5.1
Lamb County,2017-Jun,5274,4978,296,5.6
Lamb County,2017-Jul,5099,4818,281,5.5
Lamb County,2017-Aug,5142,4873,269,5.2
Lamb County,2017-Sep,5079,4836,243,4.8
Lamb County,2017-Oct,5159,4945,214,4.1
Lamb County,2017-Nov,5078,4861,217,4.3
Lamb County,2017-Dec,5106,4908,198,3.9
Lamb County,2018-Jan,5080,4850,230,4.5
Lamb County,2018-Feb,5183,4938,245,4.7
Lamb County,2018-Mar,5381,5133,248,4.6
Lamb County,2018-Apr,5214,4990,224,4.3
Lamb County,2018-May,5320,5102,218,4.1
Lamb County,2018-Jun,5275,5013,262,5
Lamb County,2018-Jul,5194,4944,250,4.8
Lamb County,2018-Aug,5268,5039,229,4.3
Lamb County,2018-Sep,5157,4929,228,4.4
Lamb County,2018-Oct,5010,4801,209,4.2
Lamb County,2018-Nov,4961,4763,198,4
Lamb County,2018-Dec,4879,4668,211,4.3
Lamb County,2019-Jan,5068,4830,238,4.7
Lamb County,2019-Feb,5185,4957,228,4.4
Lamb County,2019-Mar,5275,5059,216,4.1
Lamb County,2019-Apr,5193,5016,177,3.4
Lamb County,2019-May,5236,5066,170,3.2
Lamb County,2019-Jun,5237,5025,212,4
Lamb County,2019-Jul,5190,4981,209,4
Lamb County,2019-Aug,5336,5135,201,3.8
Lamb County,2019-Sep,5233,5038,195,3.7
Lamb County,2019-Oct,5296,5102,194,3.7
Lamb County,2019-Nov,5071,4900,171,3.4
Lamb County,2019-Dec,5132,4965,167,3.3
Lamb County,2020-Jan,5201,5000,201,3.9
Lamb County,2020-Feb,5196,5012,184,3.5
Lamb County,2020-Mar,5182,4896,286,5.5
Lamb County,2020-Apr,4955,4663,292,5.9
Lamb County,2020-May,5058,4718,340,6.7
Lamb County,2020-Jun,5143,4808,335,6.5
Lamb County,2020-Jul,5172,4871,301,5.8
Lamb County,2020-Aug,5265,5008,257,4.9
Lamb County,2020-Sep,5174,4924,250,4.8
Lamb County,2020-Oct,5313,5076,237,4.5
Lamb County,2020-Nov,5154,4891,263,5.1
Lamb County,2020-Dec,5171,4891,280,5.4
Lamb County,2021-Jan,5189,4884,305,5.9
Lamb County,2021-Feb,5319,5002,317,6
Lamb County,2021-Mar,5410,5119,291,5.4
Lamb County,2021-Apr,5326,5065,261,4.9
Lamb County,2021-May,5196,4935,261,5
Lamb County,2021-Jun,5279,4974,305,5.8
Lamb County,2021-Jul,5210,4942,268,5.1
Lamb County,2021-Aug,5214,4965,249,4.8
Lamb County,2021-Sep,5224,4983,241,4.6
Lamb County,2021-Oct,5166,4944,222,4.3
Lamb County,2021-Nov,5003,4796,207,4.1
Lamb County,2021-Dec,4995,4805,190,3.8
Lamb County,2022-Jan,5054,4828,226,4.5
Lamb County,2022-Feb,5322,5095,227,4.3
Lamb County,2022-Mar,5477,5281,196,3.6
Lamb County,2022-Apr,5391,5206,185,3.4
Lamb County,2022-May,5256,5062,194,3.7
Lamb County,2022-Jun,5290,5061,229,4.3
Lamb County,2022-Jul,5436(P),5208(P),228(P),4.2(P)
Lampasas County,2012-Jan,9001,8316,685,7.6
Lampasas County,2012-Feb,8999,8346,653,7.3
Lampasas County,2012-Mar,9006,8384,622,6.9
Lampasas County,2012-Apr,9014,8419,595,6.6
Lampasas County,2012-May,9043,8403,640,7.1
Lampasas County,2012-Jun,9120,8404,716,7.9
Lampasas County,2012-Jul,9167,8463,704,7.7
Lampasas County,2012-Aug,9099,8456,643,7.1
Lampasas County,2012-Sep,9127,8513,614,6.7
Lampasas County,2012-Oct,9128,8508,620,6.8
Lampasas County,2012-Nov,9088,8480,608,6.7
Lampasas County,2012-Dec,9061,8438,623,6.9
Lampasas County,2013-Jan,9024,8340,684,7.6
Lampasas County,2013-Feb,9026,8365,661,7.3
Lampasas County,2013-Mar,9000,8370,630,7
Lampasas County,2013-Apr,9095,8469,626,6.9
Lampasas County,2013-May,9141,8482,659,7.2
Lampasas County,2013-Jun,9156,8439,717,7.8
Lampasas County,2013-Jul,9218,8512,706,7.7
Lampasas County,2013-Aug,9155,8480,675,7.4
Lampasas County,2013-Sep,9198,8521,677,7.4
Lampasas County,2013-Oct,9111,8462,649,7.1
Lampasas County,2013-Nov,9137,8514,623,6.8
Lampasas County,2013-Dec,9108,8520,588,6.5
Lampasas County,2014-Jan,8973,8374,599,6.7
Lampasas County,2014-Feb,9020,8427,593,6.6
Lampasas County,2014-Mar,8984,8433,551,6.1
Lampasas County,2014-Apr,9015,8524,491,5.4
Lampasas County,2014-May,9027,8514,513,5.7
Lampasas County,2014-Jun,9004,8457,547,6.1
Lampasas County,2014-Jul,8970,8427,543,6.1
Lampasas County,2014-Aug,8885,8375,510,5.7
Lampasas County,2014-Sep,8911,8431,480,5.4
Lampasas County,2014-Oct,8931,8471,460,5.2
Lampasas County,2014-Nov,8912,8479,433,4.9
Lampasas County,2014-Dec,8834,8444,390,4.4
Lampasas County,2015-Jan,8906,8450,456,5.1
Lampasas County,2015-Feb,8947,8534,413,4.6
Lampasas County,2015-Mar,8979,8578,401,4.5
Lampasas County,2015-Apr,9025,8663,362,4
Lampasas County,2015-May,9086,8697,389,4.3
Lampasas County,2015-Jun,9049,8623,426,4.7
Lampasas County,2015-Jul,9075,8648,427,4.7
Lampasas County,2015-Aug,9034,8637,397,4.4
Lampasas County,2015-Sep,9063,8671,392,4.3
Lampasas County,2015-Oct,9132,8732,400,4.4
Lampasas County,2015-Nov,9192,8811,381,4.1
Lampasas County,2015-Dec,9222,8856,366,4
Lampasas County,2016-Jan,9019,8646,373,4.1
Lampasas County,2016-Feb,9141,8771,370,4
Lampasas County,2016-Mar,9174,8799,375,4.1
Lampasas County,2016-Apr,9180,8837,343,3.7
Lampasas County,2016-May,9201,8851,350,3.8
Lampasas County,2016-Jun,9204,8787,417,4.5
Lampasas County,2016-Jul,9189,8766,423,4.6
Lampasas County,2016-Aug,9175,8767,408,4.4
Lampasas County,2016-Sep,9172,8760,412,4.5
Lampasas County,2016-Oct,9163,8779,384,4.2
Lampasas County,2016-Nov,9185,8825,360,3.9
Lampasas County,2016-Dec,9171,8811,360,3.9
Lampasas County,2017-Jan,9063,8683,380,4.2
Lampasas County,2017-Feb,9144,8741,403,4.4
Lampasas County,2017-Mar,9158,8797,361,3.9
Lampasas County,2017-Apr,9194,8878,316,3.4
Lampasas County,2017-May,9201,8877,324,3.5
Lampasas County,2017-Jun,9171,8826,345,3.8
Lampasas County,2017-Jul,9128,8776,352,3.9
Lampasas County,2017-Aug,9148,8788,360,3.9
Lampasas County,2017-Sep,9126,8793,333,3.6
Lampasas County,2017-Oct,9103,8796,307,3.4
Lampasas County,2017-Nov,9157,8825,332,3.6
Lampasas County,2017-Dec,9140,8818,322,3.5
Lampasas County,2018-Jan,9017,8671,346,3.8
Lampasas County,2018-Feb,9078,8732,346,3.8
Lampasas County,2018-Mar,9076,8735,341,3.8
Lampasas County,2018-Apr,9083,8771,312,3.4
Lampasas County,2018-May,9078,8763,315,3.5
Lampasas County,2018-Jun,9054,8685,369,4.1
Lampasas County,2018-Jul,9057,8699,358,4
Lampasas County,2018-Aug,9031,8672,359,4
Lampasas County,2018-Sep,9058,8709,349,3.9
Lampasas County,2018-Oct,9069,8727,342,3.8
Lampasas County,2018-Nov,9075,8745,330,3.6
Lampasas County,2018-Dec,9067,8737,330,3.6
Lampasas County,2019-Jan,8948,8587,361,4
Lampasas County,2019-Feb,8999,8663,336,3.7
Lampasas County,2019-Mar,8976,8668,308,3.4
Lampasas County,2019-Apr,8963,8709,254,2.8
Lampasas County,2019-May,8952,8696,256,2.9
Lampasas County,2019-Jun,8981,8659,322,3.6
Lampasas County,2019-Jul,9013,8685,328,3.6
Lampasas County,2019-Aug,9018,8707,311,3.4
Lampasas County,2019-Sep,9022,8737,285,3.2
Lampasas County,2019-Oct,9046,8765,281,3.1
Lampasas County,2019-Nov,9073,8780,293,3.2
Lampasas County,2019-Dec,9068,8798,270,3
Lampasas County,2020-Jan,9058,8751,307,3.4
Lampasas County,2020-Feb,9121,8825,296,3.2
Lampasas County,2020-Mar,8969,8525,444,5
Lampasas County,2020-Apr,8391,7756,635,7.6
Lampasas County,2020-May,8617,7992,625,7.3
Lampasas County,2020-Jun,8836,8219,617,7
Lampasas County,2020-Jul,8968,8399,569,6.3
Lampasas County,2020-Aug,9055,8607,448,4.9
Lampasas County,2020-Sep,9053,8593,460,5.1
Lampasas County,2020-Oct,9142,8719,423,4.6
Lampasas County,2020-Nov,9166,8705,461,5
Lampasas County,2020-Dec,9188,8708,480,5.2
Lampasas County,2021-Jan,9195,8680,515,5.6
Lampasas County,2021-Feb,9261,8731,530,5.7
Lampasas County,2021-Mar,9293,8792,501,5.4
Lampasas County,2021-Apr,9288,8847,441,4.7
Lampasas County,2021-May,9306,8859,447,4.8
Lampasas County,2021-Jun,9310,8803,507,5.4
Lampasas County,2021-Jul,9276,8826,450,4.9
Lampasas County,2021-Aug,9285,8854,431,4.6
Lampasas County,2021-Sep,9282,8881,401,4.3
Lampasas County,2021-Oct,9335,8936,399,4.3
Lampasas County,2021-Nov,9341,8961,380,4.1
Lampasas County,2021-Dec,9314,8970,344,3.7
Lampasas County,2022-Jan,9290,8906,384,4.1
Lampasas County,2022-Feb,9455,9062,393,4.2
Lampasas County,2022-Mar,9485,9168,317,3.3
Lampasas County,2022-Apr,9399,9112,287,3.1
Lampasas County,2022-May,9358,9045,313,3.3
Lampasas County,2022-Jun,9348,8991,357,3.8
Lampasas County,2022-Jul,9414(P),9052(P),362(P),3.8(P)
La Salle County,2012-Jan,3313,3133,180,5.4
La Salle County,2012-Feb,3425,3249,176,5.1
La Salle County,2012-Mar,3487,3322,165,4.7
La Salle County,2012-Apr,3533,3378,155,4.4
La Salle County,2012-May,3670,3506,164,4.5
La Salle County,2012-Jun,3722,3547,175,4.7
La Salle County,2012-Jul,3839,3658,181,4.7
La Salle County,2012-Aug,3800,3638,162,4.3
La Salle County,2012-Sep,3809,3663,146,3.8
La Salle County,2012-Oct,3759,3616,143,3.8
La Salle County,2012-Nov,3735,3590,145,3.9
La Salle County,2012-Dec,3859,3700,159,4.1
La Salle County,2013-Jan,4041,3862,179,4.4
La Salle County,2013-Feb,4052,3880,172,4.2
La Salle County,2013-Mar,3982,3824,158,4
La Salle County,2013-Apr,4030,3881,149,3.7
La Salle County,2013-May,4083,3920,163,4
La Salle County,2013-Jun,4142,3962,180,4.3
La Salle County,2013-Jul,4222,4059,163,3.9
La Salle County,2013-Aug,4269,4119,150,3.5
La Salle County,2013-Sep,4299,4149,150,3.5
La Salle County,2013-Oct,4306,4157,149,3.5
La Salle County,2013-Nov,4281,4136,145,3.4
La Salle County,2013-Dec,4313,4174,139,3.2
La Salle County,2014-Jan,4435,4292,143,3.2
La Salle County,2014-Feb,4455,4301,154,3.5
La Salle County,2014-Mar,4440,4289,151,3.4
La Salle County,2014-Apr,4385,4254,131,3
La Salle County,2014-May,4448,4302,146,3.3
La Salle County,2014-Jun,4524,4364,160,3.5
La Salle County,2014-Jul,4653,4497,156,3.4
La Salle County,2014-Aug,4666,4520,146,3.1
La Salle County,2014-Sep,4703,4562,141,3
La Salle County,2014-Oct,4728,4596,132,2.8
La Salle County,2014-Nov,4756,4633,123,2.6
La Salle County,2014-Dec,4638,4505,133,2.9
La Salle County,2015-Jan,4743,4590,153,3.2
La Salle County,2015-Feb,4366,4196,170,3.9
La Salle County,2015-Mar,4355,4176,179,4.1
La Salle County,2015-Apr,4348,4173,175,4
La Salle County,2015-May,4352,4171,181,4.2
La Salle County,2015-Jun,4453,4257,196,4.4
La Salle County,2015-Jul,4494,4299,195,4.3
La Salle County,2015-Aug,4206,4020,186,4.4
La Salle County,2015-Sep,4068,3895,173,4.3
La Salle County,2015-Oct,4010,3824,186,4.6
La Salle County,2015-Nov,3943,3759,184,4.7
La Salle County,2015-Dec,3908,3737,171,4.4
La Salle County,2016-Jan,3966,3786,180,4.5
La Salle County,2016-Feb,4000,3813,187,4.7
La Salle County,2016-Mar,3977,3779,198,5
La Salle County,2016-Apr,3929,3723,206,5.2
La Salle County,2016-May,3932,3733,199,5.1
La Salle County,2016-Jun,3827,3606,221,5.8
La Salle County,2016-Jul,3953,3729,224,5.7
La Salle County,2016-Aug,3915,3700,215,5.5
La Salle County,2016-Sep,3853,3639,214,5.6
La Salle County,2016-Oct,3766,3573,193,5.1
La Salle County,2016-Nov,3771,3588,183,4.9
La Salle County,2016-Dec,3762,3579,183,4.9
La Salle County,2017-Jan,3838,3632,206,5.4
La Salle County,2017-Feb,3883,3682,201,5.2
La Salle County,2017-Mar,3939,3764,175,4.4
La Salle County,2017-Apr,4069,3911,158,3.9
La Salle County,2017-May,4363,4209,154,3.5
La Salle County,2017-Jun,4504,4346,158,3.5
La Salle County,2017-Jul,4412,4249,163,3.7
La Salle County,2017-Aug,4266,4113,153,3.6
La Salle County,2017-Sep,4273,4143,130,3
La Salle County,2017-Oct,4160,4043,117,2.8
La Salle County,2017-Nov,4172,4053,119,2.9
La Salle County,2017-Dec,4219,4105,114,2.7
La Salle County,2018-Jan,4365,4232,133,3
La Salle County,2018-Feb,4450,4327,123,2.8
La Salle County,2018-Mar,4473,4361,112,2.5
La Salle County,2018-Apr,4533,4425,108,2.4
La Salle County,2018-May,4459,4353,106,2.4
La Salle County,2018-Jun,4600,4480,120,2.6
La Salle County,2018-Jul,4745,4627,118,2.5
La Salle County,2018-Aug,4697,4577,120,2.6
La Salle County,2018-Sep,4610,4510,100,2.2
La Salle County,2018-Oct,4540,4443,97,2.1
La Salle County,2018-Nov,4521,4422,99,2.2
La Salle County,2018-Dec,4490,4399,91,2
La Salle County,2019-Jan,4534,4423,111,2.4
La Salle County,2019-Feb,4416,4311,105,2.4
La Salle County,2019-Mar,4339,4235,104,2.4
La Salle County,2019-Apr,4286,4203,83,1.9
La Salle County,2019-May,4308,4219,89,2.1
La Salle County,2019-Jun,4276,4169,107,2.5
La Salle County,2019-Jul,4459,4353,106,2.4
La Salle County,2019-Aug,4361,4247,114,2.6
La Salle County,2019-Sep,4281,4169,112,2.6
La Salle County,2019-Oct,4281,4172,109,2.5
La Salle County,2019-Nov,4269,4155,114,2.7
La Salle County,2019-Dec,4222,4119,103,2.4
La Salle County,2020-Jan,4159,4044,115,2.8
La Salle County,2020-Feb,4164,4038,126,3
La Salle County,2020-Mar,4065,3876,189,4.6
La Salle County,2020-Apr,3458,3172,286,8.3
La Salle County,2020-May,3477,3127,350,10.1
La Salle County,2020-Jun,3471,3119,352,10.1
La Salle County,2020-Jul,3501,3163,338,9.7
La Salle County,2020-Aug,3567,3288,279,7.8
La Salle County,2020-Sep,3552,3282,270,7.6
La Salle County,2020-Oct,3613,3387,226,6.3
La Salle County,2020-Nov,3714,3481,233,6.3
La Salle County,2020-Dec,3699,3475,224,6.1
La Salle County,2021-Jan,3650,3432,218,6
La Salle County,2021-Feb,3685,3470,215,5.8
La Salle County,2021-Mar,3714,3520,194,5.2
La Salle County,2021-Apr,3725,3553,172,4.6
La Salle County,2021-May,3655,3499,156,4.3
La Salle County,2021-Jun,3731,3552,179,4.8
La Salle County,2021-Jul,3897,3736,161,4.1
La Salle County,2021-Aug,3922,3771,151,3.9
La Salle County,2021-Sep,3897,3754,143,3.7
La Salle County,2021-Oct,3896,3766,130,3.3
La Salle County,2021-Nov,3956,3830,126,3.2
La Salle County,2021-Dec,3918,3805,113,2.9
La Salle County,2022-Jan,3898,3761,137,3.5
La Salle County,2022-Feb,3945,3812,133,3.4
La Salle County,2022-Mar,3963,3856,107,2.7
La Salle County,2022-Apr,3777,3666,111,2.9
La Salle County,2022-May,3738,3622,116,3.1
La Salle County,2022-Jun,3776,3635,141,3.7
La Salle County,2022-Jul,3936(P),3803(P),133(P),3.4(P)
Lavaca County,2012-Jan,9571,9074,497,5.2
Lavaca County,2012-Feb,9531,9062,469,4.9
Lavaca County,2012-Mar,9497,9058,439,4.6
Lavaca County,2012-Apr,9561,9141,420,4.4
Lavaca County,2012-May,9539,9088,451,4.7
Lavaca County,2012-Jun,9684,9180,504,5.2
Lavaca County,2012-Jul,9557,9040,517,5.4
Lavaca County,2012-Aug,9374,8906,468,5
Lavaca County,2012-Sep,9348,8905,443,4.7
Lavaca County,2012-Oct,9333,8912,421,4.5
Lavaca County,2012-Nov,9288,8880,408,4.4
Lavaca County,2012-Dec,9237,8827,410,4.4
Lavaca County,2013-Jan,9150,8667,483,5.3
Lavaca County,2013-Feb,9106,8664,442,4.9
Lavaca County,2013-Mar,9132,8703,429,4.7
Lavaca County,2013-Apr,9169,8761,408,4.4
Lavaca County,2013-May,9242,8804,438,4.7
Lavaca County,2013-Jun,9375,8879,496,5.3
Lavaca County,2013-Jul,9375,8901,474,5.1
Lavaca County,2013-Aug,9207,8770,437,4.7
Lavaca County,2013-Sep,9243,8803,440,4.8
Lavaca County,2013-Oct,9182,8769,413,4.5
Lavaca County,2013-Nov,9162,8770,392,4.3
Lavaca County,2013-Dec,9178,8810,368,4
Lavaca County,2014-Jan,9034,8646,388,4.3
Lavaca County,2014-Feb,8982,8589,393,4.4
Lavaca County,2014-Mar,8873,8499,374,4.2
Lavaca County,2014-Apr,9018,8707,311,3.4
Lavaca County,2014-May,8995,8644,351,3.9
Lavaca County,2014-Jun,9151,8763,388,4.2
Lavaca County,2014-Jul,9034,8633,401,4.4
Lavaca County,2014-Aug,9002,8616,386,4.3
Lavaca County,2014-Sep,8930,8576,354,4
Lavaca County,2014-Oct,8888,8563,325,3.7
Lavaca County,2014-Nov,8839,8528,311,3.5
Lavaca County,2014-Dec,8777,8491,286,3.3
Lavaca County,2015-Jan,8737,8419,318,3.6
Lavaca County,2015-Feb,8691,8384,307,3.5
Lavaca County,2015-Mar,8735,8438,297,3.4
Lavaca County,2015-Apr,8830,8525,305,3.5
Lavaca County,2015-May,8940,8607,333,3.7
Lavaca County,2015-Jun,9027,8663,364,4
Lavaca County,2015-Jul,8918,8539,379,4.2
Lavaca County,2015-Aug,8770,8420,350,4
Lavaca County,2015-Sep,8740,8380,360,4.1
Lavaca County,2015-Oct,8844,8492,352,4
Lavaca County,2015-Nov,8786,8444,342,3.9
Lavaca County,2015-Dec,8678,8357,321,3.7
Lavaca County,2016-Jan,8599,8272,327,3.8
Lavaca County,2016-Feb,8725,8378,347,4
Lavaca County,2016-Mar,8769,8408,361,4.1
Lavaca County,2016-Apr,8773,8431,342,3.9
Lavaca County,2016-May,8829,8486,343,3.9
Lavaca County,2016-Jun,8866,8474,392,4.4
Lavaca County,2016-Jul,8748,8339,409,4.7
Lavaca County,2016-Aug,8707,8311,396,4.5
Lavaca County,2016-Sep,8715,8310,405,4.6
Lavaca County,2016-Oct,8768,8389,379,4.3
Lavaca County,2016-Nov,8728,8357,371,4.3
Lavaca County,2016-Dec,8718,8356,362,4.2
Lavaca County,2017-Jan,8559,8178,381,4.5
Lavaca County,2017-Feb,8653,8291,362,4.2
Lavaca County,2017-Mar,8692,8356,336,3.9
Lavaca County,2017-Apr,8717,8420,297,3.4
Lavaca County,2017-May,8747,8445,302,3.5
Lavaca County,2017-Jun,8862,8541,321,3.6
Lavaca County,2017-Jul,8816,8489,327,3.7
Lavaca County,2017-Aug,8786,8461,325,3.7
Lavaca County,2017-Sep,8528,8233,295,3.5
Lavaca County,2017-Oct,8551,8280,271,3.2
Lavaca County,2017-Nov,8550,8258,292,3.4
Lavaca County,2017-Dec,8567,8296,271,3.2
Lavaca County,2018-Jan,8602,8298,304,3.5
Lavaca County,2018-Feb,8639,8350,289,3.3
Lavaca County,2018-Mar,8696,8408,288,3.3
Lavaca County,2018-Apr,8770,8507,263,3
Lavaca County,2018-May,8798,8539,259,2.9
Lavaca County,2018-Jun,8843,8550,293,3.3
Lavaca County,2018-Jul,8809,8523,286,3.2
Lavaca County,2018-Aug,8725,8450,275,3.2
Lavaca County,2018-Sep,8666,8401,265,3.1
Lavaca County,2018-Oct,8653,8406,247,2.9
Lavaca County,2018-Nov,8661,8406,255,2.9
Lavaca County,2018-Dec,8535,8286,249,2.9
Lavaca County,2019-Jan,8490,8201,289,3.4
Lavaca County,2019-Feb,8483,8215,268,3.2
Lavaca County,2019-Mar,8497,8234,263,3.1
Lavaca County,2019-Apr,8481,8256,225,2.7
Lavaca County,2019-May,8480,8243,237,2.8
Lavaca County,2019-Jun,8583,8300,283,3.3
Lavaca County,2019-Jul,8684,8406,278,3.2
Lavaca County,2019-Aug,8689,8422,267,3.1
Lavaca County,2019-Sep,8507,8258,249,2.9
Lavaca County,2019-Oct,8498,8266,232,2.7
Lavaca County,2019-Nov,8392,8157,235,2.8
Lavaca County,2019-Dec,8494,8280,214,2.5
Lavaca County,2020-Jan,8490,8252,238,2.8
Lavaca County,2020-Feb,8456,8230,226,2.7
Lavaca County,2020-Mar,8333,7977,356,4.3
Lavaca County,2020-Apr,7790,7318,472,6.1
Lavaca County,2020-May,8156,7593,563,6.9
Lavaca County,2020-Jun,8285,7722,563,6.8
Lavaca County,2020-Jul,8356,7808,548,6.6
Lavaca County,2020-Aug,8369,7901,468,5.6
Lavaca County,2020-Sep,8397,7913,484,5.8
Lavaca County,2020-Oct,8464,8039,425,5
Lavaca County,2020-Nov,8462,8018,444,5.2
Lavaca County,2020-Dec,8528,8085,443,5.2
Lavaca County,2021-Jan,8564,8100,464,5.4
Lavaca County,2021-Feb,8630,8165,465,5.4
Lavaca County,2021-Mar,8689,8244,445,5.1
Lavaca County,2021-Apr,8590,8206,384,4.5
Lavaca County,2021-May,8460,8087,373,4.4
Lavaca County,2021-Jun,8635,8213,422,4.9
Lavaca County,2021-Jul,8813,8419,394,4.5
Lavaca County,2021-Aug,8787,8409,378,4.3
Lavaca County,2021-Sep,8646,8294,352,4.1
Lavaca County,2021-Oct,8635,8290,345,4
Lavaca County,2021-Nov,8604,8276,328,3.8
Lavaca County,2021-Dec,8623,8332,291,3.4
Lavaca County,2022-Jan,8595,8255,340,4
Lavaca County,2022-Feb,8665,8317,348,4
Lavaca County,2022-Mar,8763,8484,279,3.2
Lavaca County,2022-Apr,8532,8266,266,3.1
Lavaca County,2022-May,8519,8234,285,3.3
Lavaca County,2022-Jun,8631,8313,318,3.7
Lavaca County,2022-Jul,8780(P),8470(P),310(P),3.5(P)
Lee County,2012-Jan,8825,8291,534,6.1
Lee County,2012-Feb,8751,8230,521,6
Lee County,2012-Mar,8895,8416,479,5.4
Lee County,2012-Apr,8805,8353,452,5.1
Lee County,2012-May,8879,8390,489,5.5
Lee County,2012-Jun,9224,8675,549,6
Lee County,2012-Jul,9256,8710,546,5.9
Lee County,2012-Aug,9427,8934,493,5.2
Lee County,2012-Sep,9544,9082,462,4.8
Lee County,2012-Oct,9403,8948,455,4.8
Lee County,2012-Nov,9146,8705,441,4.8
Lee County,2012-Dec,9236,8798,438,4.7
Lee County,2013-Jan,9261,8751,510,5.5
Lee County,2013-Feb,9336,8843,493,5.3
Lee County,2013-Mar,9226,8754,472,5.1
Lee County,2013-Apr,9190,8730,460,5
Lee County,2013-May,9010,8543,467,5.2
Lee County,2013-Jun,9062,8548,514,5.7
Lee County,2013-Jul,9388,8891,497,5.3
Lee County,2013-Aug,9258,8774,484,5.2
Lee County,2013-Sep,9154,8685,469,5.1
Lee County,2013-Oct,8954,8504,450,5
Lee County,2013-Nov,8898,8482,416,4.7
Lee County,2013-Dec,8714,8314,400,4.6
Lee County,2014-Jan,8785,8344,441,5
Lee County,2014-Feb,8822,8396,426,4.8
Lee County,2014-Mar,8919,8513,406,4.6
Lee County,2014-Apr,9164,8799,365,4
Lee County,2014-May,9259,8893,366,4
Lee County,2014-Jun,9386,8984,402,4.3
Lee County,2014-Jul,9665,9259,406,4.2
Lee County,2014-Aug,9525,9141,384,4
Lee County,2014-Sep,9532,9169,363,3.8
Lee County,2014-Oct,9672,9340,332,3.4
Lee County,2014-Nov,9669,9343,326,3.4
Lee County,2014-Dec,9512,9214,298,3.1
Lee County,2015-Jan,9543,9207,336,3.5
Lee County,2015-Feb,9558,9248,310,3.2
Lee County,2015-Mar,9339,9022,317,3.4
Lee County,2015-Apr,9298,9007,291,3.1
Lee County,2015-May,9241,8909,332,3.6
Lee County,2015-Jun,9281,8913,368,4
Lee County,2015-Jul,9084,8697,387,4.3
Lee County,2015-Aug,9121,8779,342,3.7
Lee County,2015-Sep,9349,9018,331,3.5
Lee County,2015-Oct,9278,8950,328,3.5
Lee County,2015-Nov,9272,8933,339,3.7
Lee County,2015-Dec,9285,8970,315,3.4
Lee County,2016-Jan,9364,9040,324,3.5
Lee County,2016-Feb,9369,9045,324,3.5
Lee County,2016-Mar,9326,8996,330,3.5
Lee County,2016-Apr,9207,8899,308,3.3
Lee County,2016-May,9221,8899,322,3.5
Lee County,2016-Jun,9407,9028,379,4
Lee County,2016-Jul,9359,8969,390,4.2
Lee County,2016-Aug,9313,8935,378,4.1
Lee County,2016-Sep,9264,8881,383,4.1
Lee County,2016-Oct,9211,8846,365,4
Lee County,2016-Nov,9144,8793,351,3.8
Lee County,2016-Dec,9247,8902,345,3.7
Lee County,2017-Jan,9196,8834,362,3.9
Lee County,2017-Feb,9290,8913,377,4.1
Lee County,2017-Mar,9265,8923,342,3.7
Lee County,2017-Apr,9168,8871,297,3.2
Lee County,2017-May,9523,9227,296,3.1
Lee County,2017-Jun,9861,9539,322,3.3
Lee County,2017-Jul,9874,9537,337,3.4
Lee County,2017-Aug,9869,9552,317,3.2
Lee County,2017-Sep,9732,9458,274,2.8
Lee County,2017-Oct,9493,9238,255,2.7
Lee County,2017-Nov,9209,8911,298,3.2
Lee County,2017-Dec,9125,8837,288,3.2
Lee County,2018-Jan,9044,8722,322,3.6
Lee County,2018-Feb,9477,9137,340,3.6
Lee County,2018-Mar,9511,9182,329,3.5
Lee County,2018-Apr,9438,9160,278,2.9
Lee County,2018-May,9357,9099,258,2.8
Lee County,2018-Jun,9175,8866,309,3.4
Lee County,2018-Jul,9253,8954,299,3.2
Lee County,2018-Aug,9362,9087,275,2.9
Lee County,2018-Sep,9335,9065,270,2.9
Lee County,2018-Oct,9437,9181,256,2.7
Lee County,2018-Nov,9570,9306,264,2.8
Lee County,2018-Dec,9602,9336,266,2.8
Lee County,2019-Jan,9577,9264,313,3.3
Lee County,2019-Feb,9870,9585,285,2.9
Lee County,2019-Mar,10122,9848,274,2.7
Lee County,2019-Apr,10276,10057,219,2.1
Lee County,2019-May,10261,10032,229,2.2
Lee County,2019-Jun,10045,9759,286,2.8
Lee County,2019-Jul,9946,9653,293,2.9
Lee County,2019-Aug,10032,9760,272,2.7
Lee County,2019-Sep,9993,9737,256,2.6
Lee County,2019-Oct,10191,9937,254,2.5
Lee County,2019-Nov,10005,9748,257,2.6
Lee County,2019-Dec,9750,9510,240,2.5
Lee County,2020-Jan,9320,9047,273,2.9
Lee County,2020-Feb,9324,9065,259,2.8
Lee County,2020-Mar,9205,8783,422,4.6
Lee County,2020-Apr,8758,8177,581,6.6
Lee County,2020-May,8874,8284,590,6.6
Lee County,2020-Jun,9077,8508,569,6.3
Lee County,2020-Jul,9057,8495,562,6.2
Lee County,2020-Aug,9085,8636,449,4.9
Lee County,2020-Sep,9151,8705,446,4.9
Lee County,2020-Oct,9144,8747,397,4.3
Lee County,2020-Nov,9077,8655,422,4.6
Lee County,2020-Dec,8960,8539,421,4.7
Lee County,2021-Jan,8985,8510,475,5.3
Lee County,2021-Feb,8843,8364,479,5.4
Lee County,2021-Mar,8821,8377,444,5
Lee County,2021-Apr,9021,8638,383,4.2
Lee County,2021-May,9149,8773,376,4.1
Lee County,2021-Jun,9269,8840,429,4.6
Lee County,2021-Jul,9285,8881,404,4.4
Lee County,2021-Aug,9175,8810,365,4
Lee County,2021-Sep,9075,8738,337,3.7
Lee County,2021-Oct,9100,8761,339,3.7
Lee County,2021-Nov,9046,8716,330,3.6
Lee County,2021-Dec,8918,8620,298,3.3
Lee County,2022-Jan,8817,8480,337,3.8
Lee County,2022-Feb,8838,8486,352,4
Lee County,2022-Mar,8942,8655,287,3.2
Lee County,2022-Apr,8999,8726,273,3
Lee County,2022-May,9041,8761,280,3.1
Lee County,2022-Jun,9101,8766,335,3.7
Lee County,2022-Jul,9060(P),8726(P),334(P),3.7(P)
Leon County,2012-Jan,6868,6287,581,8.5
Leon County,2012-Feb,6814,6271,543,8
Leon County,2012-Mar,6822,6315,507,7.4
Leon County,2012-Apr,6860,6393,467,6.8
Leon County,2012-May,6883,6400,483,7
Leon County,2012-Jun,7050,6496,554,7.9
Leon County,2012-Jul,7015,6471,544,7.8
Leon County,2012-Aug,6903,6386,517,7.5
Leon County,2012-Sep,6976,6490,486,7
Leon County,2012-Oct,7012,6544,468,6.7
Leon County,2012-Nov,7045,6579,466,6.6
Leon County,2012-Dec,7006,6517,489,7
Leon County,2013-Jan,6842,6295,547,8
Leon County,2013-Feb,6793,6279,514,7.6
Leon County,2013-Mar,6761,6273,488,7.2
Leon County,2013-Apr,6943,6489,454,6.5
Leon County,2013-May,6991,6501,490,7
Leon County,2013-Jun,7084,6552,532,7.5
Leon County,2013-Jul,6894,6372,522,7.6
Leon County,2013-Aug,6900,6408,492,7.1
Leon County,2013-Sep,7030,6550,480,6.8
Leon County,2013-Oct,6957,6515,442,6.4
Leon County,2013-Nov,7068,6634,434,6.1
Leon County,2013-Dec,7155,6748,407,5.7
Leon County,2014-Jan,7066,6655,411,5.8
Leon County,2014-Feb,7042,6620,422,6
Leon County,2014-Mar,7114,6723,391,5.5
Leon County,2014-Apr,7132,6777,355,5
Leon County,2014-May,7188,6801,387,5.4
Leon County,2014-Jun,7256,6843,413,5.7
Leon County,2014-Jul,7267,6837,430,5.9
Leon County,2014-Aug,7374,6956,418,5.7
Leon County,2014-Sep,7397,6998,399,5.4
Leon County,2014-Oct,7353,6996,357,4.9
Leon County,2014-Nov,7164,6818,346,4.8
Leon County,2014-Dec,7165,6839,326,4.5
Leon County,2015-Jan,7273,6906,367,5
Leon County,2015-Feb,7216,6869,347,4.8
Leon County,2015-Mar,7193,6846,347,4.8
Leon County,2015-Apr,7081,6725,356,5
Leon County,2015-May,7045,6676,369,5.2
Leon County,2015-Jun,6961,6560,401,5.8
Leon County,2015-Jul,6878,6482,396,5.8
Leon County,2015-Aug,6770,6385,385,5.7
Leon County,2015-Sep,6803,6430,373,5.5
Leon County,2015-Oct,6735,6374,361,5.4
Leon County,2015-Nov,6665,6282,383,5.7
Leon County,2015-Dec,6606,6220,386,5.8
Leon County,2016-Jan,6446,6038,408,6.3
Leon County,2016-Feb,6641,6215,426,6.4
Leon County,2016-Mar,6666,6247,419,6.3
Leon County,2016-Apr,6640,6247,393,5.9
Leon County,2016-May,6699,6302,397,5.9
Leon County,2016-Jun,6622,6167,455,6.9
Leon County,2016-Jul,6484,6028,456,7
Leon County,2016-Aug,6509,6061,448,6.9
Leon County,2016-Sep,6385,5939,446,7
Leon County,2016-Oct,6382,5962,420,6.6
Leon County,2016-Nov,6354,5961,393,6.2
Leon County,2016-Dec,6336,5929,407,6.4
Leon County,2017-Jan,6324,5842,482,7.6
Leon County,2017-Feb,6335,5858,477,7.5
Leon County,2017-Mar,6335,5916,419,6.6
Leon County,2017-Apr,6184,5793,391,6.3
Leon County,2017-May,6072,5698,374,6.2
Leon County,2017-Jun,6123,5720,403,6.6
Leon County,2017-Jul,5947,5556,391,6.6
Leon County,2017-Aug,6034,5625,409,6.8
Leon County,2017-Sep,6014,5662,352,5.9
Leon County,2017-Oct,6141,5815,326,5.3
Leon County,2017-Nov,6072,5734,338,5.6
Leon County,2017-Dec,6142,5802,340,5.5
Leon County,2018-Jan,6014,5655,359,6
Leon County,2018-Feb,6041,5685,356,5.9
Leon County,2018-Mar,6114,5765,349,5.7
Leon County,2018-Apr,6061,5749,312,5.1
Leon County,2018-May,6069,5781,288,4.7
Leon County,2018-Jun,6115,5783,332,5.4
Leon County,2018-Jul,6070,5766,304,5
Leon County,2018-Aug,6128,5837,291,4.7
Leon County,2018-Sep,6084,5811,273,4.5
Leon County,2018-Oct,6053,5794,259,4.3
Leon County,2018-Nov,6027,5756,271,4.5
Leon County,2018-Dec,6065,5788,277,4.6
Leon County,2019-Jan,6170,5857,313,5.1
Leon County,2019-Feb,6198,5917,281,4.5
Leon County,2019-Mar,6222,5963,259,4.2
Leon County,2019-Apr,6163,5949,214,3.5
Leon County,2019-May,6153,5911,242,3.9
Leon County,2019-Jun,6270,5978,292,4.7
Leon County,2019-Jul,6312,6012,300,4.8
Leon County,2019-Aug,6354,6061,293,4.6
Leon County,2019-Sep,6314,6026,288,4.6
Leon County,2019-Oct,6312,6040,272,4.3
Leon County,2019-Nov,6215,5958,257,4.1
Leon County,2019-Dec,6244,5996,248,4
Leon County,2020-Jan,6152,5856,296,4.8
Leon County,2020-Feb,6161,5882,279,4.5
Leon County,2020-Mar,6157,5735,422,6.9
Leon County,2020-Apr,5631,5099,532,9.4
Leon County,2020-May,5807,5222,585,10.1
Leon County,2020-Jun,5937,5341,596,10
Leon County,2020-Jul,6051,5497,554,9.2
Leon County,2020-Aug,6064,5600,464,7.7
Leon County,2020-Sep,6127,5658,469,7.7
Leon County,2020-Oct,6134,5685,449,7.3
Leon County,2020-Nov,6099,5610,489,8
Leon County,2020-Dec,6192,5661,531,8.6
Leon County,2021-Jan,6224,5671,553,8.9
Leon County,2021-Feb,6307,5789,518,8.2
Leon County,2021-Mar,6409,5918,491,7.7
Leon County,2021-Apr,6328,5888,440,7
Leon County,2021-May,6230,5807,423,6.8
Leon County,2021-Jun,6221,5740,481,7.7
Leon County,2021-Jul,6049,5604,445,7.4
Leon County,2021-Aug,6152,5720,432,7
Leon County,2021-Sep,6152,5754,398,6.5
Leon County,2021-Oct,6081,5702,379,6.2
Leon County,2021-Nov,6015,5659,356,5.9
Leon County,2021-Dec,6032,5697,335,5.6
Leon County,2022-Jan,6041,5645,396,6.6
Leon County,2022-Feb,6197,5809,388,6.3
Leon County,2022-Mar,6309,5987,322,5.1
Leon County,2022-Apr,6272,5980,292,4.7
Leon County,2022-May,6201,5888,313,5
Leon County,2022-Jun,6181,5823,358,5.8
Leon County,2022-Jul,6264(P),5908(P),356(P),5.7(P)
Liberty County,2012-Jan,30397,27205,3192,10.5
Liberty County,2012-Feb,30503,27419,3084,10.1
Liberty County,2012-Mar,30475,27602,2873,9.4
Liberty County,2012-Apr,30493,27742,2751,9
Liberty County,2012-May,30733,27810,2923,9.5
Liberty County,2012-Jun,31076,27835,3241,10.4
Liberty County,2012-Jul,31112,27946,3166,10.2
Liberty County,2012-Aug,30881,27877,3004,9.7
Liberty County,2012-Sep,30958,28146,2812,9.1
Liberty County,2012-Oct,30968,28260,2708,8.7
Liberty County,2012-Nov,30948,28298,2650,8.6
Liberty County,2012-Dec,31088,28272,2816,9.1
Liberty County,2013-Jan,30733,27651,3082,10
Liberty County,2013-Feb,30790,27902,2888,9.4
Liberty County,2013-Mar,30692,27958,2734,8.9
Liberty County,2013-Apr,30794,28166,2628,8.5
Liberty County,2013-May,30979,28206,2773,9
Liberty County,2013-Jun,31159,28182,2977,9.6
Liberty County,2013-Jul,31249,28335,2914,9.3
Liberty County,2013-Aug,31046,28214,2832,9.1
Liberty County,2013-Sep,31109,28337,2772,8.9
Liberty County,2013-Oct,30965,28295,2670,8.6
Liberty County,2013-Nov,31082,28494,2588,8.3
Liberty County,2013-Dec,31052,28586,2466,7.9
Liberty County,2014-Jan,30746,28134,2612,8.5
Liberty County,2014-Feb,30914,28382,2532,8.2
Liberty County,2014-Mar,30959,28541,2418,7.8
Liberty County,2014-Apr,30804,28677,2127,6.9
Liberty County,2014-May,30885,28691,2194,7.1
Liberty County,2014-Jun,31072,28668,2404,7.7
Liberty County,2014-Jul,31213,28775,2438,7.8
Liberty County,2014-Aug,31008,28664,2344,7.6
Liberty County,2014-Sep,30957,28829,2128,6.9
Liberty County,2014-Oct,30961,29006,1955,6.3
Liberty County,2014-Nov,30976,29026,1950,6.3
Liberty County,2014-Dec,30881,29004,1877,6.1
Liberty County,2015-Jan,30857,28694,2163,7
Liberty County,2015-Feb,30931,28838,2093,6.8
Liberty County,2015-Mar,30933,28846,2087,6.7
Liberty County,2015-Apr,30904,28950,1954,6.3
Liberty County,2015-May,30988,28924,2064,6.7
Liberty County,2015-Jun,31076,28808,2268,7.3
Liberty County,2015-Jul,31134,28801,2333,7.5
Liberty County,2015-Aug,30999,28705,2294,7.4
Liberty County,2015-Sep,30860,28686,2174,7
Liberty County,2015-Oct,30923,28798,2125,6.9
Liberty County,2015-Nov,31007,28821,2186,7.1
Liberty County,2015-Dec,30998,28882,2116,6.8
Liberty County,2016-Jan,31236,28997,2239,7.2
Liberty County,2016-Feb,31491,29292,2199,7
Liberty County,2016-Mar,31569,29302,2267,7.2
Liberty County,2016-Apr,31528,29324,2204,7
Liberty County,2016-May,31426,29280,2146,6.8
Liberty County,2016-Jun,31738,29159,2579,8.1
Liberty County,2016-Jul,31827,29172,2655,8.3
Liberty County,2016-Aug,31708,29076,2632,8.3
Liberty County,2016-Sep,31637,29084,2553,8.1
Liberty County,2016-Oct,31419,29128,2291,7.3
Liberty County,2016-Nov,31496,29180,2316,7.4
Liberty County,2016-Dec,31576,29117,2459,7.8
Liberty County,2017-Jan,31677,28951,2726,8.6
Liberty County,2017-Feb,31853,29234,2619,8.2
Liberty County,2017-Mar,31887,29454,2433,7.6
Liberty County,2017-Apr,31841,29582,2259,7.1
Liberty County,2017-May,31666,29504,2162,6.8
Liberty County,2017-Jun,31850,29497,2353,7.4
Liberty County,2017-Jul,31776,29499,2277,7.2
Liberty County,2017-Aug,31812,29433,2379,7.5
Liberty County,2017-Sep,31761,29517,2244,7.1
Liberty County,2017-Oct,31492,29591,1901,6
Liberty County,2017-Nov,31674,29681,1993,6.3
Liberty County,2017-Dec,31713,29693,2020,6.4
Liberty County,2018-Jan,32188,29940,2248,7
Liberty County,2018-Feb,32567,30393,2174,6.7
Liberty County,2018-Mar,32463,30472,1991,6.1
Liberty County,2018-Apr,32373,30530,1843,5.7
Liberty County,2018-May,32319,30535,1784,5.5
Liberty County,2018-Jun,32568,30515,2053,6.3
Liberty County,2018-Jul,32611,30584,2027,6.2
Liberty County,2018-Aug,32313,30416,1897,5.9
Liberty County,2018-Sep,32314,30514,1800,5.6
Liberty County,2018-Oct,32321,30724,1597,4.9
Liberty County,2018-Nov,32424,30788,1636,5
Liberty County,2018-Dec,32509,30785,1724,5.3
Liberty County,2019-Jan,32875,30928,1947,5.9
Liberty County,2019-Feb,33037,31300,1737,5.3
Liberty County,2019-Mar,32890,31301,1589,4.8
Liberty County,2019-Apr,32684,31315,1369,4.2
Liberty County,2019-May,32741,31326,1415,4.3
Liberty County,2019-Jun,33152,31356,1796,5.4
Liberty County,2019-Jul,33260,31423,1837,5.5
Liberty County,2019-Aug,33143,31403,1740,5.2
Liberty County,2019-Sep,33166,31555,1611,4.9
Liberty County,2019-Oct,33230,31681,1549,4.7
Liberty County,2019-Nov,33333,31707,1626,4.9
Liberty County,2019-Dec,33404,31691,1713,5.1
Liberty County,2020-Jan,34284,32341,1943,5.7
Liberty County,2020-Feb,34494,32725,1769,5.1
Liberty County,2020-Mar,34261,31521,2740,8
Liberty County,2020-Apr,32182,27764,4418,13.7
Liberty County,2020-May,33455,28795,4660,13.9
Liberty County,2020-Jun,34118,29576,4542,13.3
Liberty County,2020-Jul,34218,29766,4452,13
Liberty County,2020-Aug,34180,30402,3778,11.1
Liberty County,2020-Sep,34221,30535,3686,10.8
Liberty County,2020-Oct,34469,31075,3394,9.8
Liberty County,2020-Nov,34766,31144,3622,10.4
Liberty County,2020-Dec,34871,31081,3790,10.9
Liberty County,2021-Jan,34901,30859,4042,11.6
Liberty County,2021-Feb,35019,31202,3817,10.9
Liberty County,2021-Mar,34831,31348,3483,10
Liberty County,2021-Apr,34831,31462,3369,9.7
Liberty County,2021-May,34604,31453,3151,9.1
Liberty County,2021-Jun,34986,31418,3568,10.2
Liberty County,2021-Jul,35038,31715,3323,9.5
Liberty County,2021-Aug,34836,31776,3060,8.8
Liberty County,2021-Sep,34754,31966,2788,8
Liberty County,2021-Oct,34759,32111,2648,7.6
Liberty County,2021-Nov,34905,32343,2562,7.3
Liberty County,2021-Dec,34976,32470,2506,7.2
Liberty County,2022-Jan,35099,32230,2869,8.2
Liberty County,2022-Feb,35441,32671,2770,7.8
Liberty County,2022-Mar,35250,32950,2300,6.5
Liberty County,2022-Apr,35094,32938,2156,6.1
Liberty County,2022-May,35204,33036,2168,6.2
Liberty County,2022-Jun,35685,33143,2542,7.1
Liberty County,2022-Jul,35784(P),33262(P),2522(P),7.0(P)
Limestone County,2012-Jan,9629,8905,724,7.5
Limestone County,2012-Feb,9549,8842,707,7.4
Limestone County,2012-Mar,9531,8883,648,6.8
Limestone County,2012-Apr,9493,8885,608,6.4
Limestone County,2012-May,9579,8930,649,6.8
Limestone County,2012-Jun,9696,8971,725,7.5
Limestone County,2012-Jul,9657,8927,730,7.6
Limestone County,2012-Aug,9610,8942,668,7
Limestone County,2012-Sep,9599,8980,619,6.4
Limestone County,2012-Oct,9548,8943,605,6.3
Limestone County,2012-Nov,9580,8992,588,6.1
Limestone County,2012-Dec,9521,8922,599,6.3
Limestone County,2013-Jan,9466,8806,660,7
Limestone County,2013-Feb,9448,8834,614,6.5
Limestone County,2013-Mar,9385,8811,574,6.1
Limestone County,2013-Apr,9342,8788,554,5.9
Limestone County,2013-May,9475,8865,610,6.4
Limestone County,2013-Jun,9523,8852,671,7
Limestone County,2013-Jul,9560,8893,667,7
Limestone County,2013-Aug,9568,8838,730,7.6
Limestone County,2013-Sep,9538,8827,711,7.5
Limestone County,2013-Oct,9432,8743,689,7.3
Limestone County,2013-Nov,9425,8788,637,6.8
Limestone County,2013-Dec,9414,8821,593,6.3
Limestone County,2014-Jan,9258,8614,644,7
Limestone County,2014-Feb,9267,8648,619,6.7
Limestone County,2014-Mar,9266,8680,586,6.3
Limestone County,2014-Apr,9230,8727,503,5.4
Limestone County,2014-May,9281,8727,554,6
Limestone County,2014-Jun,9313,8726,587,6.3
Limestone County,2014-Jul,9265,8666,599,6.5
Limestone County,2014-Aug,9142,8583,559,6.1
Limestone County,2014-Sep,9130,8616,514,5.6
Limestone County,2014-Oct,9085,8612,473,5.2
Limestone County,2014-Nov,9070,8605,465,5.1
Limestone County,2014-Dec,8967,8549,418,4.7
Limestone County,2015-Jan,8896,8433,463,5.2
Limestone County,2015-Feb,8813,8375,438,5
Limestone County,2015-Mar,8664,8247,417,4.8
Limestone County,2015-Apr,8645,8247,398,4.6
Limestone County,2015-May,8645,8225,420,4.9
Limestone County,2015-Jun,8648,8191,457,5.3
Limestone County,2015-Jul,8568,8122,446,5.2
Limestone County,2015-Aug,8439,8021,418,5
Limestone County,2015-Sep,8447,8022,425,5
Limestone County,2015-Oct,8463,8029,434,5.1
Limestone County,2015-Nov,8403,7950,453,5.4
Limestone County,2015-Dec,8368,7935,433,5.2
Limestone County,2016-Jan,8250,7782,468,5.7
Limestone County,2016-Feb,8349,7884,465,5.6
Limestone County,2016-Mar,8401,7933,468,5.6
Limestone County,2016-Apr,8371,7936,435,5.2
Limestone County,2016-May,8423,7976,447,5.3
Limestone County,2016-Jun,8425,7919,506,6
Limestone County,2016-Jul,8348,7830,518,6.2
Limestone County,2016-Aug,8321,7832,489,5.9
Limestone County,2016-Sep,8286,7797,489,5.9
Limestone County,2016-Oct,8258,7806,452,5.5
Limestone County,2016-Nov,8276,7841,435,5.3
Limestone County,2016-Dec,8248,7811,437,5.3
Limestone County,2017-Jan,8236,7715,521,6.3
Limestone County,2017-Feb,8324,7794,530,6.4
Limestone County,2017-Mar,8366,7865,501,6
Limestone County,2017-Apr,8336,7889,447,5.4
Limestone County,2017-May,8288,7854,434,5.2
Limestone County,2017-Jun,8369,7889,480,5.7
Limestone County,2017-Jul,8205,7718,487,5.9
Limestone County,2017-Aug,8235,7751,484,5.9
Limestone County,2017-Sep,8222,7778,444,5.4
Limestone County,2017-Oct,8156,7754,402,4.9
Limestone County,2017-Nov,8176,7749,427,5.2
Limestone County,2017-Dec,8140,7735,405,5
Limestone County,2018-Jan,8369,7929,440,5.3
Limestone County,2018-Feb,8441,8018,423,5
Limestone County,2018-Mar,8428,8008,420,5
Limestone County,2018-Apr,8325,7952,373,4.5
Limestone County,2018-May,8384,8024,360,4.3
Limestone County,2018-Jun,8496,8076,420,4.9
Limestone County,2018-Jul,8310,7895,415,5
Limestone County,2018-Aug,8270,7885,385,4.7
Limestone County,2018-Sep,8193,7820,373,4.6
Limestone County,2018-Oct,8244,7894,350,4.2
Limestone County,2018-Nov,8213,7856,357,4.3
Limestone County,2018-Dec,8247,7893,354,4.3
Limestone County,2019-Jan,8426,8028,398,4.7
Limestone County,2019-Feb,8501,8143,358,4.2
Limestone County,2019-Mar,8509,8183,326,3.8
Limestone County,2019-Apr,8364,8080,284,3.4
Limestone County,2019-May,8379,8094,285,3.4
Limestone County,2019-Jun,8501,8147,354,4.2
Limestone County,2019-Jul,8503,8153,350,4.1
Limestone County,2019-Aug,8558,8220,338,3.9
Limestone County,2019-Sep,8515,8203,312,3.7
Limestone County,2019-Oct,8621,8311,310,3.6
Limestone County,2019-Nov,8616,8296,320,3.7
Limestone County,2019-Dec,8540,8237,303,3.5
Limestone County,2020-Jan,8436,8099,337,4
Limestone County,2020-Feb,8424,8101,323,3.8
Limestone County,2020-Mar,8367,7885,482,5.8
Limestone County,2020-Apr,7975,7342,633,7.9
Limestone County,2020-May,8126,7399,727,8.9
Limestone County,2020-Jun,8245,7468,777,9.4
Limestone County,2020-Jul,8265,7523,742,9
Limestone County,2020-Aug,8295,7665,630,7.6
Limestone County,2020-Sep,8223,7588,635,7.7
Limestone County,2020-Oct,8237,7670,567,6.9
Limestone County,2020-Nov,8188,7596,592,7.2
Limestone County,2020-Dec,8211,7604,607,7.4
Limestone County,2021-Jan,8310,7660,650,7.8
Limestone County,2021-Feb,8428,7781,647,7.7
Limestone County,2021-Mar,8441,7855,586,6.9
Limestone County,2021-Apr,8671,8143,528,6.1
Limestone County,2021-May,8631,8124,507,5.9
Limestone County,2021-Jun,8706,8119,587,6.7
Limestone County,2021-Jul,8673,8130,543,6.3
Limestone County,2021-Aug,8632,8119,513,5.9
Limestone County,2021-Sep,8486,8015,471,5.6
Limestone County,2021-Oct,8492,8041,451,5.3
Limestone County,2021-Nov,8456,8019,437,5.2
Limestone County,2021-Dec,8411,8007,404,4.8
Limestone County,2022-Jan,8481,8016,465,5.5
Limestone County,2022-Feb,8610,8141,469,5.4
Limestone County,2022-Mar,8690,8302,388,4.5
Limestone County,2022-Apr,8652,8297,355,4.1
Limestone County,2022-May,8622,8239,383,4.4
Limestone County,2022-Jun,8661,8220,441,5.1
Limestone County,2022-Jul,8656(P),8237(P),419(P),4.8(P)
Lipscomb County,2012-Jan,1724,1649,75,4.4
Lipscomb County,2012-Feb,1721,1653,68,4
Lipscomb County,2012-Mar,1753,1690,63,3.6
Lipscomb County,2012-Apr,1744,1683,61,3.5
Lipscomb County,2012-May,1762,1695,67,3.8
Lipscomb County,2012-Jun,1835,1759,76,4.1
Lipscomb County,2012-Jul,1773,1695,78,4.4
Lipscomb County,2012-Aug,1736,1667,69,4
Lipscomb County,2012-Sep,1789,1726,63,3.5
Lipscomb County,2012-Oct,1731,1669,62,3.6
Lipscomb County,2012-Nov,1735,1676,59,3.4
Lipscomb County,2012-Dec,1742,1678,64,3.7
Lipscomb County,2013-Jan,1702,1630,72,4.2
Lipscomb County,2013-Feb,1710,1643,67,3.9
Lipscomb County,2013-Mar,1710,1646,64,3.7
Lipscomb County,2013-Apr,1711,1648,63,3.7
Lipscomb County,2013-May,1723,1654,69,4
Lipscomb County,2013-Jun,1782,1702,80,4.5
Lipscomb County,2013-Jul,1738,1663,75,4.3
Lipscomb County,2013-Aug,1705,1635,70,4.1
Lipscomb County,2013-Sep,1726,1656,70,4.1
Lipscomb County,2013-Oct,1711,1644,67,3.9
Lipscomb County,2013-Nov,1680,1617,63,3.8
Lipscomb County,2013-Dec,1707,1649,58,3.4
Lipscomb County,2014-Jan,1701,1641,60,3.5
Lipscomb County,2014-Feb,1721,1659,62,3.6
Lipscomb County,2014-Mar,1746,1688,58,3.3
Lipscomb County,2014-Apr,1752,1701,51,2.9
Lipscomb County,2014-May,1764,1708,56,3.2
Lipscomb County,2014-Jun,1782,1721,61,3.4
Lipscomb County,2014-Jul,1744,1680,64,3.7
Lipscomb County,2014-Aug,1725,1661,64,3.7
Lipscomb County,2014-Sep,1749,1684,65,3.7
Lipscomb County,2014-Oct,1759,1700,59,3.4
Lipscomb County,2014-Nov,1758,1698,60,3.4
Lipscomb County,2014-Dec,1747,1694,53,3
Lipscomb County,2015-Jan,1744,1686,58,3.3
Lipscomb County,2015-Feb,1759,1694,65,3.7
Lipscomb County,2015-Mar,1787,1721,66,3.7
Lipscomb County,2015-Apr,1759,1692,67,3.8
Lipscomb County,2015-May,1764,1693,71,4
Lipscomb County,2015-Jun,1788,1712,76,4.3
Lipscomb County,2015-Jul,1722,1651,71,4.1
Lipscomb County,2015-Aug,1705,1635,70,4.1
Lipscomb County,2015-Sep,1676,1609,67,4
Lipscomb County,2015-Oct,1679,1613,66,3.9
Lipscomb County,2015-Nov,1650,1582,68,4.1
Lipscomb County,2015-Dec,1661,1595,66,4
Lipscomb County,2016-Jan,1626,1559,67,4.1
Lipscomb County,2016-Feb,1663,1596,67,4
Lipscomb County,2016-Mar,1689,1615,74,4.4
Lipscomb County,2016-Apr,1709,1633,76,4.4
Lipscomb County,2016-May,1706,1628,78,4.6
Lipscomb County,2016-Jun,1691,1606,85,5
Lipscomb County,2016-Jul,1658,1576,82,4.9
Lipscomb County,2016-Aug,1645,1567,78,4.7
Lipscomb County,2016-Sep,1610,1537,73,4.5
Lipscomb County,2016-Oct,1618,1550,68,4.2
Lipscomb County,2016-Nov,1605,1540,65,4
Lipscomb County,2016-Dec,1604,1540,64,4
Lipscomb County,2017-Jan,1597,1531,66,4.1
Lipscomb County,2017-Feb,1605,1539,66,4.1
Lipscomb County,2017-Mar,1636,1578,58,3.5
Lipscomb County,2017-Apr,1634,1581,53,3.2
Lipscomb County,2017-May,1622,1573,49,3
Lipscomb County,2017-Jun,1635,1582,53,3.2
Lipscomb County,2017-Jul,1615,1562,53,3.3
Lipscomb County,2017-Aug,1605,1557,48,3
Lipscomb County,2017-Sep,1583,1536,47,3
Lipscomb County,2017-Oct,1625,1581,44,2.7
Lipscomb County,2017-Nov,1593,1548,45,2.8
Lipscomb County,2017-Dec,1601,1559,42,2.6
Lipscomb County,2018-Jan,1629,1580,49,3
Lipscomb County,2018-Feb,1626,1581,45,2.8
Lipscomb County,2018-Mar,1660,1612,48,2.9
Lipscomb County,2018-Apr,1651,1607,44,2.7
Lipscomb County,2018-May,1643,1603,40,2.4
Lipscomb County,2018-Jun,1664,1614,50,3
Lipscomb County,2018-Jul,1658,1608,50,3
Lipscomb County,2018-Aug,1636,1590,46,2.8
Lipscomb County,2018-Sep,1607,1564,43,2.7
Lipscomb County,2018-Oct,1632,1591,41,2.5
Lipscomb County,2018-Nov,1611,1572,39,2.4
Lipscomb County,2018-Dec,1611,1568,43,2.7
Lipscomb County,2019-Jan,1646,1600,46,2.8
Lipscomb County,2019-Feb,1650,1601,49,3
Lipscomb County,2019-Mar,1625,1580,45,2.8
Lipscomb County,2019-Apr,1664,1629,35,2.1
Lipscomb County,2019-May,1643,1606,37,2.3
Lipscomb County,2019-Jun,1624,1575,49,3
Lipscomb County,2019-Jul,1583,1532,51,3.2
Lipscomb County,2019-Aug,1591,1546,45,2.8
Lipscomb County,2019-Sep,1594,1552,42,2.6
Lipscomb County,2019-Oct,1604,1563,41,2.6
Lipscomb County,2019-Nov,1559,1519,40,2.6
Lipscomb County,2019-Dec,1539,1504,35,2.3
Lipscomb County,2020-Jan,1559,1517,42,2.7
Lipscomb County,2020-Feb,1578,1539,39,2.5
Lipscomb County,2020-Mar,1565,1507,58,3.7
Lipscomb County,2020-Apr,1474,1406,68,4.6
Lipscomb County,2020-May,1475,1396,79,5.4
Lipscomb County,2020-Jun,1492,1415,77,5.2
Lipscomb County,2020-Jul,1465,1390,75,5.1
Lipscomb County,2020-Aug,1476,1413,63,4.3
Lipscomb County,2020-Sep,1512,1445,67,4.4
Lipscomb County,2020-Oct,1528,1473,55,3.6
Lipscomb County,2020-Nov,1496,1433,63,4.2
Lipscomb County,2020-Dec,1519,1452,67,4.4
Lipscomb County,2021-Jan,1502,1435,67,4.5
Lipscomb County,2021-Feb,1535,1466,69,4.5
Lipscomb County,2021-Mar,1572,1507,65,4.1
Lipscomb County,2021-Apr,1527,1473,54,3.5
Lipscomb County,2021-May,1510,1455,55,3.6
Lipscomb County,2021-Jun,1514,1455,59,3.9
Lipscomb County,2021-Jul,1477,1420,57,3.9
Lipscomb County,2021-Aug,1483,1428,55,3.7
Lipscomb County,2021-Sep,1493,1441,52,3.5
Lipscomb County,2021-Oct,1491,1438,53,3.6
Lipscomb County,2021-Nov,1458,1412,46,3.2
Lipscomb County,2021-Dec,1459,1418,41,2.8
Lipscomb County,2022-Jan,1468,1416,52,3.5
Lipscomb County,2022-Feb,1524,1473,51,3.3
Lipscomb County,2022-Mar,1558,1520,38,2.4
Lipscomb County,2022-Apr,1512,1478,34,2.2
Lipscomb County,2022-May,1493,1455,38,2.5
Lipscomb County,2022-Jun,1499,1453,46,3.1
Lipscomb County,2022-Jul,1488(P),1447(P),41(P),2.8(P)
Live Oak County,2012-Jan,5574,5299,275,4.9
Live Oak County,2012-Feb,5507,5236,271,4.9
Live Oak County,2012-Mar,5441,5186,255,4.7
Live Oak County,2012-Apr,5466,5223,243,4.4
Live Oak County,2012-May,5640,5383,257,4.6
Live Oak County,2012-Jun,5896,5606,290,4.9
Live Oak County,2012-Jul,5906,5613,293,5
Live Oak County,2012-Aug,5849,5583,266,4.5
Live Oak County,2012-Sep,5913,5660,253,4.3
Live Oak County,2012-Oct,5981,5737,244,4.1
Live Oak County,2012-Nov,5942,5696,246,4.1
Live Oak County,2012-Dec,5961,5706,255,4.3
Live Oak County,2013-Jan,5868,5576,292,5
Live Oak County,2013-Feb,5925,5651,274,4.6
Live Oak County,2013-Mar,5956,5693,263,4.4
Live Oak County,2013-Apr,5930,5683,247,4.2
Live Oak County,2013-May,6012,5743,269,4.5
Live Oak County,2013-Jun,6108,5810,298,4.9
Live Oak County,2013-Jul,6105,5815,290,4.8
Live Oak County,2013-Aug,6062,5800,262,4.3
Live Oak County,2013-Sep,6074,5805,269,4.4
Live Oak County,2013-Oct,6053,5804,249,4.1
Live Oak County,2013-Nov,6050,5810,240,4
Live Oak County,2013-Dec,6096,5865,231,3.8
Live Oak County,2014-Jan,6010,5768,242,4
Live Oak County,2014-Feb,6046,5811,235,3.9
Live Oak County,2014-Mar,6113,5883,230,3.8
Live Oak County,2014-Apr,6158,5959,199,3.2
Live Oak County,2014-May,6185,5969,216,3.5
Live Oak County,2014-Jun,6255,6021,234,3.7
Live Oak County,2014-Jul,6280,6035,245,3.9
Live Oak County,2014-Aug,6221,5983,238,3.8
Live Oak County,2014-Sep,6245,6030,215,3.4
Live Oak County,2014-Oct,5990,5789,201,3.4
Live Oak County,2014-Nov,5978,5774,204,3.4
Live Oak County,2014-Dec,5785,5593,192,3.3
Live Oak County,2015-Jan,5944,5724,220,3.7
Live Oak County,2015-Feb,5974,5752,222,3.7
Live Oak County,2015-Mar,5951,5725,226,3.8
Live Oak County,2015-Apr,5873,5660,213,3.6
Live Oak County,2015-May,5867,5626,241,4.1
Live Oak County,2015-Jun,5891,5632,259,4.4
Live Oak County,2015-Jul,5926,5665,261,4.4
Live Oak County,2015-Aug,5879,5636,243,4.1
Live Oak County,2015-Sep,5889,5641,248,4.2
Live Oak County,2015-Oct,5880,5639,241,4.1
Live Oak County,2015-Nov,5830,5589,241,4.1
Live Oak County,2015-Dec,5793,5553,240,4.1
Live Oak County,2016-Jan,5369,5097,272,5.1
Live Oak County,2016-Feb,5293,5004,289,5.5
Live Oak County,2016-Mar,5281,4977,304,5.8
Live Oak County,2016-Apr,5281,4966,315,6
Live Oak County,2016-May,5242,4947,295,5.6
Live Oak County,2016-Jun,5212,4876,336,6.4
Live Oak County,2016-Jul,5198,4854,344,6.6
Live Oak County,2016-Aug,5217,4877,340,6.5
Live Oak County,2016-Sep,5152,4824,328,6.4
Live Oak County,2016-Oct,5104,4801,303,5.9
Live Oak County,2016-Nov,5058,4764,294,5.8
Live Oak County,2016-Dec,5062,4774,288,5.7
Live Oak County,2017-Jan,5146,4835,311,6
Live Oak County,2017-Feb,5230,4932,298,5.7
Live Oak County,2017-Mar,5257,4993,264,5
Live Oak County,2017-Apr,5292,5052,240,4.5
Live Oak County,2017-May,5353,5108,245,4.6
Live Oak County,2017-Jun,5491,5229,262,4.8
Live Oak County,2017-Jul,5452,5205,247,4.5
Live Oak County,2017-Aug,5429,5171,258,4.8
Live Oak County,2017-Sep,5454,5219,235,4.3
Live Oak County,2017-Oct,5500,5276,224,4.1
Live Oak County,2017-Nov,5517,5285,232,4.2
Live Oak County,2017-Dec,5407,5187,220,4.1
Live Oak County,2018-Jan,5148,4904,244,4.7
Live Oak County,2018-Feb,5223,5004,219,4.2
Live Oak County,2018-Mar,5226,5021,205,3.9
Live Oak County,2018-Apr,5078,4895,183,3.6
Live Oak County,2018-May,5085,4898,187,3.7
Live Oak County,2018-Jun,5071,4855,216,4.3
Live Oak County,2018-Jul,5054,4847,207,4.1
Live Oak County,2018-Aug,5083,4890,193,3.8
Live Oak County,2018-Sep,5056,4869,187,3.7
Live Oak County,2018-Oct,5178,5006,172,3.3
Live Oak County,2018-Nov,5227,5052,175,3.3
Live Oak County,2018-Dec,5166,4996,170,3.3
Live Oak County,2019-Jan,5317,5120,197,3.7
Live Oak County,2019-Feb,5305,5125,180,3.4
Live Oak County,2019-Mar,5455,5283,172,3.2
Live Oak County,2019-Apr,5359,5211,148,2.8
Live Oak County,2019-May,5393,5242,151,2.8
Live Oak County,2019-Jun,5495,5311,184,3.3
Live Oak County,2019-Jul,5652,5466,186,3.3
Live Oak County,2019-Aug,5639,5466,173,3.1
Live Oak County,2019-Sep,5591,5426,165,3
Live Oak County,2019-Oct,5441,5283,158,2.9
Live Oak County,2019-Nov,5541,5375,166,3
Live Oak County,2019-Dec,5513,5362,151,2.7
Live Oak County,2020-Jan,5451,5267,184,3.4
Live Oak County,2020-Feb,5374,5203,171,3.2
Live Oak County,2020-Mar,5325,5064,261,4.9
Live Oak County,2020-Apr,4984,4564,420,8.4
Live Oak County,2020-May,5032,4551,481,9.6
Live Oak County,2020-Jun,5002,4502,500,10
Live Oak County,2020-Jul,5024,4524,500,10
Live Oak County,2020-Aug,5079,4652,427,8.4
Live Oak County,2020-Sep,5052,4626,426,8.4
Live Oak County,2020-Oct,5055,4661,394,7.8
Live Oak County,2020-Nov,5040,4607,433,8.6
Live Oak County,2020-Dec,5036,4613,423,8.4
Live Oak County,2021-Jan,5061,4631,430,8.5
Live Oak County,2021-Feb,5080,4664,416,8.2
Live Oak County,2021-Mar,5048,4675,373,7.4
Live Oak County,2021-Apr,4981,4638,343,6.9
Live Oak County,2021-May,4934,4610,324,6.6
Live Oak County,2021-Jun,4921,4552,369,7.5
Live Oak County,2021-Jul,4932,4590,342,6.9
Live Oak County,2021-Aug,4885,4562,323,6.6
Live Oak County,2021-Sep,4886,4585,301,6.2
Live Oak County,2021-Oct,4824,4545,279,5.8
Live Oak County,2021-Nov,4855,4583,272,5.6
Live Oak County,2021-Dec,4834,4580,254,5.3
Live Oak County,2022-Jan,4855,4572,283,5.8
Live Oak County,2022-Feb,4883,4612,271,5.5
Live Oak County,2022-Mar,4920,4692,228,4.6
Live Oak County,2022-Apr,4799,4594,205,4.3
Live Oak County,2022-May,4778,4563,215,4.5
Live Oak County,2022-Jun,4752,4502,250,5.3
Live Oak County,2022-Jul,4792(P),4556(P),236(P),4.9(P)
Llano County,2012-Jan,7871,7278,593,7.5
Llano County,2012-Feb,7863,7297,566,7.2
Llano County,2012-Mar,7969,7427,542,6.8
Llano County,2012-Apr,7991,7482,509,6.4
Llano County,2012-May,8100,7552,548,6.8
Llano County,2012-Jun,8337,7755,582,7
Llano County,2012-Jul,8278,7691,587,7.1
Llano County,2012-Aug,8177,7629,548,6.7
Llano County,2012-Sep,8108,7582,526,6.5
Llano County,2012-Oct,8005,7505,500,6.2
Llano County,2012-Nov,7977,7483,494,6.2
Llano County,2012-Dec,7889,7370,519,6.6
Llano County,2013-Jan,7950,7358,592,7.4
Llano County,2013-Feb,7911,7365,546,6.9
Llano County,2013-Mar,8064,7535,529,6.6
Llano County,2013-Apr,8153,7639,514,6.3
Llano County,2013-May,8214,7677,537,6.5
Llano County,2013-Jun,8347,7776,571,6.8
Llano County,2013-Jul,8304,7734,570,6.9
Llano County,2013-Aug,8216,7700,516,6.3
Llano County,2013-Sep,8075,7549,526,6.5
Llano County,2013-Oct,7970,7480,490,6.1
Llano County,2013-Nov,7980,7513,467,5.9
Llano County,2013-Dec,7936,7500,436,5.5
Llano County,2014-Jan,7936,7467,469,5.9
Llano County,2014-Feb,7994,7533,461,5.8
Llano County,2014-Mar,8112,7661,451,5.6
Llano County,2014-Apr,8090,7701,389,4.8
Llano County,2014-May,8192,7767,425,5.2
Llano County,2014-Jun,8264,7824,440,5.3
Llano County,2014-Jul,8240,7777,463,5.6
Llano County,2014-Aug,8135,7684,451,5.5
Llano County,2014-Sep,8048,7623,425,5.3
Llano County,2014-Oct,8055,7670,385,4.8
Llano County,2014-Nov,8004,7631,373,4.7
Llano County,2014-Dec,7859,7514,345,4.4
Llano County,2015-Jan,7974,7587,387,4.9
Llano County,2015-Feb,7939,7570,369,4.6
Llano County,2015-Mar,8081,7729,352,4.4
Llano County,2015-Apr,8193,7864,329,4
Llano County,2015-May,8270,7925,345,4.2
Llano County,2015-Jun,8376,8020,356,4.3
Llano County,2015-Jul,8378,8011,367,4.4
Llano County,2015-Aug,8214,7883,331,4
Llano County,2015-Sep,8140,7793,347,4.3
Llano County,2015-Oct,8109,7770,339,4.2
Llano County,2015-Nov,8111,7766,345,4.3
Llano County,2015-Dec,8045,7723,322,4
Llano County,2016-Jan,7982,7632,350,4.4
Llano County,2016-Feb,8074,7730,344,4.3
Llano County,2016-Mar,8227,7880,347,4.2
Llano County,2016-Apr,8301,7981,320,3.9
Llano County,2016-May,8392,8071,321,3.8
Llano County,2016-Jun,8554,8188,366,4.3
Llano County,2016-Jul,8569,8183,386,4.5
Llano County,2016-Aug,8438,8077,361,4.3
Llano County,2016-Sep,8265,7903,362,4.4
Llano County,2016-Oct,8295,7949,346,4.2
Llano County,2016-Nov,8245,7916,329,4
Llano County,2016-Dec,8213,7889,324,3.9
Llano County,2017-Jan,8183,7817,366,4.5
Llano County,2017-Feb,8202,7831,371,4.5
Llano County,2017-Mar,8282,7943,339,4.1
Llano County,2017-Apr,8308,8024,284,3.4
Llano County,2017-May,8365,8067,298,3.6
Llano County,2017-Jun,8490,8173,317,3.7
Llano County,2017-Jul,8462,8121,341,4
Llano County,2017-Aug,8423,8099,324,3.8
Llano County,2017-Sep,8277,7970,307,3.7
Llano County,2017-Oct,8251,7969,282,3.4
Llano County,2017-Nov,8176,7873,303,3.7
Llano County,2017-Dec,8225,7933,292,3.6
Llano County,2018-Jan,8216,7892,324,3.9
Llano County,2018-Feb,8281,7950,331,4
Llano County,2018-Mar,8418,8087,331,3.9
Llano County,2018-Apr,8458,8164,294,3.5
Llano County,2018-May,8588,8293,295,3.4
Llano County,2018-Jun,8661,8325,336,3.9
Llano County,2018-Jul,8667,8342,325,3.7
Llano County,2018-Aug,8556,8236,320,3.7
Llano County,2018-Sep,8433,8113,320,3.8
Llano County,2018-Oct,8356,8062,294,3.5
Llano County,2018-Nov,8345,8043,302,3.6
Llano County,2018-Dec,8262,7952,310,3.8
Llano County,2019-Jan,8301,7949,352,4.2
Llano County,2019-Feb,8379,8054,325,3.9
Llano County,2019-Mar,8434,8126,308,3.7
Llano County,2019-Apr,8378,8120,258,3.1
Llano County,2019-May,8499,8237,262,3.1
Llano County,2019-Jun,8657,8349,308,3.6
Llano County,2019-Jul,8851,8526,325,3.7
Llano County,2019-Aug,8867,8548,319,3.6
Llano County,2019-Sep,8673,8380,293,3.4
Llano County,2019-Oct,8536,8266,270,3.2
Llano County,2019-Nov,8510,8243,267,3.1
Llano County,2019-Dec,8469,8203,266,3.1
Llano County,2020-Jan,8433,8137,296,3.5
Llano County,2020-Feb,8516,8236,280,3.3
Llano County,2020-Mar,8482,8045,437,5.2
Llano County,2020-Apr,7582,6910,672,8.9
Llano County,2020-May,7967,7326,641,8
Llano County,2020-Jun,8314,7732,582,7
Llano County,2020-Jul,8511,7948,563,6.6
Llano County,2020-Aug,8641,8178,463,5.4
Llano County,2020-Sep,8614,8142,472,5.5
Llano County,2020-Oct,8548,8119,429,5
Llano County,2020-Nov,8541,8073,468,5.5
Llano County,2020-Dec,8566,8082,484,5.7
Llano County,2021-Jan,8508,7984,524,6.2
Llano County,2021-Feb,8480,7968,512,6
Llano County,2021-Mar,8758,8264,494,5.6
Llano County,2021-Apr,8841,8428,413,4.7
Llano County,2021-May,8978,8561,417,4.6
Llano County,2021-Jun,9095,8617,478,5.3
Llano County,2021-Jul,9241,8800,441,4.8
Llano County,2021-Aug,9132,8713,419,4.6
Llano County,2021-Sep,9050,8656,394,4.4
Llano County,2021-Oct,8934,8559,375,4.2
Llano County,2021-Nov,8918,8551,367,4.1
Llano County,2021-Dec,8855,8521,334,3.8
Llano County,2022-Jan,8732,8355,377,4.3
Llano County,2022-Feb,8787,8389,398,4.5
Llano County,2022-Mar,9059,8733,326,3.6
Llano County,2022-Apr,8821,8521,300,3.4
Llano County,2022-May,9022,8699,323,3.6
Llano County,2022-Jun,9197,8833,364,4
Llano County,2022-Jul,9327(P),8965(P),362(P),3.9(P)
Loving County,2012-Jan,69,65,4,5.8
Loving County,2012-Feb,73,69,4,5.5
Loving County,2012-Mar,73,69,4,5.5
Loving County,2012-Apr,61,56,5,8.2
Loving County,2012-May,63,58,5,7.9
Loving County,2012-Jun,64,59,5,7.8
Loving County,2012-Jul,67,62,5,7.5
Loving County,2012-Aug,65,61,4,6.2
Loving County,2012-Sep,63,59,4,6.3
Loving County,2012-Oct,71,67,4,5.6
Loving County,2012-Nov,70,66,4,5.7
Loving County,2012-Dec,72,68,4,5.6
Loving County,2013-Jan,77,73,4,5.2
Loving County,2013-Feb,77,73,4,5.2
Loving County,2013-Mar,72,68,4,5.6
Loving County,2013-Apr,83,79,4,4.8
Loving County,2013-May,84,79,5,6
Loving County,2013-Jun,83,78,5,6
Loving County,2013-Jul,74,69,5,6.8
Loving County,2013-Aug,71,66,5,7
Loving County,2013-Sep,75,70,5,6.7
Loving County,2013-Oct,74,70,4,5.4
Loving County,2013-Nov,67,63,4,6
Loving County,2013-Dec,72,68,4,5.6
Loving County,2014-Jan,69,65,4,5.8
Loving County,2014-Feb,69,65,4,5.8
Loving County,2014-Mar,69,65,4,5.8
Loving County,2014-Apr,77,73,4,5.2
Loving County,2014-May,80,77,3,3.8
Loving County,2014-Jun,83,79,4,4.8
Loving County,2014-Jul,79,75,4,5.1
Loving County,2014-Aug,81,77,4,4.9
Loving County,2014-Sep,81,77,4,4.9
Loving County,2014-Oct,84,80,4,4.8
Loving County,2014-Nov,78,74,4,5.1
Loving County,2014-Dec,86,82,4,4.7
Loving County,2015-Jan,80,76,4,5
Loving County,2015-Feb,76,72,4,5.3
Loving County,2015-Mar,71,67,4,5.6
Loving County,2015-Apr,81,78,3,3.7
Loving County,2015-May,77,74,3,3.9
Loving County,2015-Jun,73,70,3,4.1
Loving County,2015-Jul,72,68,4,5.6
Loving County,2015-Aug,72,68,4,5.6
Loving County,2015-Sep,76,72,4,5.3
Loving County,2015-Oct,80,76,4,5
Loving County,2015-Nov,84,80,4,4.8
Loving County,2015-Dec,82,78,4,4.9
Loving County,2016-Jan,90,86,4,4.4
Loving County,2016-Feb,90,86,4,4.4
Loving County,2016-Mar,94,90,4,4.3
Loving County,2016-Apr,82,78,4,4.9
Loving County,2016-May,84,80,4,4.8
Loving County,2016-Jun,84,80,4,4.8
Loving County,2016-Jul,79,75,4,5.1
Loving County,2016-Aug,79,75,4,5.1
Loving County,2016-Sep,76,72,4,5.3
Loving County,2016-Oct,89,84,5,5.6
Loving County,2016-Nov,96,91,5,5.2
Loving County,2016-Dec,96,91,5,5.2
Loving County,2017-Jan,113,107,6,5.3
Loving County,2017-Feb,114,108,6,5.3
Loving County,2017-Mar,110,104,6,5.5
Loving County,2017-Apr,101,95,6,5.9
Loving County,2017-May,105,100,5,4.8
Loving County,2017-Jun,97,93,4,4.1
Loving County,2017-Jul,94,90,4,4.3
Loving County,2017-Aug,91,87,4,4.4
Loving County,2017-Sep,89,85,4,4.5
Loving County,2017-Oct,93,89,4,4.3
Loving County,2017-Nov,91,87,4,4.4
Loving County,2017-Dec,93,89,4,4.3
Loving County,2018-Jan,221,217,4,1.8
Loving County,2018-Feb,262,258,4,1.5
Loving County,2018-Mar,296,292,4,1.4
Loving County,2018-Apr,274,270,4,1.5
Loving County,2018-May,278,274,4,1.4
Loving County,2018-Jun,256,252,4,1.6
Loving County,2018-Jul,261,257,4,1.5
Loving County,2018-Aug,256,252,4,1.6
Loving County,2018-Sep,248,244,4,1.6
Loving County,2018-Oct,269,265,4,1.5
Loving County,2018-Nov,254,250,4,1.6
Loving County,2018-Dec,310,306,4,1.3
Loving County,2019-Jan,314,309,5,1.6
Loving County,2019-Feb,356,352,4,1.1
Loving County,2019-Mar,400,396,4,1
Loving County,2019-Apr,496,492,4,0.8
Loving County,2019-May,553,549,4,0.7
Loving County,2019-Jun,578,573,5,0.9
Loving County,2019-Jul,586,580,6,1
Loving County,2019-Aug,594,590,4,0.7
Loving County,2019-Sep,607,603,4,0.7
Loving County,2019-Oct,559,555,4,0.7
Loving County,2019-Nov,530,526,4,0.8
Loving County,2019-Dec,403,399,4,1
Loving County,2020-Jan,362,358,4,1.1
Loving County,2020-Feb,333,329,4,1.2
Loving County,2020-Mar,296,290,6,2
Loving County,2020-Apr,248,241,7,2.8
Loving County,2020-May,218,210,8,3.7
Loving County,2020-Jun,203,196,7,3.4
Loving County,2020-Jul,283,278,5,1.8
Loving County,2020-Aug,280,276,4,1.4
Loving County,2020-Sep,314,310,4,1.3
Loving County,2020-Oct,332,328,4,1.2
Loving County,2020-Nov,328,324,4,1.2
Loving County,2020-Dec,338,334,4,1.2
Loving County,2021-Jan,338,334,4,1.2
Loving County,2021-Feb,391,386,5,1.3
Loving County,2021-Mar,378,374,4,1.1
Loving County,2021-Apr,438,434,4,0.9
Loving County,2021-May,459,455,4,0.9
Loving County,2021-Jun,479,474,5,1
Loving County,2021-Jul,435,431,4,0.9
Loving County,2021-Aug,463,458,5,1.1
Loving County,2021-Sep,479,474,5,1
Loving County,2021-Oct,480,475,5,1
Loving County,2021-Nov,472,468,4,0.8
Loving County,2021-Dec,446,442,4,0.9
Loving County,2022-Jan,447,443,4,0.9
Loving County,2022-Feb,489,485,4,0.8
Loving County,2022-Mar,482,478,4,0.8
Loving County,2022-Apr,487,483,4,0.8
Loving County,2022-May,503,499,4,0.8
Loving County,2022-Jun,511,507,4,0.8
Loving County,2022-Jul,527(P),522(P),5(P),0.9(P)
Lubbock County,2012-Jan,143955,135797,8158,5.7
Lubbock County,2012-Feb,144546,136619,7927,5.5
Lubbock County,2012-Mar,144365,136529,7836,5.4
Lubbock County,2012-Apr,144749,137746,7003,4.8
Lubbock County,2012-May,145227,137698,7529,5.2
Lubbock County,2012-Jun,146060,137087,8973,6.1
Lubbock County,2012-Jul,145804,136778,9026,6.2
Lubbock County,2012-Aug,145179,137092,8087,5.6
Lubbock County,2012-Sep,145378,138144,7234,5
Lubbock County,2012-Oct,146043,138991,7052,4.8
Lubbock County,2012-Nov,146444,139622,6822,4.7
Lubbock County,2012-Dec,145621,138676,6945,4.8
Lubbock County,2013-Jan,145228,137332,7896,5.4
Lubbock County,2013-Feb,145948,138522,7426,5.1
Lubbock County,2013-Mar,145687,138141,7546,5.2
Lubbock County,2013-Apr,146956,140156,6800,4.6
Lubbock County,2013-May,147715,140374,7341,5
Lubbock County,2013-Jun,147758,139088,8670,5.9
Lubbock County,2013-Jul,148411,140022,8389,5.7
Lubbock County,2013-Aug,147876,140463,7413,5
Lubbock County,2013-Sep,148060,140857,7203,4.9
Lubbock County,2013-Oct,146946,140192,6754,4.6
Lubbock County,2013-Nov,148071,141601,6470,4.4
Lubbock County,2013-Dec,146987,140956,6031,4.1
Lubbock County,2014-Jan,146082,139744,6338,4.3
Lubbock County,2014-Feb,147769,141319,6450,4.4
Lubbock County,2014-Mar,147687,141624,6063,4.1
Lubbock County,2014-Apr,147676,142457,5219,3.5
Lubbock County,2014-May,148087,142361,5726,3.9
Lubbock County,2014-Jun,147620,140838,6782,4.6
Lubbock County,2014-Jul,148348,141268,7080,4.8
Lubbock County,2014-Aug,147488,141216,6272,4.3
Lubbock County,2014-Sep,147265,141575,5690,3.9
Lubbock County,2014-Oct,148060,142756,5304,3.6
Lubbock County,2014-Nov,148027,142847,5180,3.5
Lubbock County,2014-Dec,146697,142101,4596,3.1
Lubbock County,2015-Jan,148004,142581,5423,3.7
Lubbock County,2015-Feb,149097,143966,5131,3.4
Lubbock County,2015-Mar,149187,144301,4886,3.3
Lubbock County,2015-Apr,149096,144584,4512,3
Lubbock County,2015-May,149408,144435,4973,3.3
Lubbock County,2015-Jun,149221,143280,5941,4
Lubbock County,2015-Jul,149824,143838,5986,4
Lubbock County,2015-Aug,149700,144439,5261,3.5
Lubbock County,2015-Sep,149679,144570,5109,3.4
Lubbock County,2015-Oct,150194,145256,4938,3.3
Lubbock County,2015-Nov,151245,146375,4870,3.2
Lubbock County,2015-Dec,150913,146368,4545,3
Lubbock County,2016-Jan,149730,144735,4995,3.3
Lubbock County,2016-Feb,152494,147444,5050,3.3
Lubbock County,2016-Mar,153135,148091,5044,3.3
Lubbock County,2016-Apr,153632,149029,4603,3
Lubbock County,2016-May,153929,149250,4679,3
Lubbock County,2016-Jun,154009,147931,6078,3.9
Lubbock County,2016-Jul,153777,147546,6231,4.1
Lubbock County,2016-Aug,154097,148463,5634,3.7
Lubbock County,2016-Sep,153747,148331,5416,3.5
Lubbock County,2016-Oct,154572,149483,5089,3.3
Lubbock County,2016-Nov,155610,150728,4882,3.1
Lubbock County,2016-Dec,154782,149904,4878,3.2
Lubbock County,2017-Jan,152878,147664,5214,3.4
Lubbock County,2017-Feb,154575,149153,5422,3.5
Lubbock County,2017-Mar,154905,149358,5547,3.6
Lubbock County,2017-Apr,155220,150754,4466,2.9
Lubbock County,2017-May,154761,150137,4624,3
Lubbock County,2017-Jun,154496,148768,5728,3.7
Lubbock County,2017-Jul,155125,149480,5645,3.6
Lubbock County,2017-Aug,155427,149902,5525,3.6
Lubbock County,2017-Sep,155323,150750,4573,2.9
Lubbock County,2017-Oct,154922,150760,4162,2.7
Lubbock County,2017-Nov,155584,151165,4419,2.8
Lubbock County,2017-Dec,154586,150312,4274,2.8
Lubbock County,2018-Jan,153261,148441,4820,3.1
Lubbock County,2018-Feb,155134,150220,4914,3.2
Lubbock County,2018-Mar,155331,149999,5332,3.4
Lubbock County,2018-Apr,155364,151101,4263,2.7
Lubbock County,2018-May,155322,151094,4228,2.7
Lubbock County,2018-Jun,155395,149757,5638,3.6
Lubbock County,2018-Jul,155729,150253,5476,3.5
Lubbock County,2018-Aug,155001,150043,4958,3.2
Lubbock County,2018-Sep,154724,150053,4671,3
Lubbock County,2018-Oct,154760,150398,4362,2.8
Lubbock County,2018-Nov,155392,151085,4307,2.8
Lubbock County,2018-Dec,154712,150330,4382,2.8
Lubbock County,2019-Jan,154846,149923,4923,3.2
Lubbock County,2019-Feb,156070,151456,4614,3
Lubbock County,2019-Mar,155857,151034,4823,3.1
Lubbock County,2019-Apr,155990,152336,3654,2.3
Lubbock County,2019-May,155649,151853,3796,2.4
Lubbock County,2019-Jun,156127,150946,5181,3.3
Lubbock County,2019-Jul,156460,151137,5323,3.4
Lubbock County,2019-Aug,156513,151860,4653,3
Lubbock County,2019-Sep,156380,152074,4306,2.8
Lubbock County,2019-Oct,157460,153289,4171,2.6
Lubbock County,2019-Nov,157436,153372,4064,2.6
Lubbock County,2019-Dec,156639,152905,3734,2.4
Lubbock County,2020-Jan,156267,151847,4420,2.8
Lubbock County,2020-Feb,157398,153265,4133,2.6
Lubbock County,2020-Mar,154190,147912,6278,4.1
Lubbock County,2020-Apr,144839,131517,13322,9.2
Lubbock County,2020-May,150460,137368,13092,8.7
Lubbock County,2020-Jun,154505,142172,12333,8
Lubbock County,2020-Jul,156079,144379,11700,7.5
Lubbock County,2020-Aug,157765,148596,9169,5.8
Lubbock County,2020-Sep,157767,149079,8688,5.5
Lubbock County,2020-Oct,160032,152235,7797,4.9
Lubbock County,2020-Nov,160428,152182,8246,5.1
Lubbock County,2020-Dec,159909,151695,8214,5.1
Lubbock County,2021-Jan,158405,149666,8739,5.5
Lubbock County,2021-Feb,160792,152283,8509,5.3
Lubbock County,2021-Mar,160914,152593,8321,5.2
Lubbock County,2021-Apr,160768,153423,7345,4.6
Lubbock County,2021-May,160112,153055,7057,4.4
Lubbock County,2021-Jun,159821,151200,8621,5.4
Lubbock County,2021-Jul,158692,150972,7720,4.9
Lubbock County,2021-Aug,159201,152167,7034,4.4
Lubbock County,2021-Sep,160837,154400,6437,4
Lubbock County,2021-Oct,161402,155225,6177,3.8
Lubbock County,2021-Nov,161823,156099,5724,3.5
Lubbock County,2021-Dec,161296,156025,5271,3.3
Lubbock County,2022-Jan,161791,155755,6036,3.7
Lubbock County,2022-Feb,164009,157950,6059,3.7
Lubbock County,2022-Mar,164039,159129,4910,3
Lubbock County,2022-Apr,162553,157955,4598,2.8
Lubbock County,2022-May,162387,157474,4913,3
Lubbock County,2022-Jun,162694,156473,6221,3.8
Lubbock County,2022-Jul,163185(P),157052(P),6133(P),3.8(P)
Lynn County,2012-Jan,2903,2709,194,6.7
Lynn County,2012-Feb,2892,2691,201,7
Lynn County,2012-Mar,2922,2727,195,6.7
Lynn County,2012-Apr,2965,2786,179,6
Lynn County,2012-May,2972,2788,184,6.2
Lynn County,2012-Jun,3025,2820,205,6.8
Lynn County,2012-Jul,3003,2808,195,6.5
Lynn County,2012-Aug,2965,2785,180,6.1
Lynn County,2012-Sep,2967,2809,158,5.3
Lynn County,2012-Oct,2937,2788,149,5.1
Lynn County,2012-Nov,2932,2790,142,4.8
Lynn County,2012-Dec,2885,2736,149,5.2
Lynn County,2013-Jan,2775,2599,176,6.3
Lynn County,2013-Feb,2789,2624,165,5.9
Lynn County,2013-Mar,2770,2608,162,5.8
Lynn County,2013-Apr,2848,2698,150,5.3
Lynn County,2013-May,2896,2737,159,5.5
Lynn County,2013-Jun,2926,2753,173,5.9
Lynn County,2013-Jul,2947,2779,168,5.7
Lynn County,2013-Aug,2873,2722,151,5.3
Lynn County,2013-Sep,2897,2750,147,5.1
Lynn County,2013-Oct,2878,2745,133,4.6
Lynn County,2013-Nov,2809,2686,123,4.4
Lynn County,2013-Dec,2833,2717,116,4.1
Lynn County,2014-Jan,2781,2650,131,4.7
Lynn County,2014-Feb,2878,2730,148,5.1
Lynn County,2014-Mar,2869,2738,131,4.6
Lynn County,2014-Apr,2891,2779,112,3.9
Lynn County,2014-May,2920,2799,121,4.1
Lynn County,2014-Jun,2922,2774,148,5.1
Lynn County,2014-Jul,2909,2760,149,5.1
Lynn County,2014-Aug,2853,2712,141,4.9
Lynn County,2014-Sep,2863,2734,129,4.5
Lynn County,2014-Oct,2854,2741,113,4
Lynn County,2014-Nov,2805,2698,107,3.8
Lynn County,2014-Dec,2756,2661,95,3.4
Lynn County,2015-Jan,2698,2590,108,4
Lynn County,2015-Feb,2784,2668,116,4.2
Lynn County,2015-Mar,2831,2715,116,4.1
Lynn County,2015-Apr,2789,2684,105,3.8
Lynn County,2015-May,2827,2712,115,4.1
Lynn County,2015-Jun,2824,2688,136,4.8
Lynn County,2015-Jul,2774,2648,126,4.5
Lynn County,2015-Aug,2726,2610,116,4.3
Lynn County,2015-Sep,2753,2637,116,4.2
Lynn County,2015-Oct,2752,2646,106,3.9
Lynn County,2015-Nov,2701,2602,99,3.7
Lynn County,2015-Dec,2705,2617,88,3.3
Lynn County,2016-Jan,2587,2493,94,3.6
Lynn County,2016-Feb,2745,2640,105,3.8
Lynn County,2016-Mar,2793,2688,105,3.8
Lynn County,2016-Apr,2799,2701,98,3.5
Lynn County,2016-May,2851,2749,102,3.6
Lynn County,2016-Jun,2793,2667,126,4.5
Lynn County,2016-Jul,2702,2573,129,4.8
Lynn County,2016-Aug,2740,2620,120,4.4
Lynn County,2016-Sep,2705,2587,118,4.4
Lynn County,2016-Oct,2695,2591,104,3.9
Lynn County,2016-Nov,2693,2589,104,3.9
Lynn County,2016-Dec,2669,2571,98,3.7
Lynn County,2017-Jan,2672,2561,111,4.2
Lynn County,2017-Feb,2736,2627,109,4
Lynn County,2017-Mar,2837,2727,110,3.9
Lynn County,2017-Apr,2822,2727,95,3.4
Lynn County,2017-May,2830,2729,101,3.6
Lynn County,2017-Jun,2792,2674,118,4.2
Lynn County,2017-Jul,2709,2591,118,4.4
Lynn County,2017-Aug,2762,2642,120,4.3
Lynn County,2017-Sep,2704,2605,99,3.7
Lynn County,2017-Oct,2749,2664,85,3.1
Lynn County,2017-Nov,2709,2615,94,3.5
Lynn County,2017-Dec,2709,2620,89,3.3
Lynn County,2018-Jan,2643,2547,96,3.6
Lynn County,2018-Feb,2707,2605,102,3.8
Lynn County,2018-Mar,2794,2694,100,3.6
Lynn County,2018-Apr,2747,2656,91,3.3
Lynn County,2018-May,2795,2711,84,3
Lynn County,2018-Jun,2754,2650,104,3.8
Lynn County,2018-Jul,2710,2614,96,3.5
Lynn County,2018-Aug,2761,2673,88,3.2
Lynn County,2018-Sep,2724,2641,83,3
Lynn County,2018-Oct,2698,2623,75,2.8
Lynn County,2018-Nov,2682,2608,74,2.8
Lynn County,2018-Dec,2634,2560,74,2.8
Lynn County,2019-Jan,2646,2560,86,3.3
Lynn County,2019-Feb,2714,2628,86,3.2
Lynn County,2019-Mar,2768,2683,85,3.1
Lynn County,2019-Apr,2747,2674,73,2.7
Lynn County,2019-May,2772,2701,71,2.6
Lynn County,2019-Jun,2748,2657,91,3.3
Lynn County,2019-Jul,2744,2654,90,3.3
Lynn County,2019-Aug,2823,2737,86,3
Lynn County,2019-Sep,2758,2673,85,3.1
Lynn County,2019-Oct,2807,2727,80,2.9
Lynn County,2019-Nov,2726,2652,74,2.7
Lynn County,2019-Dec,2744,2669,75,2.7
Lynn County,2020-Jan,2733,2641,92,3.4
Lynn County,2020-Feb,2778,2683,95,3.4
Lynn County,2020-Mar,2758,2618,140,5.1
Lynn County,2020-Apr,2503,2344,159,6.4
Lynn County,2020-May,2634,2422,212,8
Lynn County,2020-Jun,2693,2486,207,7.7
Lynn County,2020-Jul,2716,2530,186,6.8
Lynn County,2020-Aug,2771,2634,137,4.9
Lynn County,2020-Sep,2736,2595,141,5.2
Lynn County,2020-Oct,2824,2688,136,4.8
Lynn County,2020-Nov,2768,2622,146,5.3
Lynn County,2020-Dec,2756,2618,138,5
Lynn County,2021-Jan,2770,2622,148,5.3
Lynn County,2021-Feb,2852,2707,145,5.1
Lynn County,2021-Mar,2922,2783,139,4.8
Lynn County,2021-Apr,2873,2755,118,4.1
Lynn County,2021-May,2809,2688,121,4.3
Lynn County,2021-Jun,2766,2629,137,5
Lynn County,2021-Jul,2745,2626,119,4.3
Lynn County,2021-Aug,2780,2671,109,3.9
Lynn County,2021-Sep,2802,2693,109,3.9
Lynn County,2021-Oct,2786,2682,104,3.7
Lynn County,2021-Nov,2738,2641,97,3.5
Lynn County,2021-Dec,2733,2640,93,3.4
Lynn County,2022-Jan,2753,2649,104,3.8
Lynn County,2022-Feb,2911,2806,105,3.6
Lynn County,2022-Mar,2995,2907,88,2.9
Lynn County,2022-Apr,2967,2876,91,3.1
Lynn County,2022-May,2898,2798,100,3.5
Lynn County,2022-Jun,2863,2750,113,3.9
Lynn County,2022-Jul,2968(P),2855(P),113(P),3.8(P)
McCulloch County,2012-Jan,4390,4144,246,5.6
McCulloch County,2012-Feb,4363,4125,238,5.5
McCulloch County,2012-Mar,4368,4145,223,5.1
McCulloch County,2012-Apr,4391,4172,219,5
McCulloch County,2012-May,4396,4159,237,5.4
McCulloch County,2012-Jun,4469,4213,256,5.7
McCulloch County,2012-Jul,4443,4187,256,5.8
McCulloch County,2012-Aug,4405,4163,242,5.5
McCulloch County,2012-Sep,4407,4179,228,5.2
McCulloch County,2012-Oct,4368,4135,233,5.3
McCulloch County,2012-Nov,4374,4155,219,5
McCulloch County,2012-Dec,4336,4110,226,5.2
McCulloch County,2013-Jan,4319,4071,248,5.7
McCulloch County,2013-Feb,4297,4072,225,5.2
McCulloch County,2013-Mar,4251,4045,206,4.8
McCulloch County,2013-Apr,4273,4078,195,4.6
McCulloch County,2013-May,4294,4084,210,4.9
McCulloch County,2013-Jun,4309,4072,237,5.5
McCulloch County,2013-Jul,4331,4076,255,5.9
McCulloch County,2013-Aug,4282,4040,242,5.7
McCulloch County,2013-Sep,4298,4046,252,5.9
McCulloch County,2013-Oct,4197,3965,232,5.5
McCulloch County,2013-Nov,4153,3939,214,5.2
McCulloch County,2013-Dec,4159,3956,203,4.9
McCulloch County,2014-Jan,3999,3793,206,5.2
McCulloch County,2014-Feb,4079,3873,206,5.1
McCulloch County,2014-Mar,4068,3878,190,4.7
McCulloch County,2014-Apr,4081,3919,162,4
McCulloch County,2014-May,4069,3895,174,4.3
McCulloch County,2014-Jun,4106,3920,186,4.5
McCulloch County,2014-Jul,4150,3956,194,4.7
McCulloch County,2014-Aug,4133,3952,181,4.4
McCulloch County,2014-Sep,4178,4011,167,4
McCulloch County,2014-Oct,4170,4012,158,3.8
McCulloch County,2014-Nov,4141,3993,148,3.6
McCulloch County,2014-Dec,4099,3970,129,3.1
McCulloch County,2015-Jan,4040,3888,152,3.8
McCulloch County,2015-Feb,4056,3890,166,4.1
McCulloch County,2015-Mar,4067,3911,156,3.8
McCulloch County,2015-Apr,4019,3874,145,3.6
McCulloch County,2015-May,3992,3818,174,4.4
McCulloch County,2015-Jun,3974,3762,212,5.3
McCulloch County,2015-Jul,3940,3721,219,5.6
McCulloch County,2015-Aug,3885,3646,239,6.2
McCulloch County,2015-Sep,3843,3628,215,5.6
McCulloch County,2015-Oct,3814,3603,211,5.5
McCulloch County,2015-Nov,3720,3519,201,5.4
McCulloch County,2015-Dec,3739,3555,184,4.9
McCulloch County,2016-Jan,3692,3504,188,5.1
McCulloch County,2016-Feb,3778,3599,179,4.7
McCulloch County,2016-Mar,3772,3607,165,4.4
McCulloch County,2016-Apr,3759,3601,158,4.2
McCulloch County,2016-May,3757,3601,156,4.2
McCulloch County,2016-Jun,3742,3567,175,4.7
McCulloch County,2016-Jul,3693,3516,177,4.8
McCulloch County,2016-Aug,3722,3548,174,4.7
McCulloch County,2016-Sep,3642,3468,174,4.8
McCulloch County,2016-Oct,3646,3490,156,4.3
McCulloch County,2016-Nov,3645,3499,146,4
McCulloch County,2016-Dec,3690,3539,151,4.1
McCulloch County,2017-Jan,3542,3392,150,4.2
McCulloch County,2017-Feb,3603,3454,149,4.1
McCulloch County,2017-Mar,3731,3597,134,3.6
McCulloch County,2017-Apr,3642,3528,114,3.1
McCulloch County,2017-May,3666,3532,134,3.7
McCulloch County,2017-Jun,3679,3541,138,3.8
McCulloch County,2017-Jul,3615,3476,139,3.8
McCulloch County,2017-Aug,3661,3527,134,3.7
McCulloch County,2017-Sep,3656,3530,126,3.4
McCulloch County,2017-Oct,3705,3594,111,3
McCulloch County,2017-Nov,3676,3556,120,3.3
McCulloch County,2017-Dec,3707,3595,112,3
McCulloch County,2018-Jan,3668,3544,124,3.4
McCulloch County,2018-Feb,3664,3544,120,3.3
McCulloch County,2018-Mar,3749,3631,118,3.1
McCulloch County,2018-Apr,3696,3589,107,2.9
McCulloch County,2018-May,3708,3602,106,2.9
McCulloch County,2018-Jun,3728,3600,128,3.4
McCulloch County,2018-Jul,3756,3628,128,3.4
McCulloch County,2018-Aug,3780,3649,131,3.5
McCulloch County,2018-Sep,3712,3578,134,3.6
McCulloch County,2018-Oct,3718,3589,129,3.5
McCulloch County,2018-Nov,3700,3572,128,3.5
McCulloch County,2018-Dec,3675,3549,126,3.4
McCulloch County,2019-Jan,3647,3506,141,3.9
McCulloch County,2019-Feb,3605,3446,159,4.4
McCulloch County,2019-Mar,3670,3510,160,4.4
McCulloch County,2019-Apr,3504,3309,195,5.6
McCulloch County,2019-May,3419,3205,214,6.3
McCulloch County,2019-Jun,3389,3177,212,6.3
McCulloch County,2019-Jul,3366,3161,205,6.1
McCulloch County,2019-Aug,3386,3179,207,6.1
McCulloch County,2019-Sep,3330,3143,187,5.6
McCulloch County,2019-Oct,3316,3151,165,5
McCulloch County,2019-Nov,3286,3132,154,4.7
McCulloch County,2019-Dec,3309,3168,141,4.3
McCulloch County,2020-Jan,3265,3116,149,4.6
McCulloch County,2020-Feb,3242,3099,143,4.4
McCulloch County,2020-Mar,3243,3034,209,6.4
McCulloch County,2020-Apr,2986,2723,263,8.8
McCulloch County,2020-May,3100,2807,293,9.5
McCulloch County,2020-Jun,3141,2849,292,9.3
McCulloch County,2020-Jul,3214,2905,309,9.6
McCulloch County,2020-Aug,3241,2998,243,7.5
McCulloch County,2020-Sep,3218,2968,250,7.8
McCulloch County,2020-Oct,3232,2998,234,7.2
McCulloch County,2020-Nov,3158,2924,234,7.4
McCulloch County,2020-Dec,3193,2931,262,8.2
McCulloch County,2021-Jan,3167,2911,256,8.1
McCulloch County,2021-Feb,3207,2960,247,7.7
McCulloch County,2021-Mar,3259,3026,233,7.1
McCulloch County,2021-Apr,3151,2947,204,6.5
McCulloch County,2021-May,3113,2918,195,6.3
McCulloch County,2021-Jun,3138,2917,221,7
McCulloch County,2021-Jul,3160,2958,202,6.4
McCulloch County,2021-Aug,3192,2995,197,6.2
McCulloch County,2021-Sep,3174,2988,186,5.9
McCulloch County,2021-Oct,3138,2959,179,5.7
McCulloch County,2021-Nov,3093,2924,169,5.5
McCulloch County,2021-Dec,3085,2927,158,5.1
McCulloch County,2022-Jan,3043,2872,171,5.6
McCulloch County,2022-Feb,3109,2941,168,5.4
McCulloch County,2022-Mar,3183,3042,141,4.4
McCulloch County,2022-Apr,3074,2947,127,4.1
McCulloch County,2022-May,3044,2912,132,4.3
McCulloch County,2022-Jun,3072,2921,151,4.9
McCulloch County,2022-Jul,3144(P),3000(P),144(P),4.6(P)
McLennan County,2012-Jan,111757,103777,7980,7.1
McLennan County,2012-Feb,112045,104238,7807,7
McLennan County,2012-Mar,111957,104624,7333,6.5
McLennan County,2012-Apr,111519,104681,6838,6.1
McLennan County,2012-May,111733,104440,7293,6.5
McLennan County,2012-Jun,112723,104437,8286,7.4
McLennan County,2012-Jul,113148,104811,8337,7.4
McLennan County,2012-Aug,112555,104918,7637,6.8
McLennan County,2012-Sep,112387,105407,6980,6.2
McLennan County,2012-Oct,111771,104954,6817,6.1
McLennan County,2012-Nov,111900,105189,6711,6
McLennan County,2012-Dec,111683,104923,6760,6.1
McLennan County,2013-Jan,111223,103709,7514,6.8
McLennan County,2013-Feb,111365,104269,7096,6.4
McLennan County,2013-Mar,111258,104303,6955,6.3
McLennan County,2013-Apr,112546,105985,6561,5.8
McLennan County,2013-May,112624,105594,7030,6.2
McLennan County,2013-Jun,113273,105314,7959,7
McLennan County,2013-Jul,113223,105470,7753,6.8
McLennan County,2013-Aug,112715,105535,7180,6.4
McLennan County,2013-Sep,112697,105744,6953,6.2
McLennan County,2013-Oct,110707,104109,6598,6
McLennan County,2013-Nov,111234,104962,6272,5.6
McLennan County,2013-Dec,110771,104932,5839,5.3
McLennan County,2014-Jan,111358,105294,6064,5.4
McLennan County,2014-Feb,111917,105670,6247,5.6
McLennan County,2014-Mar,112024,106017,6007,5.4
McLennan County,2014-Apr,113215,108077,5138,4.5
McLennan County,2014-May,113380,107550,5830,5.1
McLennan County,2014-Jun,113381,106890,6491,5.7
McLennan County,2014-Jul,113736,106965,6771,6
McLennan County,2014-Aug,112800,106476,6324,5.6
McLennan County,2014-Sep,112868,107166,5702,5.1
McLennan County,2014-Oct,112728,107545,5183,4.6
McLennan County,2014-Nov,113117,108066,5051,4.5
McLennan County,2014-Dec,112490,107969,4521,4
McLennan County,2015-Jan,111938,106828,5110,4.6
McLennan County,2015-Feb,111479,106777,4702,4.2
McLennan County,2015-Mar,111012,106458,4554,4.1
McLennan County,2015-Apr,111396,107300,4096,3.7
McLennan County,2015-May,111833,107326,4507,4
McLennan County,2015-Jun,112381,107287,5094,4.5
McLennan County,2015-Jul,113372,108157,5215,4.6
McLennan County,2015-Aug,113312,108599,4713,4.2
McLennan County,2015-Sep,112964,108373,4591,4.1
McLennan County,2015-Oct,113494,109064,4430,3.9
McLennan County,2015-Nov,114205,109818,4387,3.8
McLennan County,2015-Dec,114005,109948,4057,3.6
McLennan County,2016-Jan,113920,109531,4389,3.9
McLennan County,2016-Feb,115057,110697,4360,3.8
McLennan County,2016-Mar,115116,110662,4454,3.9
McLennan County,2016-Apr,115168,111087,4081,3.5
McLennan County,2016-May,115003,110822,4181,3.6
McLennan County,2016-Jun,115912,110815,5097,4.4
McLennan County,2016-Jul,116850,111586,5264,4.5
McLennan County,2016-Aug,117213,112260,4953,4.2
McLennan County,2016-Sep,117274,112368,4906,4.2
McLennan County,2016-Oct,117159,112530,4629,4
McLennan County,2016-Nov,117662,113192,4470,3.8
McLennan County,2016-Dec,117457,113020,4437,3.8
McLennan County,2017-Jan,116871,112062,4809,4.1
McLennan County,2017-Feb,117658,112738,4920,4.2
McLennan County,2017-Mar,117393,112826,4567,3.9
McLennan County,2017-Apr,117120,113041,4079,3.5
McLennan County,2017-May,116784,112515,4269,3.7
McLennan County,2017-Jun,117555,112223,5332,4.5
McLennan County,2017-Jul,117988,112712,5276,4.5
McLennan County,2017-Aug,117970,112885,5085,4.3
McLennan County,2017-Sep,117869,113409,4460,3.8
McLennan County,2017-Oct,116057,112020,4037,3.5
McLennan County,2017-Nov,116659,112453,4206,3.6
McLennan County,2017-Dec,116336,112377,3959,3.4
McLennan County,2018-Jan,115477,111008,4469,3.9
McLennan County,2018-Feb,116681,112249,4432,3.8
McLennan County,2018-Mar,116474,112177,4297,3.7
McLennan County,2018-Apr,116840,112886,3954,3.4
McLennan County,2018-May,116541,112578,3963,3.4
McLennan County,2018-Jun,117828,112909,4919,4.2
McLennan County,2018-Jul,118050,113337,4713,4
McLennan County,2018-Aug,117086,112771,4315,3.7
McLennan County,2018-Sep,117025,112960,4065,3.5
McLennan County,2018-Oct,117326,113463,3863,3.3
McLennan County,2018-Nov,117979,114100,3879,3.3
McLennan County,2018-Dec,117546,113633,3913,3.3
McLennan County,2019-Jan,117346,112856,4490,3.8
McLennan County,2019-Feb,117761,113602,4159,3.5
McLennan County,2019-Mar,117482,113511,3971,3.4
McLennan County,2019-Apr,116992,113705,3287,2.8
McLennan County,2019-May,116773,113371,3402,2.9
McLennan County,2019-Jun,118046,113650,4396,3.7
McLennan County,2019-Jul,118963,114462,4501,3.8
McLennan County,2019-Aug,118431,114198,4233,3.6
McLennan County,2019-Sep,118239,114397,3842,3.2
McLennan County,2019-Oct,117831,114132,3699,3.1
McLennan County,2019-Nov,117844,114207,3637,3.1
McLennan County,2019-Dec,117710,114260,3450,2.9
McLennan County,2020-Jan,118056,114110,3946,3.3
McLennan County,2020-Feb,118793,115089,3704,3.1
McLennan County,2020-Mar,117088,111155,5933,5.1
McLennan County,2020-Apr,111018,100214,10804,9.7
McLennan County,2020-May,115765,105228,10537,9.1
McLennan County,2020-Jun,118164,108328,9836,8.3
McLennan County,2020-Jul,119087,109789,9298,7.8
McLennan County,2020-Aug,120545,113161,7384,6.1
McLennan County,2020-Sep,120028,112943,7085,5.9
McLennan County,2020-Oct,120397,114027,6370,5.3
McLennan County,2020-Nov,120843,114105,6738,5.6
McLennan County,2020-Dec,120910,114093,6817,5.6
McLennan County,2021-Jan,120486,113291,7195,6
McLennan County,2021-Feb,120950,113982,6968,5.8
McLennan County,2021-Mar,120738,114005,6733,5.6
McLennan County,2021-Apr,121201,115274,5927,4.9
McLennan County,2021-May,121065,115133,5932,4.9
McLennan County,2021-Jun,121332,114500,6832,5.6
McLennan County,2021-Jul,122696,116465,6231,5.1
McLennan County,2021-Aug,123099,117238,5861,4.8
McLennan County,2021-Sep,123141,117763,5378,4.4
McLennan County,2021-Oct,123838,118700,5138,4.1
McLennan County,2021-Nov,124002,119207,4795,3.9
McLennan County,2021-Dec,123759,119407,4352,3.5
McLennan County,2022-Jan,124071,118937,5134,4.1
McLennan County,2022-Feb,125449,120375,5074,4
McLennan County,2022-Mar,125653,121425,4228,3.4
McLennan County,2022-Apr,124531,120623,3908,3.1
McLennan County,2022-May,124539,120369,4170,3.3
McLennan County,2022-Jun,125738,120768,4970,4
McLennan County,2022-Jul,125861(P),120985(P),4876(P),3.9(P)
McMullen County,2012-Jan,716,698,18,2.5
McMullen County,2012-Feb,711,692,19,2.7
McMullen County,2012-Mar,720,703,17,2.4
McMullen County,2012-Apr,741,725,16,2.2
McMullen County,2012-May,729,712,17,2.3
McMullen County,2012-Jun,749,729,20,2.7
McMullen County,2012-Jul,759,739,20,2.6
McMullen County,2012-Aug,752,734,18,2.4
McMullen County,2012-Sep,748,733,15,2
McMullen County,2012-Oct,754,738,16,2.1
McMullen County,2012-Nov,759,743,16,2.1
McMullen County,2012-Dec,773,757,16,2.1
McMullen County,2013-Jan,796,773,23,2.9
McMullen County,2013-Feb,811,789,22,2.7
McMullen County,2013-Mar,841,821,20,2.4
McMullen County,2013-Apr,886,865,21,2.4
McMullen County,2013-May,902,878,24,2.7
McMullen County,2013-Jun,907,883,24,2.6
McMullen County,2013-Jul,872,849,23,2.6
McMullen County,2013-Aug,862,834,28,3.2
McMullen County,2013-Sep,890,862,28,3.1
McMullen County,2013-Oct,934,905,29,3.1
McMullen County,2013-Nov,922,901,21,2.3
McMullen County,2013-Dec,947,928,19,2
McMullen County,2014-Jan,997,972,25,2.5
McMullen County,2014-Feb,1029,1007,22,2.1
McMullen County,2014-Mar,1082,1062,20,1.8
McMullen County,2014-Apr,1102,1085,17,1.5
McMullen County,2014-May,1101,1084,17,1.5
McMullen County,2014-Jun,1077,1058,19,1.8
McMullen County,2014-Jul,1110,1090,20,1.8
McMullen County,2014-Aug,1070,1049,21,2
McMullen County,2014-Sep,1046,1023,23,2.2
McMullen County,2014-Oct,1043,1021,22,2.1
McMullen County,2014-Nov,1014,991,23,2.3
McMullen County,2014-Dec,1020,998,22,2.2
McMullen County,2015-Jan,997,973,24,2.4
McMullen County,2015-Feb,989,967,22,2.2
McMullen County,2015-Mar,988,966,22,2.2
McMullen County,2015-Apr,1005,987,18,1.8
McMullen County,2015-May,992,975,17,1.7
McMullen County,2015-Jun,966,947,19,2
McMullen County,2015-Jul,986,965,21,2.1
McMullen County,2015-Aug,949,926,23,2.4
McMullen County,2015-Sep,943,920,23,2.4
McMullen County,2015-Oct,953,934,19,2
McMullen County,2015-Nov,933,917,16,1.7
McMullen County,2015-Dec,926,909,17,1.8
McMullen County,2016-Jan,947,931,16,1.7
McMullen County,2016-Feb,954,938,16,1.7
McMullen County,2016-Mar,925,903,22,2.4
McMullen County,2016-Apr,883,862,21,2.4
McMullen County,2016-May,894,875,19,2.1
McMullen County,2016-Jun,885,865,20,2.3
McMullen County,2016-Jul,863,840,23,2.7
McMullen County,2016-Aug,849,830,19,2.2
McMullen County,2016-Sep,813,795,18,2.2
McMullen County,2016-Oct,808,794,14,1.7
McMullen County,2016-Nov,759,745,14,1.8
McMullen County,2016-Dec,762,746,16,2.1
McMullen County,2017-Jan,746,726,20,2.7
McMullen County,2017-Feb,748,729,19,2.5
McMullen County,2017-Mar,759,746,13,1.7
McMullen County,2017-Apr,743,731,12,1.6
McMullen County,2017-May,755,743,12,1.6
McMullen County,2017-Jun,745,730,15,2
McMullen County,2017-Jul,703,689,14,2
McMullen County,2017-Aug,725,712,13,1.8
McMullen County,2017-Sep,697,686,11,1.6
McMullen County,2017-Oct,746,734,12,1.6
McMullen County,2017-Nov,776,763,13,1.7
McMullen County,2017-Dec,767,755,12,1.6
McMullen County,2018-Jan,751,738,13,1.7
McMullen County,2018-Feb,733,720,13,1.8
McMullen County,2018-Mar,736,724,12,1.6
McMullen County,2018-Apr,716,703,13,1.8
McMullen County,2018-May,696,684,12,1.7
McMullen County,2018-Jun,692,679,13,1.9
McMullen County,2018-Jul,690,676,14,2
McMullen County,2018-Aug,701,687,14,2
McMullen County,2018-Sep,700,685,15,2.1
McMullen County,2018-Oct,704,688,16,2.3
McMullen County,2018-Nov,701,689,12,1.7
McMullen County,2018-Dec,691,680,11,1.6
McMullen County,2019-Jan,712,697,15,2.1
McMullen County,2019-Feb,721,708,13,1.8
McMullen County,2019-Mar,763,749,14,1.8
McMullen County,2019-Apr,758,748,10,1.3
McMullen County,2019-May,755,746,9,1.2
McMullen County,2019-Jun,774,763,11,1.4
McMullen County,2019-Jul,841,827,14,1.7
McMullen County,2019-Aug,882,866,16,1.8
McMullen County,2019-Sep,877,863,14,1.6
McMullen County,2019-Oct,889,875,14,1.6
McMullen County,2019-Nov,854,840,14,1.6
McMullen County,2019-Dec,840,827,13,1.5
McMullen County,2020-Jan,790,777,13,1.6
McMullen County,2020-Feb,790,778,12,1.5
McMullen County,2020-Mar,777,760,17,2.2
McMullen County,2020-Apr,709,693,16,2.3
McMullen County,2020-May,715,692,23,3.2
McMullen County,2020-Jun,716,690,26,3.6
McMullen County,2020-Jul,673,646,27,4
McMullen County,2020-Aug,683,658,25,3.7
McMullen County,2020-Sep,667,644,23,3.4
McMullen County,2020-Oct,688,670,18,2.6
McMullen County,2020-Nov,671,652,19,2.8
McMullen County,2020-Dec,666,649,17,2.6
McMullen County,2021-Jan,693,675,18,2.6
McMullen County,2021-Feb,707,687,20,2.8
McMullen County,2021-Mar,712,693,19,2.7
McMullen County,2021-Apr,709,691,18,2.5
McMullen County,2021-May,703,684,19,2.7
McMullen County,2021-Jun,702,683,19,2.7
McMullen County,2021-Jul,703,687,16,2.3
McMullen County,2021-Aug,802,784,18,2.2
McMullen County,2021-Sep,774,759,15,1.9
McMullen County,2021-Oct,780,766,14,1.8
McMullen County,2021-Nov,763,748,15,2
McMullen County,2021-Dec,758,743,15,2
McMullen County,2022-Jan,763,747,16,2.1
McMullen County,2022-Feb,786,770,16,2
McMullen County,2022-Mar,808,792,16,2
McMullen County,2022-Apr,790,776,14,1.8
McMullen County,2022-May,778,764,14,1.8
McMullen County,2022-Jun,779,762,17,2.2
McMullen County,2022-Jul,777(P),762(P),15(P),1.9(P)
Madison County,2012-Jan,4521,4172,349,7.7
Madison County,2012-Feb,4537,4203,334,7.4
Madison County,2012-Mar,4581,4269,312,6.8
Madison County,2012-Apr,4606,4316,290,6.3
Madison County,2012-May,4621,4312,309,6.7
Madison County,2012-Jun,4737,4364,373,7.9
Madison County,2012-Jul,4687,4322,365,7.8
Madison County,2012-Aug,4682,4339,343,7.3
Madison County,2012-Sep,4724,4404,320,6.8
Madison County,2012-Oct,4691,4385,306,6.5
Madison County,2012-Nov,4674,4372,302,6.5
Madison County,2012-Dec,4640,4335,305,6.6
Madison County,2013-Jan,4714,4369,345,7.3
Madison County,2013-Feb,4742,4419,323,6.8
Madison County,2013-Mar,4751,4435,316,6.7
Madison County,2013-Apr,4811,4501,310,6.4
Madison County,2013-May,4880,4564,316,6.5
Madison County,2013-Jun,4922,4568,354,7.2
Madison County,2013-Jul,4865,4521,344,7.1
Madison County,2013-Aug,4795,4482,313,6.5
Madison County,2013-Sep,4858,4557,301,6.2
Madison County,2013-Oct,4834,4537,297,6.1
Madison County,2013-Nov,4782,4492,290,6.1
Madison County,2013-Dec,4777,4517,260,5.4
Madison County,2014-Jan,4886,4624,262,5.4
Madison County,2014-Feb,5029,4758,271,5.4
Madison County,2014-Mar,5085,4826,259,5.1
Madison County,2014-Apr,4961,4732,229,4.6
Madison County,2014-May,5063,4819,244,4.8
Madison County,2014-Jun,5122,4848,274,5.3
Madison County,2014-Jul,5097,4809,288,5.7
Madison County,2014-Aug,5046,4784,262,5.2
Madison County,2014-Sep,5072,4837,235,4.6
Madison County,2014-Oct,4996,4775,221,4.4
Madison County,2014-Nov,4963,4739,224,4.5
Madison County,2014-Dec,4900,4691,209,4.3
Madison County,2015-Jan,5068,4837,231,4.6
Madison County,2015-Feb,5111,4885,226,4.4
Madison County,2015-Mar,5189,4971,218,4.2
Madison County,2015-Apr,5091,4891,200,3.9
Madison County,2015-May,5184,4963,221,4.3
Madison County,2015-Jun,5169,4919,250,4.8
Madison County,2015-Jul,5158,4919,239,4.6
Madison County,2015-Aug,5086,4874,212,4.2
Madison County,2015-Sep,5218,5006,212,4.1
Madison County,2015-Oct,5126,4915,211,4.1
Madison County,2015-Nov,5037,4809,228,4.5
Madison County,2015-Dec,4989,4774,215,4.3
Madison County,2016-Jan,4824,4592,232,4.8
Madison County,2016-Feb,4867,4637,230,4.7
Madison County,2016-Mar,4874,4634,240,4.9
Madison County,2016-Apr,4798,4575,223,4.6
Madison County,2016-May,4851,4619,232,4.8
Madison County,2016-Jun,4791,4509,282,5.9
Madison County,2016-Jul,4710,4430,280,5.9
Madison County,2016-Aug,4696,4442,254,5.4
Madison County,2016-Sep,4688,4440,248,5.3
Madison County,2016-Oct,4719,4494,225,4.8
Madison County,2016-Nov,4731,4497,234,4.9
Madison County,2016-Dec,4697,4458,239,5.1
Madison County,2017-Jan,4556,4293,263,5.8
Madison County,2017-Feb,4655,4416,239,5.1
Madison County,2017-Mar,4793,4553,240,5
Madison County,2017-Apr,4764,4544,220,4.6
Madison County,2017-May,4720,4511,209,4.4
Madison County,2017-Jun,4630,4386,244,5.3
Madison County,2017-Jul,4574,4335,239,5.2
Madison County,2017-Aug,4659,4416,243,5.2
Madison County,2017-Sep,4656,4452,204,4.4
Madison County,2017-Oct,4613,4433,180,3.9
Madison County,2017-Nov,4582,4395,187,4.1
Madison County,2017-Dec,4615,4427,188,4.1
Madison County,2018-Jan,4512,4302,210,4.7
Madison County,2018-Feb,4566,4357,209,4.6
Madison County,2018-Mar,4632,4418,214,4.6
Madison County,2018-Apr,4528,4341,187,4.1
Madison County,2018-May,4569,4383,186,4.1
Madison County,2018-Jun,4541,4310,231,5.1
Madison County,2018-Jul,4481,4251,230,5.1
Madison County,2018-Aug,4469,4263,206,4.6
Madison County,2018-Sep,4464,4272,192,4.3
Madison County,2018-Oct,4495,4310,185,4.1
Madison County,2018-Nov,4521,4338,183,4
Madison County,2018-Dec,4487,4304,183,4.1
Madison County,2019-Jan,4435,4234,201,4.5
Madison County,2019-Feb,4503,4318,185,4.1
Madison County,2019-Mar,4548,4373,175,3.8
Madison County,2019-Apr,4489,4337,152,3.4
Madison County,2019-May,4467,4302,165,3.7
Madison County,2019-Jun,4476,4251,225,5
Madison County,2019-Jul,4411,4181,230,5.2
Madison County,2019-Aug,4518,4297,221,4.9
Madison County,2019-Sep,4480,4285,195,4.4
Madison County,2019-Oct,4512,4336,176,3.9
Madison County,2019-Nov,4466,4294,172,3.9
Madison County,2019-Dec,4463,4300,163,3.7
Madison County,2020-Jan,4386,4205,181,4.1
Madison County,2020-Feb,4436,4271,165,3.7
Madison County,2020-Mar,4408,4149,259,5.9
Madison County,2020-Apr,4153,3819,334,8
Madison County,2020-May,4317,3908,409,9.5
Madison County,2020-Jun,4377,3956,421,9.6
Madison County,2020-Jul,4410,4016,394,8.9
Madison County,2020-Aug,4478,4139,339,7.6
Madison County,2020-Sep,4466,4129,337,7.5
Madison County,2020-Oct,4625,4321,304,6.6
Madison County,2020-Nov,4615,4285,330,7.2
Madison County,2020-Dec,4580,4237,343,7.5
Madison County,2021-Jan,4610,4247,363,7.9
Madison County,2021-Feb,4667,4320,347,7.4
Madison County,2021-Mar,4749,4417,332,7
Madison County,2021-Apr,4690,4399,291,6.2
Madison County,2021-May,4636,4355,281,6.1
Madison County,2021-Jun,4698,4357,341,7.3
Madison County,2021-Jul,4682,4373,309,6.6
Madison County,2021-Aug,4693,4409,284,6.1
Madison County,2021-Sep,4695,4436,259,5.5
Madison County,2021-Oct,4753,4505,248,5.2
Madison County,2021-Nov,4731,4496,235,5
Madison County,2021-Dec,4690,4466,224,4.8
Madison County,2022-Jan,4692,4439,253,5.4
Madison County,2022-Feb,4820,4575,245,5.1
Madison County,2022-Mar,4905,4707,198,4
Madison County,2022-Apr,4794,4610,184,3.8
Madison County,2022-May,4764,4558,206,4.3
Madison County,2022-Jun,4776,4535,241,5
Madison County,2022-Jul,4835(P),4596(P),239(P),4.9(P)
Marion County,2012-Jan,4314,3868,446,10.3
Marion County,2012-Feb,4304,3891,413,9.6
Marion County,2012-Mar,4311,3910,401,9.3
Marion County,2012-Apr,4326,3952,374,8.6
Marion County,2012-May,4343,3952,391,9
Marion County,2012-Jun,4345,3936,409,9.4
Marion County,2012-Jul,4339,3936,403,9.3
Marion County,2012-Aug,4330,3944,386,8.9
Marion County,2012-Sep,4332,3953,379,8.7
Marion County,2012-Oct,4375,4012,363,8.3
Marion County,2012-Nov,4367,4002,365,8.4
Marion County,2012-Dec,4398,4006,392,8.9
Marion County,2013-Jan,4427,4006,421,9.5
Marion County,2013-Feb,4422,4028,394,8.9
Marion County,2013-Mar,4430,4058,372,8.4
Marion County,2013-Apr,4500,4150,350,7.8
Marion County,2013-May,4586,4225,361,7.9
Marion County,2013-Jun,4581,4192,389,8.5
Marion County,2013-Jul,4579,4214,365,8
Marion County,2013-Aug,4574,4208,366,8
Marion County,2013-Sep,4555,4188,367,8.1
Marion County,2013-Oct,4596,4234,362,7.9
Marion County,2013-Nov,4593,4250,343,7.5
Marion County,2013-Dec,4544,4215,329,7.2
Marion County,2014-Jan,4490,4146,344,7.7
Marion County,2014-Feb,4473,4143,330,7.4
Marion County,2014-Mar,4488,4177,311,6.9
Marion County,2014-Apr,4484,4209,275,6.1
Marion County,2014-May,4487,4198,289,6.4
Marion County,2014-Jun,4475,4166,309,6.9
Marion County,2014-Jul,4514,4206,308,6.8
Marion County,2014-Aug,4498,4201,297,6.6
Marion County,2014-Sep,4446,4176,270,6.1
Marion County,2014-Oct,4469,4211,258,5.8
Marion County,2014-Nov,4445,4178,267,6
Marion County,2014-Dec,4433,4178,255,5.8
Marion County,2015-Jan,4476,4190,286,6.4
Marion County,2015-Feb,4416,4138,278,6.3
Marion County,2015-Mar,4389,4116,273,6.2
Marion County,2015-Apr,4423,4145,278,6.3
Marion County,2015-May,4405,4122,283,6.4
Marion County,2015-Jun,4440,4127,313,7
Marion County,2015-Jul,4486,4157,329,7.3
Marion County,2015-Aug,4425,4120,305,6.9
Marion County,2015-Sep,4383,4089,294,6.7
Marion County,2015-Oct,4385,4113,272,6.2
Marion County,2015-Nov,4401,4118,283,6.4
Marion County,2015-Dec,4368,4096,272,6.2
Marion County,2016-Jan,4372,4087,285,6.5
Marion County,2016-Feb,4365,4089,276,6.3
Marion County,2016-Mar,4408,4120,288,6.5
Marion County,2016-Apr,4350,4046,304,7
Marion County,2016-May,4347,4051,296,6.8
Marion County,2016-Jun,4360,4016,344,7.9
Marion County,2016-Jul,4365,4031,334,7.7
Marion County,2016-Aug,4361,4027,334,7.7
Marion County,2016-Sep,4308,3976,332,7.7
Marion County,2016-Oct,4311,4019,292,6.8
Marion County,2016-Nov,4315,4024,291,6.7
Marion County,2016-Dec,4259,3975,284,6.7
Marion County,2017-Jan,4271,3968,303,7.1
Marion County,2017-Feb,4274,3976,298,7
Marion County,2017-Mar,4215,3945,270,6.4
Marion County,2017-Apr,4252,3997,255,6
Marion County,2017-May,4248,4004,244,5.7
Marion County,2017-Jun,4265,4012,253,5.9
Marion County,2017-Jul,4348,4102,246,5.7
Marion County,2017-Aug,4390,4141,249,5.7
Marion County,2017-Sep,4398,4176,222,5
Marion County,2017-Oct,4354,4150,204,4.7
Marion County,2017-Nov,4324,4115,209,4.8
Marion County,2017-Dec,4319,4115,204,4.7
Marion County,2018-Jan,4247,4030,217,5.1
Marion County,2018-Feb,4281,4066,215,5
Marion County,2018-Mar,4256,4052,204,4.8
Marion County,2018-Apr,4247,4064,183,4.3
Marion County,2018-May,4217,4046,171,4.1
Marion County,2018-Jun,4233,4035,198,4.7
Marion County,2018-Jul,4222,4025,197,4.7
Marion County,2018-Aug,4172,3974,198,4.7
Marion County,2018-Sep,4157,3977,180,4.3
Marion County,2018-Oct,4160,3988,172,4.1
Marion County,2018-Nov,4182,4010,172,4.1
Marion County,2018-Dec,4172,3982,190,4.6
Marion County,2019-Jan,4186,3974,212,5.1
Marion County,2019-Feb,4163,3970,193,4.6
Marion County,2019-Mar,4195,4010,185,4.4
Marion County,2019-Apr,4187,4035,152,3.6
Marion County,2019-May,4146,4000,146,3.5
Marion County,2019-Jun,4161,3988,173,4.2
Marion County,2019-Jul,4198,4020,178,4.2
Marion County,2019-Aug,4189,4011,178,4.2
Marion County,2019-Sep,4169,4004,165,4
Marion County,2019-Oct,4236,4068,168,4
Marion County,2019-Nov,4214,4036,178,4.2
Marion County,2019-Dec,4171,3989,182,4.4
Marion County,2020-Jan,4205,3995,210,5
Marion County,2020-Feb,4215,4031,184,4.4
Marion County,2020-Mar,4208,3915,293,7
Marion County,2020-Apr,4005,3553,452,11.3
Marion County,2020-May,4169,3698,471,11.3
Marion County,2020-Jun,4236,3774,462,10.9
Marion County,2020-Jul,4244,3813,431,10.2
Marion County,2020-Aug,4228,3869,359,8.5
Marion County,2020-Sep,4246,3896,350,8.2
Marion County,2020-Oct,4232,3914,318,7.5
Marion County,2020-Nov,4246,3912,334,7.9
Marion County,2020-Dec,4218,3892,326,7.7
Marion County,2021-Jan,4230,3882,348,8.2
Marion County,2021-Feb,4243,3890,353,8.3
Marion County,2021-Mar,4249,3928,321,7.6
Marion County,2021-Apr,4263,3957,306,7.2
Marion County,2021-May,4223,3939,284,6.7
Marion County,2021-Jun,4274,3946,328,7.7
Marion County,2021-Jul,4257,3962,295,6.9
Marion County,2021-Aug,4282,3995,287,6.7
Marion County,2021-Sep,4278,4012,266,6.2
Marion County,2021-Oct,4271,4021,250,5.9
Marion County,2021-Nov,4260,4022,238,5.6
Marion County,2021-Dec,4226,3999,227,5.4
Marion County,2022-Jan,4258,3996,262,6.2
Marion County,2022-Feb,4263,3999,264,6.2
Marion County,2022-Mar,4282,4062,220,5.1
Marion County,2022-Apr,4208,4003,205,4.9
Marion County,2022-May,4229,4020,209,4.9
Marion County,2022-Jun,4263,4025,238,5.6
Marion County,2022-Jul,4276(P),4028(P),248(P),5.8(P)
Martin County,2012-Jan,2323,2207,116,5
Martin County,2012-Feb,2328,2213,115,4.9
Martin County,2012-Mar,2342,2240,102,4.4
Martin County,2012-Apr,2385,2288,97,4.1
Martin County,2012-May,2405,2299,106,4.4
Martin County,2012-Jun,2444,2323,121,5
Martin County,2012-Jul,2478,2351,127,5.1
Martin County,2012-Aug,2460,2346,114,4.6
Martin County,2012-Sep,2460,2356,104,4.2
Martin County,2012-Oct,2444,2343,101,4.1
Martin County,2012-Nov,2434,2340,94,3.9
Martin County,2012-Dec,2416,2316,100,4.1
Martin County,2013-Jan,2469,2353,116,4.7
Martin County,2013-Feb,2473,2368,105,4.2
Martin County,2013-Mar,2465,2359,106,4.3
Martin County,2013-Apr,2536,2433,103,4.1
Martin County,2013-May,2557,2448,109,4.3
Martin County,2013-Jun,2596,2470,126,4.9
Martin County,2013-Jul,2616,2499,117,4.5
Martin County,2013-Aug,2570,2454,116,4.5
Martin County,2013-Sep,2589,2475,114,4.4
Martin County,2013-Oct,2575,2466,109,4.2
Martin County,2013-Nov,2549,2450,99,3.9
Martin County,2013-Dec,2562,2471,91,3.6
Martin County,2014-Jan,2574,2477,97,3.8
Martin County,2014-Feb,2623,2521,102,3.9
Martin County,2014-Mar,2636,2540,96,3.6
Martin County,2014-Apr,2671,2590,81,3
Martin County,2014-May,2692,2599,93,3.5
Martin County,2014-Jun,2712,2611,101,3.7
Martin County,2014-Jul,2745,2638,107,3.9
Martin County,2014-Aug,2704,2605,99,3.7
Martin County,2014-Sep,2724,2633,91,3.3
Martin County,2014-Oct,2726,2644,82,3
Martin County,2014-Nov,2706,2623,83,3.1
Martin County,2014-Dec,2677,2606,71,2.7
Martin County,2015-Jan,2657,2573,84,3.2
Martin County,2015-Feb,2647,2566,81,3.1
Martin County,2015-Mar,2643,2564,79,3
Martin County,2015-Apr,2624,2545,79,3
Martin County,2015-May,2633,2540,93,3.5
Martin County,2015-Jun,2623,2523,100,3.8
Martin County,2015-Jul,2591,2486,105,4.1
Martin County,2015-Aug,2536,2439,97,3.8
Martin County,2015-Sep,2537,2439,98,3.9
Martin County,2015-Oct,2533,2432,101,4
Martin County,2015-Nov,2500,2404,96,3.8
Martin County,2015-Dec,2489,2406,83,3.3
Martin County,2016-Jan,2467,2373,94,3.8
Martin County,2016-Feb,2530,2426,104,4.1
Martin County,2016-Mar,2538,2433,105,4.1
Martin County,2016-Apr,2516,2416,100,4
Martin County,2016-May,2523,2421,102,4
Martin County,2016-Jun,2499,2374,125,5
Martin County,2016-Jul,2465,2337,128,5.2
Martin County,2016-Aug,2471,2348,123,5
Martin County,2016-Sep,2441,2330,111,4.5
Martin County,2016-Oct,2448,2338,110,4.5
Martin County,2016-Nov,2448,2346,102,4.2
Martin County,2016-Dec,2454,2345,109,4.4
Martin County,2017-Jan,2368,2260,108,4.6
Martin County,2017-Feb,2413,2307,106,4.4
Martin County,2017-Mar,2470,2374,96,3.9
Martin County,2017-Apr,2486,2404,82,3.3
Martin County,2017-May,2509,2425,84,3.3
Martin County,2017-Jun,2517,2428,89,3.5
Martin County,2017-Jul,2506,2419,87,3.5
Martin County,2017-Aug,2537,2456,81,3.2
Martin County,2017-Sep,2526,2455,71,2.8
Martin County,2017-Oct,2580,2516,64,2.5
Martin County,2017-Nov,2576,2509,67,2.6
Martin County,2017-Dec,2599,2538,61,2.3
Martin County,2018-Jan,2571,2506,65,2.5
Martin County,2018-Feb,2631,2564,67,2.5
Martin County,2018-Mar,2697,2633,64,2.4
Martin County,2018-Apr,2712,2654,58,2.1
Martin County,2018-May,2755,2693,62,2.3
Martin County,2018-Jun,2759,2681,78,2.8
Martin County,2018-Jul,2779,2710,69,2.5
Martin County,2018-Aug,2804,2729,75,2.7
Martin County,2018-Sep,2807,2729,78,2.8
Martin County,2018-Oct,2809,2738,71,2.5
Martin County,2018-Nov,2804,2735,69,2.5
Martin County,2018-Dec,2798,2725,73,2.6
Martin County,2019-Jan,2715,2631,84,3.1
Martin County,2019-Feb,2752,2680,72,2.6
Martin County,2019-Mar,2770,2704,66,2.4
Martin County,2019-Apr,2769,2717,52,1.9
Martin County,2019-May,2781,2726,55,2
Martin County,2019-Jun,2791,2715,76,2.7
Martin County,2019-Jul,2813,2736,77,2.7
Martin County,2019-Aug,2839,2760,79,2.8
Martin County,2019-Sep,2798,2723,75,2.7
Martin County,2019-Oct,2812,2731,81,2.9
Martin County,2019-Nov,2760,2679,81,2.9
Martin County,2019-Dec,2761,2683,78,2.8
Martin County,2020-Jan,2761,2680,81,2.9
Martin County,2020-Feb,2790,2713,77,2.8
Martin County,2020-Mar,2741,2629,112,4.1
Martin County,2020-Apr,2424,2265,159,6.6
Martin County,2020-May,2426,2217,209,8.6
Martin County,2020-Jun,2426,2212,214,8.8
Martin County,2020-Jul,2451,2232,219,8.9
Martin County,2020-Aug,2491,2316,175,7
Martin County,2020-Sep,2454,2295,159,6.5
Martin County,2020-Oct,2510,2362,148,5.9
Martin County,2020-Nov,2488,2332,156,6.3
Martin County,2020-Dec,2498,2349,149,6
Martin County,2021-Jan,2526,2371,155,6.1
Martin County,2021-Feb,2578,2427,151,5.9
Martin County,2021-Mar,2640,2491,149,5.6
Martin County,2021-Apr,2622,2493,129,4.9
Martin County,2021-May,2587,2466,121,4.7
Martin County,2021-Jun,2591,2450,141,5.4
Martin County,2021-Jul,2621,2494,127,4.8
Martin County,2021-Aug,2629,2516,113,4.3
Martin County,2021-Sep,2628,2520,108,4.1
Martin County,2021-Oct,2618,2512,106,4
Martin County,2021-Nov,2610,2505,105,4
Martin County,2021-Dec,2609,2512,97,3.7
Martin County,2022-Jan,2610,2499,111,4.3
Martin County,2022-Feb,2701,2593,108,4
Martin County,2022-Mar,2755,2667,88,3.2
Martin County,2022-Apr,2723,2643,80,2.9
Martin County,2022-May,2690,2605,85,3.2
Martin County,2022-Jun,2693,2594,99,3.7
Martin County,2022-Jul,2728(P),2638(P),90(P),3.3(P)
Mason County,2012-Jan,1944,1834,110,5.7
Mason County,2012-Feb,1916,1808,108,5.6
Mason County,2012-Mar,1936,1836,100,5.2
Mason County,2012-Apr,1973,1878,95,4.8
Mason County,2012-May,1964,1863,101,5.1
Mason County,2012-Jun,2018,1908,110,5.5
Mason County,2012-Jul,2009,1894,115,5.7
Mason County,2012-Aug,1935,1830,105,5.4
Mason County,2012-Sep,1953,1853,100,5.1
Mason County,2012-Oct,1985,1893,92,4.6
Mason County,2012-Nov,1991,1900,91,4.6
Mason County,2012-Dec,1958,1864,94,4.8
Mason County,2013-Jan,1939,1833,106,5.5
Mason County,2013-Feb,1935,1830,105,5.4
Mason County,2013-Mar,1900,1800,100,5.3
Mason County,2013-Apr,1970,1872,98,5
Mason County,2013-May,1999,1886,113,5.7
Mason County,2013-Jun,2025,1894,131,6.5
Mason County,2013-Jul,2033,1907,126,6.2
Mason County,2013-Aug,1972,1859,113,5.7
Mason County,2013-Sep,1944,1837,107,5.5
Mason County,2013-Oct,1928,1825,103,5.3
Mason County,2013-Nov,1893,1796,97,5.1
Mason County,2013-Dec,1922,1831,91,4.7
Mason County,2014-Jan,1888,1786,102,5.4
Mason County,2014-Feb,1914,1817,97,5.1
Mason County,2014-Mar,1919,1823,96,5
Mason County,2014-Apr,1910,1826,84,4.4
Mason County,2014-May,1921,1830,91,4.7
Mason County,2014-Jun,1955,1862,93,4.8
Mason County,2014-Jul,1918,1822,96,5
Mason County,2014-Aug,1872,1783,89,4.8
Mason County,2014-Sep,1866,1784,82,4.4
Mason County,2014-Oct,1884,1809,75,4
Mason County,2014-Nov,1858,1783,75,4
Mason County,2014-Dec,1821,1751,70,3.8
Mason County,2015-Jan,1787,1708,79,4.4
Mason County,2015-Feb,1796,1726,70,3.9
Mason County,2015-Mar,1818,1750,68,3.7
Mason County,2015-Apr,1822,1755,67,3.7
Mason County,2015-May,1861,1785,76,4.1
Mason County,2015-Jun,1860,1782,78,4.2
Mason County,2015-Jul,1856,1778,78,4.2
Mason County,2015-Aug,1773,1703,70,3.9
Mason County,2015-Sep,1792,1722,70,3.9
Mason County,2015-Oct,1772,1711,61,3.4
Mason County,2015-Nov,1760,1700,60,3.4
Mason County,2015-Dec,1755,1697,58,3.3
Mason County,2016-Jan,1700,1638,62,3.6
Mason County,2016-Feb,1781,1720,61,3.4
Mason County,2016-Mar,1818,1754,64,3.5
Mason County,2016-Apr,1835,1781,54,2.9
Mason County,2016-May,1878,1821,57,3
Mason County,2016-Jun,1870,1800,70,3.7
Mason County,2016-Jul,1794,1726,68,3.8
Mason County,2016-Aug,1816,1753,63,3.5
Mason County,2016-Sep,1750,1674,76,4.3
Mason County,2016-Oct,1741,1669,72,4.1
Mason County,2016-Nov,1752,1685,67,3.8
Mason County,2016-Dec,1760,1696,64,3.6
Mason County,2017-Jan,1727,1655,72,4.2
Mason County,2017-Feb,1827,1752,75,4.1
Mason County,2017-Mar,1881,1816,65,3.5
Mason County,2017-Apr,1871,1815,56,3
Mason County,2017-May,1870,1807,63,3.4
Mason County,2017-Jun,1870,1805,65,3.5
Mason County,2017-Jul,1775,1711,64,3.6
Mason County,2017-Aug,1781,1719,62,3.5
Mason County,2017-Sep,1719,1666,53,3.1
Mason County,2017-Oct,1775,1727,48,2.7
Mason County,2017-Nov,1746,1691,55,3.2
Mason County,2017-Dec,1757,1705,52,3
Mason County,2018-Jan,1756,1697,59,3.4
Mason County,2018-Feb,1762,1704,58,3.3
Mason County,2018-Mar,1805,1752,53,2.9
Mason County,2018-Apr,1792,1744,48,2.7
Mason County,2018-May,1800,1751,49,2.7
Mason County,2018-Jun,1805,1744,61,3.4
Mason County,2018-Jul,1772,1719,53,3
Mason County,2018-Aug,1788,1729,59,3.3
Mason County,2018-Sep,1703,1650,53,3.1
Mason County,2018-Oct,1702,1649,53,3.1
Mason County,2018-Nov,1707,1652,55,3.2
Mason County,2018-Dec,1691,1635,56,3.3
Mason County,2019-Jan,1692,1626,66,3.9
Mason County,2019-Feb,1749,1685,64,3.7
Mason County,2019-Mar,1765,1707,58,3.3
Mason County,2019-Apr,1738,1690,48,2.8
Mason County,2019-May,1754,1703,51,2.9
Mason County,2019-Jun,1787,1727,60,3.4
Mason County,2019-Jul,1744,1679,65,3.7
Mason County,2019-Aug,1782,1727,55,3.1
Mason County,2019-Sep,1720,1668,52,3
Mason County,2019-Oct,1741,1692,49,2.8
Mason County,2019-Nov,1708,1657,51,3
Mason County,2019-Dec,1703,1651,52,3.1
Mason County,2020-Jan,1733,1674,59,3.4
Mason County,2020-Feb,1749,1693,56,3.2
Mason County,2020-Mar,1753,1667,86,4.9
Mason County,2020-Apr,1618,1515,103,6.4
Mason County,2020-May,1664,1549,115,6.9
Mason County,2020-Jun,1692,1576,116,6.9
Mason County,2020-Jul,1707,1598,109,6.4
Mason County,2020-Aug,1763,1665,98,5.6
Mason County,2020-Sep,1695,1597,98,5.8
Mason County,2020-Oct,1734,1642,92,5.3
Mason County,2020-Nov,1731,1625,106,6.1
Mason County,2020-Dec,1729,1628,101,5.8
Mason County,2021-Jan,1724,1622,102,5.9
Mason County,2021-Feb,1757,1655,102,5.8
Mason County,2021-Mar,1839,1742,97,5.3
Mason County,2021-Apr,1778,1695,83,4.7
Mason County,2021-May,1780,1698,82,4.6
Mason County,2021-Jun,1810,1716,94,5.2
Mason County,2021-Jul,1826,1741,85,4.7
Mason County,2021-Aug,1815,1734,81,4.5
Mason County,2021-Sep,1801,1724,77,4.3
Mason County,2021-Oct,1796,1720,76,4.2
Mason County,2021-Nov,1781,1709,72,4
Mason County,2021-Dec,1762,1701,61,3.5
Mason County,2022-Jan,1746,1677,69,4
Mason County,2022-Feb,1824,1753,71,3.9
Mason County,2022-Mar,1918,1860,58,3
Mason County,2022-Apr,1839,1788,51,2.8
Mason County,2022-May,1839,1782,57,3.1
Mason County,2022-Jun,1859,1795,64,3.4
Mason County,2022-Jul,1911(P),1848(P),63(P),3.3(P)
Matagorda County,2012-Jan,16959,14994,1965,11.6
Matagorda County,2012-Feb,16902,15022,1880,11.1
Matagorda County,2012-Mar,16920,15202,1718,10.2
Matagorda County,2012-Apr,17024,15406,1618,9.5
Matagorda County,2012-May,17129,15449,1680,9.8
Matagorda County,2012-Jun,17293,15422,1871,10.8
Matagorda County,2012-Jul,17162,15328,1834,10.7
Matagorda County,2012-Aug,16959,15198,1761,10.4
Matagorda County,2012-Sep,17024,15408,1616,9.5
Matagorda County,2012-Oct,17425,15912,1513,8.7
Matagorda County,2012-Nov,17244,15752,1492,8.7
Matagorda County,2012-Dec,16701,15024,1677,10
Matagorda County,2013-Jan,16582,14814,1768,10.7
Matagorda County,2013-Feb,16563,14962,1601,9.7
Matagorda County,2013-Mar,16593,14975,1618,9.8
Matagorda County,2013-Apr,16663,15085,1578,9.5
Matagorda County,2013-May,16860,15206,1654,9.8
Matagorda County,2013-Jun,16995,15222,1773,10.4
Matagorda County,2013-Jul,17073,15288,1785,10.5
Matagorda County,2013-Aug,16728,15003,1725,10.3
Matagorda County,2013-Sep,16688,15041,1647,9.9
Matagorda County,2013-Oct,16866,15280,1586,9.4
Matagorda County,2013-Nov,17251,15731,1520,8.8
Matagorda County,2013-Dec,17000,15511,1489,8.8
Matagorda County,2014-Jan,16636,15056,1580,9.5
Matagorda County,2014-Feb,16919,15434,1485,8.8
Matagorda County,2014-Mar,17238,15877,1361,7.9
Matagorda County,2014-Apr,16860,15643,1217,7.2
Matagorda County,2014-May,16634,15399,1235,7.4
Matagorda County,2014-Jun,16751,15313,1438,8.6
Matagorda County,2014-Jul,16577,15122,1455,8.8
Matagorda County,2014-Aug,16479,15067,1412,8.6
Matagorda County,2014-Sep,16542,15281,1261,7.6
Matagorda County,2014-Oct,16441,15296,1145,7
Matagorda County,2014-Nov,16475,15312,1163,7.1
Matagorda County,2014-Dec,16403,15252,1151,7
Matagorda County,2015-Jan,16855,15596,1259,7.5
Matagorda County,2015-Feb,17077,15914,1163,6.8
Matagorda County,2015-Mar,17431,16342,1089,6.2
Matagorda County,2015-Apr,17671,16636,1035,5.9
Matagorda County,2015-May,17212,16124,1088,6.3
Matagorda County,2015-Jun,17302,16112,1190,6.9
Matagorda County,2015-Jul,17130,15880,1250,7.3
Matagorda County,2015-Aug,17020,15806,1214,7.1
Matagorda County,2015-Sep,17007,15850,1157,6.8
Matagorda County,2015-Oct,17548,16411,1137,6.5
Matagorda County,2015-Nov,17049,15851,1198,7
Matagorda County,2015-Dec,16943,15716,1227,7.2
Matagorda County,2016-Jan,16609,15389,1220,7.3
Matagorda County,2016-Feb,16852,15660,1192,7.1
Matagorda County,2016-Mar,17210,16010,1200,7
Matagorda County,2016-Apr,17075,15905,1170,6.9
Matagorda County,2016-May,17013,15866,1147,6.7
Matagorda County,2016-Jun,17012,15710,1302,7.7
Matagorda County,2016-Jul,16691,15411,1280,7.7
Matagorda County,2016-Aug,16642,15356,1286,7.7
Matagorda County,2016-Sep,16874,15576,1298,7.7
Matagorda County,2016-Oct,17210,16012,1198,7
Matagorda County,2016-Nov,16800,15562,1238,7.4
Matagorda County,2016-Dec,16693,15376,1317,7.9
Matagorda County,2017-Jan,16559,15117,1442,8.7
Matagorda County,2017-Feb,16825,15456,1369,8.1
Matagorda County,2017-Mar,17374,16115,1259,7.2
Matagorda County,2017-Apr,16966,15804,1162,6.8
Matagorda County,2017-May,16654,15534,1120,6.7
Matagorda County,2017-Jun,17019,15758,1261,7.4
Matagorda County,2017-Jul,16696,15440,1256,7.5
Matagorda County,2017-Aug,16718,15445,1273,7.6
Matagorda County,2017-Sep,16724,15444,1280,7.7
Matagorda County,2017-Oct,16613,15508,1105,6.7
Matagorda County,2017-Nov,16627,15489,1138,6.8
Matagorda County,2017-Dec,16611,15473,1138,6.9
Matagorda County,2018-Jan,16507,15245,1262,7.6
Matagorda County,2018-Feb,16760,15568,1192,7.1
Matagorda County,2018-Mar,17152,16083,1069,6.2
Matagorda County,2018-Apr,17016,16046,970,5.7
Matagorda County,2018-May,16699,15733,966,5.8
Matagorda County,2018-Jun,16796,15683,1113,6.6
Matagorda County,2018-Jul,16520,15446,1074,6.5
Matagorda County,2018-Aug,16527,15514,1013,6.1
Matagorda County,2018-Sep,16557,15584,973,5.9
Matagorda County,2018-Oct,16776,15898,878,5.2
Matagorda County,2018-Nov,16290,15405,885,5.4
Matagorda County,2018-Dec,16148,15228,920,5.7
Matagorda County,2019-Jan,16283,15240,1043,6.4
Matagorda County,2019-Feb,16394,15446,948,5.8
Matagorda County,2019-Mar,16465,15613,852,5.2
Matagorda County,2019-Apr,16421,15643,778,4.7
Matagorda County,2019-May,16482,15677,805,4.9
Matagorda County,2019-Jun,16551,15542,1009,6.1
Matagorda County,2019-Jul,16558,15516,1042,6.3
Matagorda County,2019-Aug,16601,15570,1031,6.2
Matagorda County,2019-Sep,16588,15641,947,5.7
Matagorda County,2019-Oct,16819,15954,865,5.1
Matagorda County,2019-Nov,16443,15514,929,5.6
Matagorda County,2019-Dec,16509,15527,982,5.9
Matagorda County,2020-Jan,16435,15360,1075,6.5
Matagorda County,2020-Feb,16538,15626,912,5.5
Matagorda County,2020-Mar,16873,15505,1368,8.1
Matagorda County,2020-Apr,15746,13620,2126,13.5
Matagorda County,2020-May,16199,13865,2334,14.4
Matagorda County,2020-Jun,16401,14149,2252,13.7
Matagorda County,2020-Jul,16409,14201,2208,13.5
Matagorda County,2020-Aug,16323,14494,1829,11.2
Matagorda County,2020-Sep,16276,14508,1768,10.9
Matagorda County,2020-Oct,16454,14918,1536,9.3
Matagorda County,2020-Nov,16424,14802,1622,9.9
Matagorda County,2020-Dec,16354,14719,1635,10
Matagorda County,2021-Jan,16477,14765,1712,10.4
Matagorda County,2021-Feb,16708,15118,1590,9.5
Matagorda County,2021-Mar,17194,15718,1476,8.6
Matagorda County,2021-Apr,16681,15300,1381,8.3
Matagorda County,2021-May,16300,14971,1329,8.2
Matagorda County,2021-Jun,16430,14921,1509,9.2
Matagorda County,2021-Jul,16414,14951,1463,8.9
Matagorda County,2021-Aug,16358,15011,1347,8.2
Matagorda County,2021-Sep,16338,15112,1226,7.5
Matagorda County,2021-Oct,16478,15301,1177,7.1
Matagorda County,2021-Nov,16278,15141,1137,7
Matagorda County,2021-Dec,16205,15055,1150,7.1
Matagorda County,2022-Jan,16350,15033,1317,8.1
Matagorda County,2022-Feb,16770,15483,1287,7.7
Matagorda County,2022-Mar,17209,16143,1066,6.2
Matagorda County,2022-Apr,16447,15397,1050,6.4
Matagorda County,2022-May,16310,15229,1081,6.6
Matagorda County,2022-Jun,16446,15182,1264,7.7
Matagorda County,2022-Jul,16536(P),15273(P),1263(P),7.6(P)
Maverick County,2012-Jan,24022,20556,3466,14.4
Maverick County,2012-Feb,23893,20444,3449,14.4
Maverick County,2012-Mar,23668,20481,3187,13.5
Maverick County,2012-Apr,23485,20521,2964,12.6
Maverick County,2012-May,23449,20596,2853,12.2
Maverick County,2012-Jun,23441,20494,2947,12.6
Maverick County,2012-Jul,22907,20031,2876,12.6
Maverick County,2012-Aug,22470,19815,2655,11.8
Maverick County,2012-Sep,22814,20341,2473,10.8
Maverick County,2012-Oct,23006,20448,2558,11.1
Maverick County,2012-Nov,23114,20568,2546,11
Maverick County,2012-Dec,23389,20550,2839,12.1
Maverick County,2013-Jan,24187,20566,3621,15
Maverick County,2013-Feb,24083,20599,3484,14.5
Maverick County,2013-Mar,23821,20661,3160,13.3
Maverick County,2013-Apr,23890,20811,3079,12.9
Maverick County,2013-May,23765,20791,2974,12.5
Maverick County,2013-Jun,23696,20636,3060,12.9
Maverick County,2013-Jul,22985,20146,2839,12.4
Maverick County,2013-Aug,22769,20039,2730,12
Maverick County,2013-Sep,23070,20497,2573,11.2
Maverick County,2013-Oct,23457,20821,2636,11.2
Maverick County,2013-Nov,23916,21167,2749,11.5
Maverick County,2013-Dec,23947,21177,2770,11.6
Maverick County,2014-Jan,24439,21056,3383,13.8
Maverick County,2014-Feb,24432,21066,3366,13.8
Maverick County,2014-Mar,24188,21078,3110,12.9
Maverick County,2014-Apr,23693,20952,2741,11.6
Maverick County,2014-May,23577,21018,2559,10.9
Maverick County,2014-Jun,23311,20740,2571,11
Maverick County,2014-Jul,22543,20078,2465,10.9
Maverick County,2014-Aug,22401,20028,2373,10.6
Maverick County,2014-Sep,22787,20627,2160,9.5
Maverick County,2014-Oct,22926,20867,2059,9
Maverick County,2014-Nov,23060,20913,2147,9.3
Maverick County,2014-Dec,23245,21049,2196,9.4
Maverick County,2015-Jan,23788,20906,2882,12.1
Maverick County,2015-Feb,23717,20914,2803,11.8
Maverick County,2015-Mar,23787,21041,2746,11.5
Maverick County,2015-Apr,23696,21285,2411,10.2
Maverick County,2015-May,23766,21442,2324,9.8
Maverick County,2015-Jun,23870,21310,2560,10.7
Maverick County,2015-Jul,23193,20726,2467,10.6
Maverick County,2015-Aug,23034,20614,2420,10.5
Maverick County,2015-Sep,23329,21019,2310,9.9
Maverick County,2015-Oct,23619,21247,2372,10
Maverick County,2015-Nov,23988,21431,2557,10.7
Maverick County,2015-Dec,24198,21573,2625,10.8
Maverick County,2016-Jan,24666,21589,3077,12.5
Maverick County,2016-Feb,24838,21712,3126,12.6
Maverick County,2016-Mar,24936,21799,3137,12.6
Maverick County,2016-Apr,24742,21697,3045,12.3
Maverick County,2016-May,24350,21684,2666,10.9
Maverick County,2016-Jun,24273,21440,2833,11.7
Maverick County,2016-Jul,23680,20940,2740,11.6
Maverick County,2016-Aug,23560,20916,2644,11.2
Maverick County,2016-Sep,23721,21238,2483,10.5
Maverick County,2016-Oct,23725,21430,2295,9.7
Maverick County,2016-Nov,24167,21902,2265,9.4
Maverick County,2016-Dec,24335,21882,2453,10.1
Maverick County,2017-Jan,24618,21704,2914,11.8
Maverick County,2017-Feb,24605,21682,2923,11.9
Maverick County,2017-Mar,24438,21714,2724,11.1
Maverick County,2017-Apr,24431,21836,2595,10.6
Maverick County,2017-May,23931,21658,2273,9.5
Maverick County,2017-Jun,23800,21446,2354,9.9
Maverick County,2017-Jul,23030,20937,2093,9.1
Maverick County,2017-Aug,23013,20974,2039,8.9
Maverick County,2017-Sep,23048,21351,1697,7.4
Maverick County,2017-Oct,23156,21561,1595,6.9
Maverick County,2017-Nov,23428,21715,1713,7.3
Maverick County,2017-Dec,23599,21658,1941,8.2
Maverick County,2018-Jan,23945,21592,2353,9.8
Maverick County,2018-Feb,23912,21507,2405,10.1
Maverick County,2018-Mar,23969,21641,2328,9.7
Maverick County,2018-Apr,23960,21769,2191,9.1
Maverick County,2018-May,23654,21695,1959,8.3
Maverick County,2018-Jun,23546,21520,2026,8.6
Maverick County,2018-Jul,22931,21028,1903,8.3
Maverick County,2018-Aug,22484,20907,1577,7
Maverick County,2018-Sep,23105,21613,1492,6.5
Maverick County,2018-Oct,22970,21467,1503,6.5
Maverick County,2018-Nov,23211,21663,1548,6.7
Maverick County,2018-Dec,23376,21577,1799,7.7
Maverick County,2019-Jan,23960,21792,2168,9
Maverick County,2019-Feb,23961,21763,2198,9.2
Maverick County,2019-Mar,23885,21953,1932,8.1
Maverick County,2019-Apr,23800,22063,1737,7.3
Maverick County,2019-May,23636,21977,1659,7
Maverick County,2019-Jun,23628,21816,1812,7.7
Maverick County,2019-Jul,22574,20812,1762,7.8
Maverick County,2019-Aug,22775,21216,1559,6.8
Maverick County,2019-Sep,22914,21440,1474,6.4
Maverick County,2019-Oct,22714,21210,1504,6.6
Maverick County,2019-Nov,23043,21409,1634,7.1
Maverick County,2019-Dec,23461,21617,1844,7.9
Maverick County,2020-Jan,24067,21773,2294,9.5
Maverick County,2020-Feb,23989,21771,2218,9.2
Maverick County,2020-Mar,24301,21121,3180,13.1
Maverick County,2020-Apr,23576,19400,4176,17.7
Maverick County,2020-May,24310,19522,4788,19.7
Maverick County,2020-Jun,24401,19828,4573,18.7
Maverick County,2020-Jul,24097,19681,4416,18.3
Maverick County,2020-Aug,24066,20357,3709,15.4
Maverick County,2020-Sep,24234,20562,3672,15.2
Maverick County,2020-Oct,23686,20395,3291,13.9
Maverick County,2020-Nov,24158,20559,3599,14.9
Maverick County,2020-Dec,24345,20511,3834,15.7
Maverick County,2021-Jan,24358,20218,4140,17
Maverick County,2021-Feb,24420,20482,3938,16.1
Maverick County,2021-Mar,24216,20538,3678,15.2
Maverick County,2021-Apr,24114,20638,3476,14.4
Maverick County,2021-May,23638,20521,3117,13.2
Maverick County,2021-Jun,23714,20472,3242,13.7
Maverick County,2021-Jul,23776,20961,2815,11.8
Maverick County,2021-Aug,23453,20939,2514,10.7
Maverick County,2021-Sep,23406,21105,2301,9.8
Maverick County,2021-Oct,23096,20807,2289,9.9
Maverick County,2021-Nov,23392,21074,2318,9.9
Maverick County,2021-Dec,23436,21107,2329,9.9
Maverick County,2022-Jan,23880,21018,2862,12
Maverick County,2022-Feb,24055,21177,2878,12
Maverick County,2022-Mar,23860,21419,2441,10.2
Maverick County,2022-Apr,23205,20939,2266,9.8
Maverick County,2022-May,23019,20855,2164,9.4
Maverick County,2022-Jun,22959,20769,2190,9.5
Maverick County,2022-Jul,22940(P),20818(P),2122(P),9.3(P)
Medina County,2012-Jan,19897,18451,1446,7.3
Medina County,2012-Feb,19949,18563,1386,6.9
Medina County,2012-Mar,19972,18691,1281,6.4
Medina County,2012-Apr,20044,18835,1209,6
Medina County,2012-May,20147,18857,1290,6.4
Medina County,2012-Jun,20365,18922,1443,7.1
Medina County,2012-Jul,20390,18932,1458,7.2
Medina County,2012-Aug,20225,18884,1341,6.6
Medina County,2012-Sep,20270,19007,1263,6.2
Medina County,2012-Oct,20234,19017,1217,6
Medina County,2012-Nov,20210,19028,1182,5.8
Medina County,2012-Dec,20196,18966,1230,6.1
Medina County,2013-Jan,20004,18615,1389,6.9
Medina County,2013-Feb,20075,18765,1310,6.5
Medina County,2013-Mar,20028,18789,1239,6.2
Medina County,2013-Apr,20233,19030,1203,5.9
Medina County,2013-May,20324,19090,1234,6.1
Medina County,2013-Jun,20534,19164,1370,6.7
Medina County,2013-Jul,20575,19252,1323,6.4
Medina County,2013-Aug,20367,19113,1254,6.2
Medina County,2013-Sep,20420,19188,1232,6
Medina County,2013-Oct,20268,19103,1165,5.7
Medina County,2013-Nov,20298,19173,1125,5.5
Medina County,2013-Dec,20305,19237,1068,5.3
Medina County,2014-Jan,20067,18909,1158,5.8
Medina County,2014-Feb,20256,19117,1139,5.6
Medina County,2014-Mar,20344,19252,1092,5.4
Medina County,2014-Apr,20369,19411,958,4.7
Medina County,2014-May,20459,19444,1015,5
Medina County,2014-Jun,20556,19482,1074,5.2
Medina County,2014-Jul,20603,19486,1117,5.4
Medina County,2014-Aug,20387,19352,1035,5.1
Medina County,2014-Sep,20379,19417,962,4.7
Medina County,2014-Oct,20434,19521,913,4.5
Medina County,2014-Nov,20410,19510,900,4.4
Medina County,2014-Dec,20212,19410,802,4
Medina County,2015-Jan,20076,19143,933,4.6
Medina County,2015-Feb,20239,19342,897,4.4
Medina County,2015-Mar,20328,19441,887,4.4
Medina County,2015-Apr,20393,19576,817,4
Medina County,2015-May,20540,19655,885,4.3
Medina County,2015-Jun,20550,19587,963,4.7
Medina County,2015-Jul,20526,19560,966,4.7
Medina County,2015-Aug,20397,19488,909,4.5
Medina County,2015-Sep,20475,19555,920,4.5
Medina County,2015-Oct,20528,19628,900,4.4
Medina County,2015-Nov,20574,19686,888,4.3
Medina County,2015-Dec,20551,19711,840,4.1
Medina County,2016-Jan,20476,19592,884,4.3
Medina County,2016-Feb,20851,19954,897,4.3
Medina County,2016-Mar,20992,20072,920,4.4
Medina County,2016-Apr,21016,20138,878,4.2
Medina County,2016-May,21050,20202,848,4
Medina County,2016-Jun,21091,20096,995,4.7
Medina County,2016-Jul,21116,20082,1034,4.9
Medina County,2016-Aug,21102,20122,980,4.6
Medina County,2016-Sep,21116,20124,992,4.7
Medina County,2016-Oct,21031,20120,911,4.3
Medina County,2016-Nov,21099,20212,887,4.2
Medina County,2016-Dec,21049,20165,884,4.2
Medina County,2017-Jan,20855,19908,947,4.5
Medina County,2017-Feb,21044,20087,957,4.5
Medina County,2017-Mar,21193,20319,874,4.1
Medina County,2017-Apr,21186,20395,791,3.7
Medina County,2017-May,21131,20325,806,3.8
Medina County,2017-Jun,21201,20340,861,4.1
Medina County,2017-Jul,21190,20313,877,4.1
Medina County,2017-Aug,21174,20323,851,4
Medina County,2017-Sep,21215,20432,783,3.7
Medina County,2017-Oct,21090,20381,709,3.4
Medina County,2017-Nov,21106,20359,747,3.5
Medina County,2017-Dec,21083,20376,707,3.4
Medina County,2018-Jan,21008,20198,810,3.9
Medina County,2018-Feb,21253,20453,800,3.8
Medina County,2018-Mar,21380,20612,768,3.6
Medina County,2018-Apr,21384,20689,695,3.3
Medina County,2018-May,21409,20701,708,3.3
Medina County,2018-Jun,21489,20670,819,3.8
Medina County,2018-Jul,21460,20665,795,3.7
Medina County,2018-Aug,21402,20634,768,3.6
Medina County,2018-Sep,21379,20638,741,3.5
Medina County,2018-Oct,21355,20657,698,3.3
Medina County,2018-Nov,21359,20675,684,3.2
Medina County,2018-Dec,21317,20620,697,3.3
Medina County,2019-Jan,21248,20436,812,3.8
Medina County,2019-Feb,21396,20653,743,3.5
Medina County,2019-Mar,21444,20756,688,3.2
Medina County,2019-Apr,21366,20778,588,2.8
Medina County,2019-May,21380,20785,595,2.8
Medina County,2019-Jun,21548,20825,723,3.4
Medina County,2019-Jul,21609,20865,744,3.4
Medina County,2019-Aug,21661,20961,700,3.2
Medina County,2019-Sep,21642,20959,683,3.2
Medina County,2019-Oct,21697,21050,647,3
Medina County,2019-Nov,21650,20994,656,3
Medina County,2019-Dec,21684,21060,624,2.9
Medina County,2020-Jan,21577,20873,704,3.3
Medina County,2020-Feb,21748,21068,680,3.1
Medina County,2020-Mar,21388,20332,1056,4.9
Medina County,2020-Apr,19619,17760,1859,9.5
Medina County,2020-May,20539,18491,2048,10
Medina County,2020-Jun,21043,19214,1829,8.7
Medina County,2020-Jul,21031,19383,1648,7.8
Medina County,2020-Aug,21265,19949,1316,6.2
Medina County,2020-Sep,21317,20017,1300,6.1
Medina County,2020-Oct,21587,20385,1202,5.6
Medina County,2020-Nov,21584,20344,1240,5.7
Medina County,2020-Dec,21601,20378,1223,5.7
Medina County,2021-Jan,21516,20210,1306,6.1
Medina County,2021-Feb,21724,20420,1304,6
Medina County,2021-Mar,21852,20599,1253,5.7
Medina County,2021-Apr,21779,20702,1077,4.9
Medina County,2021-May,21715,20671,1044,4.8
Medina County,2021-Jun,21878,20684,1194,5.5
Medina County,2021-Jul,21914,20790,1124,5.1
Medina County,2021-Aug,21883,20809,1074,4.9
Medina County,2021-Sep,21923,20926,997,4.5
Medina County,2021-Oct,21945,20998,947,4.3
Medina County,2021-Nov,21959,21054,905,4.1
Medina County,2021-Dec,21894,21065,829,3.8
Medina County,2022-Jan,22007,21060,947,4.3
Medina County,2022-Feb,22448,21490,958,4.3
Medina County,2022-Mar,22423,21654,769,3.4
Medina County,2022-Apr,22294,21565,729,3.3
Medina County,2022-May,22284,21491,793,3.6
Medina County,2022-Jun,22410,21480,930,4.1
Medina County,2022-Jul,22523(P),21617(P),906(P),4.0(P)
Menard County,2012-Jan,915,845,70,7.7
Menard County,2012-Feb,971,907,64,6.6
Menard County,2012-Mar,969,910,59,6.1
Menard County,2012-Apr,969,915,54,5.6
Menard County,2012-May,962,903,59,6.1
Menard County,2012-Jun,990,923,67,6.8
Menard County,2012-Jul,1012,943,69,6.8
Menard County,2012-Aug,985,922,63,6.4
Menard County,2012-Sep,992,933,59,5.9
Menard County,2012-Oct,987,931,56,5.7
Menard County,2012-Nov,941,889,52,5.5
Menard County,2012-Dec,948,890,58,6.1
Menard County,2013-Jan,923,858,65,7
Menard County,2013-Feb,927,870,57,6.1
Menard County,2013-Mar,919,866,53,5.8
Menard County,2013-Apr,916,864,52,5.7
Menard County,2013-May,934,878,56,6
Menard County,2013-Jun,935,875,60,6.4
Menard County,2013-Jul,925,867,58,6.3
Menard County,2013-Aug,913,858,55,6
Menard County,2013-Sep,911,857,54,5.9
Menard County,2013-Oct,896,848,48,5.4
Menard County,2013-Nov,897,850,47,5.2
Menard County,2013-Dec,915,869,46,5
Menard County,2014-Jan,865,817,48,5.5
Menard County,2014-Feb,895,846,49,5.5
Menard County,2014-Mar,895,849,46,5.1
Menard County,2014-Apr,890,855,35,3.9
Menard County,2014-May,889,852,37,4.2
Menard County,2014-Jun,905,861,44,4.9
Menard County,2014-Jul,906,860,46,5.1
Menard County,2014-Aug,872,827,45,5.2
Menard County,2014-Sep,872,831,41,4.7
Menard County,2014-Oct,884,850,34,3.8
Menard County,2014-Nov,885,846,39,4.4
Menard County,2014-Dec,849,811,38,4.5
Menard County,2015-Jan,853,805,48,5.6
Menard County,2015-Feb,858,811,47,5.5
Menard County,2015-Mar,866,824,42,4.8
Menard County,2015-Apr,865,828,37,4.3
Menard County,2015-May,895,847,48,5.4
Menard County,2015-Jun,891,839,52,5.8
Menard County,2015-Jul,864,816,48,5.6
Menard County,2015-Aug,855,810,45,5.3
Menard County,2015-Sep,853,806,47,5.5
Menard County,2015-Oct,852,809,43,5
Menard County,2015-Nov,825,784,41,5
Menard County,2015-Dec,809,769,40,4.9
Menard County,2016-Jan,790,753,37,4.7
Menard County,2016-Feb,818,777,41,5
Menard County,2016-Mar,830,794,36,4.3
Menard County,2016-Apr,824,791,33,4
Menard County,2016-May,828,796,32,3.9
Menard County,2016-Jun,832,793,39,4.7
Menard County,2016-Jul,820,779,41,5
Menard County,2016-Aug,823,784,39,4.7
Menard County,2016-Sep,812,773,39,4.8
Menard County,2016-Oct,804,768,36,4.5
Menard County,2016-Nov,812,777,35,4.3
Menard County,2016-Dec,816,783,33,4
Menard County,2017-Jan,781,745,36,4.6
Menard County,2017-Feb,786,749,37,4.7
Menard County,2017-Mar,799,764,35,4.4
Menard County,2017-Apr,796,768,28,3.5
Menard County,2017-May,806,757,49,6.1
Menard County,2017-Jun,813,763,50,6.2
Menard County,2017-Jul,801,756,45,5.6
Menard County,2017-Aug,811,769,42,5.2
Menard County,2017-Sep,795,757,38,4.8
Menard County,2017-Oct,809,772,37,4.6
Menard County,2017-Nov,805,766,39,4.8
Menard County,2017-Dec,807,771,36,4.5
Menard County,2018-Jan,803,768,35,4.4
Menard County,2018-Feb,806,764,42,5.2
Menard County,2018-Mar,824,784,40,4.9
Menard County,2018-Apr,831,794,37,4.5
Menard County,2018-May,838,803,35,4.2
Menard County,2018-Jun,848,811,37,4.4
Menard County,2018-Jul,833,800,33,4
Menard County,2018-Aug,834,801,33,4
Menard County,2018-Sep,829,798,31,3.7
Menard County,2018-Oct,788,762,26,3.3
Menard County,2018-Nov,800,774,26,3.3
Menard County,2018-Dec,801,771,30,3.7
Menard County,2019-Jan,816,782,34,4.2
Menard County,2019-Feb,825,794,31,3.8
Menard County,2019-Mar,824,794,30,3.6
Menard County,2019-Apr,837,812,25,3
Menard County,2019-May,844,820,24,2.8
Menard County,2019-Jun,853,824,29,3.4
Menard County,2019-Jul,870,837,33,3.8
Menard County,2019-Aug,889,857,32,3.6
Menard County,2019-Sep,882,851,31,3.5
Menard County,2019-Oct,871,842,29,3.3
Menard County,2019-Nov,866,836,30,3.5
Menard County,2019-Dec,880,855,25,2.8
Menard County,2020-Jan,867,839,28,3.2
Menard County,2020-Feb,881,855,26,3
Menard County,2020-Mar,883,846,37,4.2
Menard County,2020-Apr,799,750,49,6.1
Menard County,2020-May,831,771,60,7.2
Menard County,2020-Jun,838,777,61,7.3
Menard County,2020-Jul,868,809,59,6.8
Menard County,2020-Aug,866,823,43,5
Menard County,2020-Sep,865,823,42,4.9
Menard County,2020-Oct,859,822,37,4.3
Menard County,2020-Nov,850,809,41,4.8
Menard County,2020-Dec,878,835,43,4.9
Menard County,2021-Jan,858,814,44,5.1
Menard County,2021-Feb,860,811,49,5.7
Menard County,2021-Mar,867,822,45,5.2
Menard County,2021-Apr,863,826,37,4.3
Menard County,2021-May,854,814,40,4.7
Menard County,2021-Jun,869,827,42,4.8
Menard County,2021-Jul,827,785,42,5.1
Menard County,2021-Aug,819,778,41,5
Menard County,2021-Sep,822,785,37,4.5
Menard County,2021-Oct,800,765,35,4.4
Menard County,2021-Nov,791,759,32,4
Menard County,2021-Dec,809,777,32,4
Menard County,2022-Jan,789,756,33,4.2
Menard County,2022-Feb,811,774,37,4.6
Menard County,2022-Mar,832,801,31,3.7
Menard County,2022-Apr,815,786,29,3.6
Menard County,2022-May,808,777,31,3.8
Menard County,2022-Jun,809,779,30,3.7
Menard County,2022-Jul,820(P),789(P),31(P),3.8(P)
Midland County,2012-Jan,79176,75762,3414,4.3
Midland County,2012-Feb,79920,76630,3290,4.1
Midland County,2012-Mar,80031,76982,3049,3.8
Midland County,2012-Apr,80974,78058,2916,3.6
Midland County,2012-May,81607,78434,3173,3.9
Midland County,2012-Jun,82078,78483,3595,4.4
Midland County,2012-Jul,83443,79825,3618,4.3
Midland County,2012-Aug,83463,80171,3292,3.9
Midland County,2012-Sep,83413,80376,3037,3.6
Midland County,2012-Oct,83528,80600,2928,3.5
Midland County,2012-Nov,83413,80590,2823,3.4
Midland County,2012-Dec,83328,80498,2830,3.4
Midland County,2013-Jan,84142,80765,3377,4
Midland County,2013-Feb,84435,81261,3174,3.8
Midland County,2013-Mar,84185,81141,3044,3.6
Midland County,2013-Apr,85662,82732,2930,3.4
Midland County,2013-May,85777,82583,3194,3.7
Midland County,2013-Jun,86251,82653,3598,4.2
Midland County,2013-Jul,87016,83531,3485,4
Midland County,2013-Aug,86398,83125,3273,3.8
Midland County,2013-Sep,86775,83495,3280,3.8
Midland County,2013-Oct,86072,83025,3047,3.5
Midland County,2013-Nov,86939,84059,2880,3.3
Midland County,2013-Dec,86827,84097,2730,3.1
Midland County,2014-Jan,87753,84890,2863,3.3
Midland County,2014-Feb,88275,85365,2910,3.3
Midland County,2014-Mar,88692,85933,2759,3.1
Midland County,2014-Apr,89702,87344,2358,2.6
Midland County,2014-May,89848,87221,2627,2.9
Midland County,2014-Jun,90601,87720,2881,3.2
Midland County,2014-Jul,92184,89209,2975,3.2
Midland County,2014-Aug,91809,89028,2781,3
Midland County,2014-Sep,92324,89686,2638,2.9
Midland County,2014-Oct,92797,90341,2456,2.6
Midland County,2014-Nov,92861,90538,2323,2.5
Midland County,2014-Dec,92591,90440,2151,2.3
Midland County,2015-Jan,91881,89273,2608,2.8
Midland County,2015-Feb,90459,87709,2750,3
Midland County,2015-Mar,89435,86576,2859,3.2
Midland County,2015-Apr,89408,86608,2800,3.1
Midland County,2015-May,88786,85675,3111,3.5
Midland County,2015-Jun,88574,85170,3404,3.8
Midland County,2015-Jul,88203,84845,3358,3.8
Midland County,2015-Aug,87351,84168,3183,3.6
Midland County,2015-Sep,86793,83580,3213,3.7
Midland County,2015-Oct,86521,83275,3246,3.8
Midland County,2015-Nov,86901,83619,3282,3.8
Midland County,2015-Dec,86571,83403,3168,3.7
Midland County,2016-Jan,86566,83139,3427,4
Midland County,2016-Feb,86235,82631,3604,4.2
Midland County,2016-Mar,85855,82015,3840,4.5
Midland County,2016-Apr,85094,81286,3808,4.5
Midland County,2016-May,84235,80444,3791,4.5
Midland County,2016-Jun,84180,80029,4151,4.9
Midland County,2016-Jul,84890,80751,4139,4.9
Midland County,2016-Aug,84386,80388,3998,4.7
Midland County,2016-Sep,84421,80472,3949,4.7
Midland County,2016-Oct,84627,81044,3583,4.2
Midland County,2016-Nov,85197,81793,3404,4
Midland County,2016-Dec,85273,81915,3358,3.9
Midland County,2017-Jan,85471,81994,3477,4.1
Midland County,2017-Feb,86255,82869,3386,3.9
Midland County,2017-Mar,86415,83354,3061,3.5
Midland County,2017-Apr,87699,85009,2690,3.1
Midland County,2017-May,88237,85573,2664,3
Midland County,2017-Jun,89338,86512,2826,3.2
Midland County,2017-Jul,91179,88427,2752,3
Midland County,2017-Aug,91517,88820,2697,2.9
Midland County,2017-Sep,92436,90006,2430,2.6
Midland County,2017-Oct,93185,91021,2164,2.3
Midland County,2017-Nov,94261,91972,2289,2.4
Midland County,2017-Dec,94882,92735,2147,2.3
Midland County,2018-Jan,96570,94217,2353,2.4
Midland County,2018-Feb,98228,95861,2367,2.4
Midland County,2018-Mar,98616,96332,2284,2.3
Midland County,2018-Apr,100562,98563,1999,2
Midland County,2018-May,100872,98869,2003,2
Midland County,2018-Jun,101784,99399,2385,2.3
Midland County,2018-Jul,103922,101652,2270,2.2
Midland County,2018-Aug,103243,101019,2224,2.2
Midland County,2018-Sep,103941,101795,2146,2.1
Midland County,2018-Oct,104736,102667,2069,2
Midland County,2018-Nov,105237,103174,2063,2
Midland County,2018-Dec,105610,103537,2073,2
Midland County,2019-Jan,104351,101939,2412,2.3
Midland County,2019-Feb,105162,102880,2282,2.2
Midland County,2019-Mar,104551,102374,2177,2.1
Midland County,2019-Apr,105482,103674,1808,1.7
Midland County,2019-May,105138,103257,1881,1.8
Midland County,2019-Jun,105838,103518,2320,2.2
Midland County,2019-Jul,106963,104553,2410,2.3
Midland County,2019-Aug,106192,103795,2397,2.3
Midland County,2019-Sep,106103,103867,2236,2.1
Midland County,2019-Oct,105595,103391,2204,2.1
Midland County,2019-Nov,105302,103062,2240,2.1
Midland County,2019-Dec,104706,102594,2112,2
Midland County,2020-Jan,105013,102569,2444,2.3
Midland County,2020-Feb,105744,103376,2368,2.2
Midland County,2020-Mar,103257,99580,3677,3.6
Midland County,2020-Apr,94353,85136,9217,9.8
Midland County,2020-May,95128,83306,11822,12.4
Midland County,2020-Jun,94820,83224,11596,12.2
Midland County,2020-Jul,94951,83742,11209,11.8
Midland County,2020-Aug,95515,86222,9293,9.7
Midland County,2020-Sep,95455,86514,8941,9.4
Midland County,2020-Oct,96273,88218,8055,8.4
Midland County,2020-Nov,96718,88610,8108,8.4
Midland County,2020-Dec,96947,89165,7782,8
Midland County,2021-Jan,96850,89289,7561,7.8
Midland County,2021-Feb,97628,90481,7147,7.3
Midland County,2021-Mar,97903,91357,6546,6.7
Midland County,2021-Apr,98621,92486,6135,6.2
Midland County,2021-May,98478,92791,5687,5.8
Midland County,2021-Jun,99031,92864,6167,6.2
Midland County,2021-Jul,100279,94642,5637,5.6
Midland County,2021-Aug,100195,94941,5254,5.2
Midland County,2021-Sep,100259,95347,4912,4.9
Midland County,2021-Oct,100281,95654,4627,4.6
Midland County,2021-Nov,101050,96711,4339,4.3
Midland County,2021-Dec,101040,97007,4033,4
Midland County,2022-Jan,100678,96204,4474,4.4
Midland County,2022-Feb,101468,97083,4385,4.3
Midland County,2022-Mar,101589,98032,3557,3.5
Midland County,2022-Apr,100645,97393,3252,3.2
Midland County,2022-May,100902,97567,3335,3.3
Midland County,2022-Jun,101570,97889,3681,3.6
Midland County,2022-Jul,100880(P),97323(P),3557(P),3.5(P)
Milam County,2012-Jan,10229,9270,959,9.4
Milam County,2012-Feb,10186,9246,940,9.2
Milam County,2012-Mar,10187,9329,858,8.4
Milam County,2012-Apr,10213,9427,786,7.7
Milam County,2012-May,10414,9586,828,8
Milam County,2012-Jun,10486,9540,946,9
Milam County,2012-Jul,10421,9472,949,9.1
Milam County,2012-Aug,10269,9401,868,8.5
Milam County,2012-Sep,10254,9427,827,8.1
Milam County,2012-Oct,10148,9359,789,7.8
Milam County,2012-Nov,10176,9321,855,8.4
Milam County,2012-Dec,10068,9176,892,8.9
Milam County,2013-Jan,10090,9117,973,9.6
Milam County,2013-Feb,10068,9146,922,9.2
Milam County,2013-Mar,10047,9215,832,8.3
Milam County,2013-Apr,10104,9365,739,7.3
Milam County,2013-May,10190,9433,757,7.4
Milam County,2013-Jun,10304,9457,847,8.2
Milam County,2013-Jul,10217,9406,811,7.9
Milam County,2013-Aug,10045,9235,810,8.1
Milam County,2013-Sep,10110,9327,783,7.7
Milam County,2013-Oct,10102,9365,737,7.3
Milam County,2013-Nov,10036,9331,705,7
Milam County,2013-Dec,9996,9331,665,6.7
Milam County,2014-Jan,10097,9425,672,6.7
Milam County,2014-Feb,10210,9535,675,6.6
Milam County,2014-Mar,10253,9602,651,6.3
Milam County,2014-Apr,10216,9640,576,5.6
Milam County,2014-May,10268,9652,616,6
Milam County,2014-Jun,10337,9665,672,6.5
Milam County,2014-Jul,10350,9635,715,6.9
Milam County,2014-Aug,10279,9571,708,6.9
Milam County,2014-Sep,10279,9620,659,6.4
Milam County,2014-Oct,10152,9540,612,6
Milam County,2014-Nov,10134,9528,606,6
Milam County,2014-Dec,10016,9465,551,5.5
Milam County,2015-Jan,10015,9402,613,6.1
Milam County,2015-Feb,10093,9525,568,5.6
Milam County,2015-Mar,10031,9514,517,5.2
Milam County,2015-Apr,9990,9516,474,4.7
Milam County,2015-May,10131,9628,503,5
Milam County,2015-Jun,10256,9689,567,5.5
Milam County,2015-Jul,10231,9651,580,5.7
Milam County,2015-Aug,10150,9615,535,5.3
Milam County,2015-Sep,10178,9636,542,5.3
Milam County,2015-Oct,10203,9675,528,5.2
Milam County,2015-Nov,10126,9612,514,5.1
Milam County,2015-Dec,10113,9630,483,4.8
Milam County,2016-Jan,10109,9595,514,5.1
Milam County,2016-Feb,10254,9758,496,4.8
Milam County,2016-Mar,10320,9824,496,4.8
Milam County,2016-Apr,10268,9813,455,4.4
Milam County,2016-May,10341,9878,463,4.5
Milam County,2016-Jun,10369,9795,574,5.5
Milam County,2016-Jul,10366,9762,604,5.8
Milam County,2016-Aug,10350,9788,562,5.4
Milam County,2016-Sep,10322,9752,570,5.5
Milam County,2016-Oct,10247,9716,531,5.2
Milam County,2016-Nov,10180,9646,534,5.2
Milam County,2016-Dec,10133,9574,559,5.5
Milam County,2017-Jan,10068,9448,620,6.2
Milam County,2017-Feb,10183,9601,582,5.7
Milam County,2017-Mar,10266,9723,543,5.3
Milam County,2017-Apr,10199,9707,492,4.8
Milam County,2017-May,10110,9631,479,4.7
Milam County,2017-Jun,10155,9630,525,5.2
Milam County,2017-Jul,9885,9359,526,5.3
Milam County,2017-Aug,9917,9397,520,5.2
Milam County,2017-Sep,9913,9437,476,4.8
Milam County,2017-Oct,9917,9481,436,4.4
Milam County,2017-Nov,9870,9404,466,4.7
Milam County,2017-Dec,9764,9319,445,4.6
Milam County,2018-Jan,9721,9201,520,5.3
Milam County,2018-Feb,9919,9243,676,6.8
Milam County,2018-Mar,9924,9334,590,5.9
Milam County,2018-Apr,9855,9291,564,5.7
Milam County,2018-May,9878,9352,526,5.3
Milam County,2018-Jun,9817,9221,596,6.1
Milam County,2018-Jul,9779,9200,579,5.9
Milam County,2018-Aug,9767,9228,539,5.5
Milam County,2018-Sep,9749,9243,506,5.2
Milam County,2018-Oct,9741,9276,465,4.8
Milam County,2018-Nov,9701,9233,468,4.8
Milam County,2018-Dec,9682,9199,483,5
Milam County,2019-Jan,9681,9010,671,6.9
Milam County,2019-Feb,9683,9099,584,6
Milam County,2019-Mar,9695,9177,518,5.3
Milam County,2019-Apr,9589,9152,437,4.6
Milam County,2019-May,9618,9182,436,4.5
Milam County,2019-Jun,9713,9209,504,5.2
Milam County,2019-Jul,9644,9144,500,5.2
Milam County,2019-Aug,9678,9218,460,4.8
Milam County,2019-Sep,9634,9199,435,4.5
Milam County,2019-Oct,9663,9248,415,4.3
Milam County,2019-Nov,9527,9113,414,4.3
Milam County,2019-Dec,9560,9165,395,4.1
Milam County,2020-Jan,9572,9122,450,4.7
Milam County,2020-Feb,9656,9244,412,4.3
Milam County,2020-Mar,9618,9006,612,6.4
Milam County,2020-Apr,9170,8290,880,9.6
Milam County,2020-May,9430,8510,920,9.8
Milam County,2020-Jun,9641,8760,881,9.1
Milam County,2020-Jul,9653,8816,837,8.7
Milam County,2020-Aug,9712,9016,696,7.2
Milam County,2020-Sep,9746,9079,667,6.8
Milam County,2020-Oct,9768,9165,603,6.2
Milam County,2020-Nov,9761,9101,660,6.8
Milam County,2020-Dec,9664,9005,659,6.8
Milam County,2021-Jan,9868,9130,738,7.5
Milam County,2021-Feb,10013,9280,733,7.3
Milam County,2021-Mar,10165,9479,686,6.7
Milam County,2021-Apr,10153,9552,601,5.9
Milam County,2021-May,10196,9616,580,5.7
Milam County,2021-Jun,10267,9603,664,6.5
Milam County,2021-Jul,10337,9749,588,5.7
Milam County,2021-Aug,10380,9808,572,5.5
Milam County,2021-Sep,10350,9823,527,5.1
Milam County,2021-Oct,10278,9779,499,4.9
Milam County,2021-Nov,10236,9756,480,4.7
Milam County,2021-Dec,10147,9698,449,4.4
Milam County,2022-Jan,10246,9735,511,5
Milam County,2022-Feb,10455,9943,512,4.9
Milam County,2022-Mar,10506,10092,414,3.9
Milam County,2022-Apr,10386,10013,373,3.6
Milam County,2022-May,10299,9896,403,3.9
Milam County,2022-Jun,10321,9832,489,4.7
Milam County,2022-Jul,10452(P),9967(P),485(P),4.6(P)
Mills County,2012-Jan,2118,1998,120,5.7
Mills County,2012-Feb,2078,1959,119,5.7
Mills County,2012-Mar,2088,1977,111,5.3
Mills County,2012-Apr,2125,2014,111,5.2
Mills County,2012-May,2116,2004,112,5.3
Mills County,2012-Jun,2159,2034,125,5.8
Mills County,2012-Jul,2132,2008,124,5.8
Mills County,2012-Aug,2087,1969,118,5.7
Mills County,2012-Sep,2085,1976,109,5.2
Mills County,2012-Oct,2068,1965,103,5
Mills County,2012-Nov,2062,1961,101,4.9
Mills County,2012-Dec,2041,1935,106,5.2
Mills County,2013-Jan,2020,1901,119,5.9
Mills County,2013-Feb,2001,1896,105,5.2
Mills County,2013-Mar,2035,1926,109,5.4
Mills County,2013-Apr,2036,1931,105,5.2
Mills County,2013-May,2062,1949,113,5.5
Mills County,2013-Jun,2162,2038,124,5.7
Mills County,2013-Jul,2154,2040,114,5.3
Mills County,2013-Aug,2106,1999,107,5.1
Mills County,2013-Sep,2119,2000,119,5.6
Mills County,2013-Oct,2056,1954,102,5
Mills County,2013-Nov,2018,1915,103,5.1
Mills County,2013-Dec,2038,1940,98,4.8
Mills County,2014-Jan,2015,1913,102,5.1
Mills County,2014-Feb,2039,1942,97,4.8
Mills County,2014-Mar,2048,1950,98,4.8
Mills County,2014-Apr,2056,1975,81,3.9
Mills County,2014-May,2081,1988,93,4.5
Mills County,2014-Jun,2096,1999,97,4.6
Mills County,2014-Jul,2090,1976,114,5.5
Mills County,2014-Aug,2037,1945,92,4.5
Mills County,2014-Sep,2034,1950,84,4.1
Mills County,2014-Oct,2041,1964,77,3.8
Mills County,2014-Nov,2015,1937,78,3.9
Mills County,2014-Dec,1991,1923,68,3.4
Mills County,2015-Jan,1995,1915,80,4
Mills County,2015-Feb,2024,1949,75,3.7
Mills County,2015-Mar,2041,1972,69,3.4
Mills County,2015-Apr,2035,1971,64,3.1
Mills County,2015-May,2053,1978,75,3.7
Mills County,2015-Jun,2035,1955,80,3.9
Mills County,2015-Jul,2012,1935,77,3.8
Mills County,2015-Aug,1957,1885,72,3.7
Mills County,2015-Sep,1941,1869,72,3.7
Mills County,2015-Oct,1972,1898,74,3.8
Mills County,2015-Nov,1925,1850,75,3.9
Mills County,2015-Dec,1897,1826,71,3.7
Mills County,2016-Jan,1865,1792,73,3.9
Mills County,2016-Feb,1934,1861,73,3.8
Mills County,2016-Mar,1966,1892,74,3.8
Mills County,2016-Apr,1932,1858,74,3.8
Mills County,2016-May,1957,1882,75,3.8
Mills County,2016-Jun,1952,1869,83,4.3
Mills County,2016-Jul,1926,1835,91,4.7
Mills County,2016-Aug,1963,1873,90,4.6
Mills County,2016-Sep,1903,1812,91,4.8
Mills County,2016-Oct,1898,1816,82,4.3
Mills County,2016-Nov,1913,1837,76,4
Mills County,2016-Dec,1885,1810,75,4
Mills County,2017-Jan,1870,1786,84,4.5
Mills County,2017-Feb,1887,1806,81,4.3
Mills County,2017-Mar,1934,1861,73,3.8
Mills County,2017-Apr,1890,1828,62,3.3
Mills County,2017-May,1908,1844,64,3.4
Mills County,2017-Jun,1911,1840,71,3.7
Mills County,2017-Jul,1898,1826,72,3.8
Mills County,2017-Aug,1904,1833,71,3.7
Mills County,2017-Sep,1890,1827,63,3.3
Mills County,2017-Oct,1905,1848,57,3
Mills County,2017-Nov,1878,1819,59,3.1
Mills County,2017-Dec,1893,1839,54,2.9
Mills County,2018-Jan,1824,1762,62,3.4
Mills County,2018-Feb,1846,1780,66,3.6
Mills County,2018-Mar,1928,1858,70,3.6
Mills County,2018-Apr,1840,1781,59,3.2
Mills County,2018-May,1881,1819,62,3.3
Mills County,2018-Jun,1844,1776,68,3.7
Mills County,2018-Jul,1845,1772,73,4
Mills County,2018-Aug,1887,1819,68,3.6
Mills County,2018-Sep,1848,1782,66,3.6
Mills County,2018-Oct,1843,1779,64,3.5
Mills County,2018-Nov,1830,1767,63,3.4
Mills County,2018-Dec,1805,1742,63,3.5
Mills County,2019-Jan,1832,1754,78,4.3
Mills County,2019-Feb,1855,1783,72,3.9
Mills County,2019-Mar,1885,1815,70,3.7
Mills County,2019-Apr,1830,1776,54,3
Mills County,2019-May,1837,1789,48,2.6
Mills County,2019-Jun,1849,1788,61,3.3
Mills County,2019-Jul,1897,1832,65,3.4
Mills County,2019-Aug,1935,1876,59,3
Mills County,2019-Sep,1882,1827,55,2.9
Mills County,2019-Oct,1884,1831,53,2.8
Mills County,2019-Nov,1865,1807,58,3.1
Mills County,2019-Dec,1848,1794,54,2.9
Mills County,2020-Jan,1867,1808,59,3.2
Mills County,2020-Feb,1879,1824,55,2.9
Mills County,2020-Mar,1894,1812,82,4.3
Mills County,2020-Apr,1740,1667,73,4.2
Mills County,2020-May,1771,1690,81,4.6
Mills County,2020-Jun,1794,1703,91,5.1
Mills County,2020-Jul,1880,1794,86,4.6
Mills County,2020-Aug,1938,1867,71,3.7
Mills County,2020-Sep,1909,1831,78,4.1
Mills County,2020-Oct,1917,1846,71,3.7
Mills County,2020-Nov,1904,1823,81,4.3
Mills County,2020-Dec,1896,1808,88,4.6
Mills County,2021-Jan,1898,1803,95,5
Mills County,2021-Feb,1948,1852,96,4.9
Mills County,2021-Mar,1980,1889,91,4.6
Mills County,2021-Apr,1907,1831,76,4
Mills County,2021-May,1904,1826,78,4.1
Mills County,2021-Jun,1946,1856,90,4.6
Mills County,2021-Jul,1930,1848,82,4.2
Mills County,2021-Aug,1930,1847,83,4.3
Mills County,2021-Sep,1892,1810,82,4.3
Mills County,2021-Oct,1856,1778,78,4.2
Mills County,2021-Nov,1850,1772,78,4.2
Mills County,2021-Dec,1825,1754,71,3.9
Mills County,2022-Jan,1846,1755,91,4.9
Mills County,2022-Feb,1928,1834,94,4.9
Mills County,2022-Mar,1977,1904,73,3.7
Mills County,2022-Apr,1900,1833,67,3.5
Mills County,2022-May,1884,1812,72,3.8
Mills County,2022-Jun,1896,1819,77,4.1
Mills County,2022-Jul,1964(P),1883(P),81(P),4.1(P)
Mitchell County,2012-Jan,2860,2661,199,7
Mitchell County,2012-Feb,2860,2670,190,6.6
Mitchell County,2012-Mar,2876,2701,175,6.1
Mitchell County,2012-Apr,2874,2716,158,5.5
Mitchell County,2012-May,2885,2712,173,6
Mitchell County,2012-Jun,2931,2741,190,6.5
Mitchell County,2012-Jul,2930,2741,189,6.5
Mitchell County,2012-Aug,2876,2705,171,5.9
Mitchell County,2012-Sep,2878,2723,155,5.4
Mitchell County,2012-Oct,2847,2700,147,5.2
Mitchell County,2012-Nov,2802,2656,146,5.2
Mitchell County,2012-Dec,2824,2677,147,5.2
Mitchell County,2013-Jan,2835,2650,185,6.5
Mitchell County,2013-Feb,2854,2683,171,6
Mitchell County,2013-Mar,2836,2676,160,5.6
Mitchell County,2013-Apr,2869,2713,156,5.4
Mitchell County,2013-May,2892,2727,165,5.7
Mitchell County,2013-Jun,2944,2762,182,6.2
Mitchell County,2013-Jul,2919,2743,176,6
Mitchell County,2013-Aug,2884,2727,157,5.4
Mitchell County,2013-Sep,2896,2741,155,5.4
Mitchell County,2013-Oct,2849,2705,144,5.1
Mitchell County,2013-Nov,2848,2708,140,4.9
Mitchell County,2013-Dec,2843,2716,127,4.5
Mitchell County,2014-Jan,2844,2714,130,4.6
Mitchell County,2014-Feb,2868,2738,130,4.5
Mitchell County,2014-Mar,2889,2762,127,4.4
Mitchell County,2014-Apr,2908,2796,112,3.9
Mitchell County,2014-May,2908,2786,122,4.2
Mitchell County,2014-Jun,2930,2789,141,4.8
Mitchell County,2014-Jul,2938,2789,149,5.1
Mitchell County,2014-Aug,2915,2777,138,4.7
Mitchell County,2014-Sep,2914,2789,125,4.3
Mitchell County,2014-Oct,2896,2779,117,4
Mitchell County,2014-Nov,2902,2794,108,3.7
Mitchell County,2014-Dec,2887,2786,101,3.5
Mitchell County,2015-Jan,2808,2682,126,4.5
Mitchell County,2015-Feb,2809,2679,130,4.6
Mitchell County,2015-Mar,2814,2666,148,5.3
Mitchell County,2015-Apr,2761,2618,143,5.2
Mitchell County,2015-May,2758,2609,149,5.4
Mitchell County,2015-Jun,2782,2613,169,6.1
Mitchell County,2015-Jul,2747,2562,185,6.7
Mitchell County,2015-Aug,2692,2528,164,6.1
Mitchell County,2015-Sep,2699,2535,164,6.1
Mitchell County,2015-Oct,2712,2548,164,6
Mitchell County,2015-Nov,2679,2514,165,6.2
Mitchell County,2015-Dec,2682,2522,160,6
Mitchell County,2016-Jan,2637,2462,175,6.6
Mitchell County,2016-Feb,2686,2503,183,6.8
Mitchell County,2016-Mar,2681,2480,201,7.5
Mitchell County,2016-Apr,2646,2462,184,7
Mitchell County,2016-May,2625,2449,176,6.7
Mitchell County,2016-Jun,2637,2450,187,7.1
Mitchell County,2016-Jul,2584,2394,190,7.4
Mitchell County,2016-Aug,2590,2408,182,7
Mitchell County,2016-Sep,2555,2362,193,7.6
Mitchell County,2016-Oct,2572,2388,184,7.2
Mitchell County,2016-Nov,2543,2367,176,6.9
Mitchell County,2016-Dec,2567,2397,170,6.6
Mitchell County,2017-Jan,2578,2399,179,6.9
Mitchell County,2017-Feb,2596,2420,176,6.8
Mitchell County,2017-Mar,2589,2437,152,5.9
Mitchell County,2017-Apr,2568,2432,136,5.3
Mitchell County,2017-May,2519,2386,133,5.3
Mitchell County,2017-Jun,2527,2384,143,5.7
Mitchell County,2017-Jul,2464,2326,138,5.6
Mitchell County,2017-Aug,2436,2305,131,5.4
Mitchell County,2017-Sep,2419,2304,115,4.8
Mitchell County,2017-Oct,2388,2281,107,4.5
Mitchell County,2017-Nov,2348,2233,115,4.9
Mitchell County,2017-Dec,2325,2213,112,4.8
Mitchell County,2018-Jan,2347,2221,126,5.4
Mitchell County,2018-Feb,2358,2241,117,5
Mitchell County,2018-Mar,2350,2240,110,4.7
Mitchell County,2018-Apr,2310,2217,93,4
Mitchell County,2018-May,2314,2220,94,4.1
Mitchell County,2018-Jun,2345,2241,104,4.4
Mitchell County,2018-Jul,2258,2162,96,4.3
Mitchell County,2018-Aug,2259,2168,91,4
Mitchell County,2018-Sep,2280,2193,87,3.8
Mitchell County,2018-Oct,2291,2211,80,3.5
Mitchell County,2018-Nov,2267,2187,80,3.5
Mitchell County,2018-Dec,2268,2187,81,3.6
Mitchell County,2019-Jan,2275,2175,100,4.4
Mitchell County,2019-Feb,2304,2210,94,4.1
Mitchell County,2019-Mar,2293,2209,84,3.7
Mitchell County,2019-Apr,2294,2222,72,3.1
Mitchell County,2019-May,2315,2244,71,3.1
Mitchell County,2019-Jun,2319,2224,95,4.1
Mitchell County,2019-Jul,2297,2205,92,4
Mitchell County,2019-Aug,2328,2237,91,3.9
Mitchell County,2019-Sep,2309,2223,86,3.7
Mitchell County,2019-Oct,2315,2233,82,3.5
Mitchell County,2019-Nov,2316,2231,85,3.7
Mitchell County,2019-Dec,2321,2247,74,3.2
Mitchell County,2020-Jan,2298,2224,74,3.2
Mitchell County,2020-Feb,2317,2246,71,3.1
Mitchell County,2020-Mar,2305,2202,103,4.5
Mitchell County,2020-Apr,2196,2018,178,8.1
Mitchell County,2020-May,2296,2060,236,10.3
Mitchell County,2020-Jun,2349,2102,247,10.5
Mitchell County,2020-Jul,2379,2122,257,10.8
Mitchell County,2020-Aug,2373,2152,221,9.3
Mitchell County,2020-Sep,2377,2162,215,9
Mitchell County,2020-Oct,2367,2169,198,8.4
Mitchell County,2020-Nov,2330,2117,213,9.1
Mitchell County,2020-Dec,2325,2130,195,8.4
Mitchell County,2021-Jan,2353,2153,200,8.5
Mitchell County,2021-Feb,2389,2194,195,8.2
Mitchell County,2021-Mar,2390,2203,187,7.8
Mitchell County,2021-Apr,2367,2185,182,7.7
Mitchell County,2021-May,2353,2176,177,7.5
Mitchell County,2021-Jun,2348,2160,188,8
Mitchell County,2021-Jul,2337,2168,169,7.2
Mitchell County,2021-Aug,2330,2175,155,6.7
Mitchell County,2021-Sep,2346,2199,147,6.3
Mitchell County,2021-Oct,2332,2191,141,6
Mitchell County,2021-Nov,2298,2168,130,5.7
Mitchell County,2021-Dec,2312,2179,133,5.8
Mitchell County,2022-Jan,2332,2185,147,6.3
Mitchell County,2022-Feb,2369,2225,144,6.1
Mitchell County,2022-Mar,2379,2263,116,4.9
Mitchell County,2022-Apr,2319,2207,112,4.8
Mitchell County,2022-May,2312,2199,113,4.9
Mitchell County,2022-Jun,2301,2181,120,5.2
Mitchell County,2022-Jul,2307(P),2195(P),112(P),4.9(P)
Montague County,2012-Jan,9517,8944,573,6
Montague County,2012-Feb,9585,9023,562,5.9
Montague County,2012-Mar,9601,9067,534,5.6
Montague County,2012-Apr,9648,9163,485,5
Montague County,2012-May,9758,9231,527,5.4
Montague County,2012-Jun,9840,9266,574,5.8
Montague County,2012-Jul,9890,9313,577,5.8
Montague County,2012-Aug,9931,9378,553,5.6
Montague County,2012-Sep,10034,9532,502,5
Montague County,2012-Oct,10016,9526,490,4.9
Montague County,2012-Nov,10007,9532,475,4.7
Montague County,2012-Dec,10104,9623,481,4.8
Montague County,2013-Jan,10157,9608,549,5.4
Montague County,2013-Feb,10290,9767,523,5.1
Montague County,2013-Mar,10209,9713,496,4.9
Montague County,2013-Apr,10243,9775,468,4.6
Montague County,2013-May,10367,9848,519,5
Montague County,2013-Jun,10436,9870,566,5.4
Montague County,2013-Jul,10408,9846,562,5.4
Montague County,2013-Aug,10402,9876,526,5.1
Montague County,2013-Sep,10489,9970,519,4.9
Montague County,2013-Oct,10404,9901,503,4.8
Montague County,2013-Nov,10401,9931,470,4.5
Montague County,2013-Dec,10329,9880,449,4.3
Montague County,2014-Jan,10076,9601,475,4.7
Montague County,2014-Feb,10124,9654,470,4.6
Montague County,2014-Mar,10196,9753,443,4.3
Montague County,2014-Apr,10066,9688,378,3.8
Montague County,2014-May,10359,9953,406,3.9
Montague County,2014-Jun,10362,9940,422,4.1
Montague County,2014-Jul,10144,9709,435,4.3
Montague County,2014-Aug,10048,9634,414,4.1
Montague County,2014-Sep,10085,9699,386,3.8
Montague County,2014-Oct,10068,9702,366,3.6
Montague County,2014-Nov,9970,9605,365,3.7
Montague County,2014-Dec,9950,9621,329,3.3
Montague County,2015-Jan,9997,9610,387,3.9
Montague County,2015-Feb,9937,9533,404,4.1
Montague County,2015-Mar,9840,9439,401,4.1
Montague County,2015-Apr,9825,9456,369,3.8
Montague County,2015-May,9787,9378,409,4.2
Montague County,2015-Jun,9860,9425,435,4.4
Montague County,2015-Jul,9844,9401,443,4.5
Montague County,2015-Aug,9638,9225,413,4.3
Montague County,2015-Sep,9588,9150,438,4.6
Montague County,2015-Oct,9447,9030,417,4.4
Montague County,2015-Nov,9361,8947,414,4.4
Montague County,2015-Dec,9360,8915,445,4.8
Montague County,2016-Jan,9083,8648,435,4.8
Montague County,2016-Feb,9041,8608,433,4.8
Montague County,2016-Mar,9062,8601,461,5.1
Montague County,2016-Apr,9085,8661,424,4.7
Montague County,2016-May,9171,8737,434,4.7
Montague County,2016-Jun,9236,8753,483,5.2
Montague County,2016-Jul,9095,8609,486,5.3
Montague County,2016-Aug,8907,8436,471,5.3
Montague County,2016-Sep,8949,8466,483,5.4
Montague County,2016-Oct,8930,8500,430,4.8
Montague County,2016-Nov,8941,8524,417,4.7
Montague County,2016-Dec,8917,8503,414,4.6
Montague County,2017-Jan,8877,8430,447,5
Montague County,2017-Feb,8953,8519,434,4.8
Montague County,2017-Mar,8939,8547,392,4.4
Montague County,2017-Apr,9125,8757,368,4
Montague County,2017-May,9156,8800,356,3.9
Montague County,2017-Jun,9163,8788,375,4.1
Montague County,2017-Jul,9039,8656,383,4.2
Montague County,2017-Aug,9015,8648,367,4.1
Montague County,2017-Sep,9050,8724,326,3.6
Montague County,2017-Oct,8990,8694,296,3.3
Montague County,2017-Nov,9000,8681,319,3.5
Montague County,2017-Dec,8935,8635,300,3.4
Montague County,2018-Jan,8877,8555,322,3.6
Montague County,2018-Feb,8991,8673,318,3.5
Montague County,2018-Mar,9010,8718,292,3.2
Montague County,2018-Apr,9020,8758,262,2.9
Montague County,2018-May,9073,8804,269,3
Montague County,2018-Jun,9139,8819,320,3.5
Montague County,2018-Jul,9070,8759,311,3.4
Montague County,2018-Aug,9044,8747,297,3.3
Montague County,2018-Sep,9088,8796,292,3.2
Montague County,2018-Oct,9131,8858,273,3
Montague County,2018-Nov,9083,8812,271,3
Montague County,2018-Dec,9084,8823,261,2.9
Montague County,2019-Jan,9008,8707,301,3.3
Montague County,2019-Feb,9099,8813,286,3.1
Montague County,2019-Mar,9078,8806,272,3
Montague County,2019-Apr,9100,8867,233,2.6
Montague County,2019-May,9249,9014,235,2.5
Montague County,2019-Jun,9294,9016,278,3
Montague County,2019-Jul,9296,9015,281,3
Montague County,2019-Aug,9226,8950,276,3
Montague County,2019-Sep,9281,9010,271,2.9
Montague County,2019-Oct,9274,9018,256,2.8
Montague County,2019-Nov,9171,8922,249,2.7
Montague County,2019-Dec,9102,8873,229,2.5
Montague County,2020-Jan,9248,8965,283,3.1
Montague County,2020-Feb,9339,9053,286,3.1
Montague County,2020-Mar,9186,8749,437,4.8
Montague County,2020-Apr,8600,7726,874,10.2
Montague County,2020-May,8791,7931,860,9.8
Montague County,2020-Jun,8871,8069,802,9
Montague County,2020-Jul,8926,8175,751,8.4
Montague County,2020-Aug,8980,8363,617,6.9
Montague County,2020-Sep,8999,8397,602,6.7
Montague County,2020-Oct,9058,8519,539,6
Montague County,2020-Nov,9041,8488,553,6.1
Montague County,2020-Dec,8979,8417,562,6.3
Montague County,2021-Jan,9084,8495,589,6.5
Montague County,2021-Feb,9188,8611,577,6.3
Montague County,2021-Mar,9302,8727,575,6.2
Montague County,2021-Apr,9379,8891,488,5.2
Montague County,2021-May,9335,8877,458,4.9
Montague County,2021-Jun,9394,8870,524,5.6
Montague County,2021-Jul,9278,8799,479,5.2
Montague County,2021-Aug,9219,8770,449,4.9
Montague County,2021-Sep,9315,8862,453,4.9
Montague County,2021-Oct,9264,8869,395,4.3
Montague County,2021-Nov,9252,8875,377,4.1
Montague County,2021-Dec,9165,8816,349,3.8
Montague County,2022-Jan,9257,8863,394,4.3
Montague County,2022-Feb,9373,8994,379,4
Montague County,2022-Mar,9466,9160,306,3.2
Montague County,2022-Apr,9299,9021,278,3
Montague County,2022-May,9356,9047,309,3.3
Montague County,2022-Jun,9401,9028,373,4
Montague County,2022-Jul,9365(P),9018(P),347(P),3.7(P)
Montgomery County,2012-Jan,234571,219413,15158,6.5
Montgomery County,2012-Feb,236049,221218,14831,6.3
Montgomery County,2012-Mar,236263,222489,13774,5.8
Montgomery County,2012-Apr,236485,223391,13094,5.5
Montgomery County,2012-May,237700,223785,13915,5.9
Montgomery County,2012-Jun,239506,223892,15614,6.5
Montgomery County,2012-Jul,240415,224839,15576,6.5
Montgomery County,2012-Aug,239035,224486,14549,6.1
Montgomery County,2012-Sep,240351,226762,13589,5.7
Montgomery County,2012-Oct,241040,227823,13217,5.5
Montgomery County,2012-Nov,241070,228314,12756,5.3
Montgomery County,2012-Dec,241189,228240,12949,5.4
Montgomery County,2013-Jan,243072,228343,14729,6.1
Montgomery County,2013-Feb,244248,230355,13893,5.7
Montgomery County,2013-Mar,244075,230777,13298,5.4
Montgomery County,2013-Apr,245047,232320,12727,5.2
Montgomery County,2013-May,245717,232318,13399,5.5
Montgomery County,2013-Jun,246709,231892,14817,6
Montgomery County,2013-Jul,247520,233136,14384,5.8
Montgomery County,2013-Aug,246046,232488,13558,5.5
Montgomery County,2013-Sep,246922,233425,13497,5.5
Montgomery County,2013-Oct,245770,233052,12718,5.2
Montgomery County,2013-Nov,247563,235297,12266,5
Montgomery County,2013-Dec,247294,235766,11528,4.7
Montgomery County,2014-Jan,249881,237521,12360,4.9
Montgomery County,2014-Feb,252004,239382,12622,5
Montgomery County,2014-Mar,252650,240664,11986,4.7
Montgomery County,2014-Apr,252052,241652,10400,4.1
Montgomery County,2014-May,252869,241604,11265,4.5
Montgomery County,2014-Jun,253569,241452,12117,4.8
Montgomery County,2014-Jul,254965,242454,12511,4.9
Montgomery County,2014-Aug,253713,241768,11945,4.7
Montgomery County,2014-Sep,254346,243245,11101,4.4
Montgomery County,2014-Oct,255255,244876,10379,4.1
Montgomery County,2014-Nov,255583,245392,10191,4
Montgomery County,2014-Dec,254419,245159,9260,3.6
Montgomery County,2015-Jan,257072,246329,10743,4.2
Montgomery County,2015-Feb,257542,247081,10461,4.1
Montgomery County,2015-Mar,257276,247034,10242,4
Montgomery County,2015-Apr,258134,248326,9808,3.8
Montgomery County,2015-May,258760,247983,10777,4.2
Montgomery County,2015-Jun,258664,246944,11720,4.5
Montgomery County,2015-Jul,259086,247160,11926,4.6
Montgomery County,2015-Aug,257972,246579,11393,4.4
Montgomery County,2015-Sep,257793,246291,11502,4.5
Montgomery County,2015-Oct,258736,247318,11418,4.4
Montgomery County,2015-Nov,259453,247921,11532,4.4
Montgomery County,2015-Dec,259281,248235,11046,4.3
Montgomery County,2016-Jan,263621,251748,11873,4.5
Montgomery County,2016-Feb,265595,253592,12003,4.5
Montgomery County,2016-Mar,265897,253556,12341,4.6
Montgomery County,2016-Apr,266115,253868,12247,4.6
Montgomery County,2016-May,265515,253191,12324,4.6
Montgomery County,2016-Jun,266810,252616,14194,5.3
Montgomery County,2016-Jul,267718,253222,14496,5.4
Montgomery County,2016-Aug,266384,252123,14261,5.4
Montgomery County,2016-Sep,266347,252218,14129,5.3
Montgomery County,2016-Oct,265958,252803,13155,4.9
Montgomery County,2016-Nov,266192,253366,12826,4.8
Montgomery County,2016-Dec,265801,252988,12813,4.8
Montgomery County,2017-Jan,266181,252258,13923,5.2
Montgomery County,2017-Feb,268306,254489,13817,5.1
Montgomery County,2017-Mar,268333,255712,12621,4.7
Montgomery County,2017-Apr,268478,256929,11549,4.3
Montgomery County,2017-May,267693,256197,11496,4.3
Montgomery County,2017-Jun,268667,256461,12206,4.5
Montgomery County,2017-Jul,268849,256959,11890,4.4
Montgomery County,2017-Aug,267986,256079,11907,4.4
Montgomery County,2017-Sep,268287,257113,11174,4.2
Montgomery County,2017-Oct,267480,257411,10069,3.8
Montgomery County,2017-Nov,269174,258640,10534,3.9
Montgomery County,2017-Dec,269041,258796,10245,3.8
Montgomery County,2018-Jan,273437,261987,11450,4.2
Montgomery County,2018-Feb,277085,265658,11427,4.1
Montgomery County,2018-Mar,276674,265840,10834,3.9
Montgomery County,2018-Apr,276728,266710,10018,3.6
Montgomery County,2018-May,276029,266278,9751,3.5
Montgomery County,2018-Jun,277611,266299,11312,4.1
Montgomery County,2018-Jul,278103,267215,10888,3.9
Montgomery County,2018-Aug,275821,265215,10606,3.8
Montgomery County,2018-Sep,276522,266287,10235,3.7
Montgomery County,2018-Oct,277905,268246,9659,3.5
Montgomery County,2018-Nov,278617,269026,9591,3.4
Montgomery County,2018-Dec,279104,269427,9677,3.5
Montgomery County,2019-Jan,283427,272242,11185,3.9
Montgomery County,2019-Feb,285445,275150,10295,3.6
Montgomery County,2019-Mar,284321,274737,9584,3.4
Montgomery County,2019-Apr,283217,274956,8261,2.9
Montgomery County,2019-May,283338,274787,8551,3
Montgomery County,2019-Jun,285570,275263,10307,3.6
Montgomery County,2019-Jul,286489,275889,10600,3.7
Montgomery County,2019-Aug,285538,275280,10258,3.6
Montgomery County,2019-Sep,286634,277023,9611,3.4
Montgomery County,2019-Oct,287072,277755,9317,3.2
Montgomery County,2019-Nov,288019,278627,9392,3.3
Montgomery County,2019-Dec,287339,278392,8947,3.1
Montgomery County,2020-Jan,292604,282367,10237,3.5
Montgomery County,2020-Feb,295350,285617,9733,3.3
Montgomery County,2020-Mar,289896,274844,15052,5.2
Montgomery County,2020-Apr,273966,241729,32237,11.8
Montgomery County,2020-May,282962,251052,31910,11.3
Montgomery County,2020-Jun,286841,258036,28805,10
Montgomery County,2020-Jul,286710,259810,26900,9.4
Montgomery County,2020-Aug,287157,265220,21937,7.6
Montgomery County,2020-Sep,288020,266596,21424,7.4
Montgomery County,2020-Oct,290122,270891,19231,6.6
Montgomery County,2020-Nov,291975,271904,20071,6.9
Montgomery County,2020-Dec,291453,271396,20057,6.9
Montgomery County,2021-Jan,289886,269211,20675,7.1
Montgomery County,2021-Feb,292244,271919,20325,7
Montgomery County,2021-Mar,292239,272892,19347,6.6
Montgomery County,2021-Apr,291866,274107,17759,6.1
Montgomery County,2021-May,291382,274559,16823,5.8
Montgomery County,2021-Jun,293395,274430,18965,6.5
Montgomery County,2021-Jul,294646,277269,17377,5.9
Montgomery County,2021-Aug,294074,277675,16399,5.6
Montgomery County,2021-Sep,294566,279351,15215,5.2
Montgomery County,2021-Oct,295194,280666,14528,4.9
Montgomery County,2021-Nov,296898,283064,13834,4.7
Montgomery County,2021-Dec,297163,284194,12969,4.4
Montgomery County,2022-Jan,296322,281689,14633,4.9
Montgomery County,2022-Feb,299110,284665,14445,4.8
Montgomery County,2022-Mar,298649,286767,11882,4
Montgomery County,2022-Apr,297630,286568,11062,3.7
Montgomery County,2022-May,299586,288044,11542,3.9
Montgomery County,2022-Jun,302483,289307,13176,4.4
Montgomery County,2022-Jul,302575(P),289736(P),12839(P),4.2(P)
Moore County,2012-Jan,11554,11039,515,4.5
Moore County,2012-Feb,11523,11021,502,4.4
Moore County,2012-Mar,11496,11026,470,4.1
Moore County,2012-Apr,11593,11136,457,3.9
Moore County,2012-May,11505,11009,496,4.3
Moore County,2012-Jun,11719,11147,572,4.9
Moore County,2012-Jul,11843,11266,577,4.9
Moore County,2012-Aug,11636,11114,522,4.5
Moore County,2012-Sep,11539,11063,476,4.1
Moore County,2012-Oct,11555,11096,459,4
Moore County,2012-Nov,11467,11015,452,3.9
Moore County,2012-Dec,11321,10856,465,4.1
Moore County,2013-Jan,11270,10744,526,4.7
Moore County,2013-Feb,11246,10755,491,4.4
Moore County,2013-Mar,11117,10646,471,4.2
Moore County,2013-Apr,11333,10873,460,4.1
Moore County,2013-May,11491,10986,505,4.4
Moore County,2013-Jun,11562,10996,566,4.9
Moore County,2013-Jul,11732,11193,539,4.6
Moore County,2013-Aug,11409,10910,499,4.4
Moore County,2013-Sep,11489,10991,498,4.3
Moore County,2013-Oct,11495,11034,461,4
Moore County,2013-Nov,11412,10968,444,3.9
Moore County,2013-Dec,11427,11013,414,3.6
Moore County,2014-Jan,11264,10845,419,3.7
Moore County,2014-Feb,11360,10934,426,3.8
Moore County,2014-Mar,11328,10926,402,3.5
Moore County,2014-Apr,11377,11017,360,3.2
Moore County,2014-May,11409,10996,413,3.6
Moore County,2014-Jun,11333,10891,442,3.9
Moore County,2014-Jul,11397,10936,461,4
Moore County,2014-Aug,11296,10870,426,3.8
Moore County,2014-Sep,11312,10917,395,3.5
Moore County,2014-Oct,11260,10900,360,3.2
Moore County,2014-Nov,11093,10743,350,3.2
Moore County,2014-Dec,10918,10605,313,2.9
Moore County,2015-Jan,10977,10618,359,3.3
Moore County,2015-Feb,11081,10727,354,3.2
Moore County,2015-Mar,11213,10870,343,3.1
Moore County,2015-Apr,11207,10889,318,2.8
Moore County,2015-May,11327,10977,350,3.1
Moore County,2015-Jun,11243,10867,376,3.3
Moore County,2015-Jul,11147,10772,375,3.4
Moore County,2015-Aug,10989,10652,337,3.1
Moore County,2015-Sep,11201,10849,352,3.1
Moore County,2015-Oct,11070,10716,354,3.2
Moore County,2015-Nov,10955,10612,343,3.1
Moore County,2015-Dec,10967,10634,333,3
Moore County,2016-Jan,10723,10382,341,3.2
Moore County,2016-Feb,10944,10616,328,3
Moore County,2016-Mar,10994,10670,324,2.9
Moore County,2016-Apr,11035,10752,283,2.6
Moore County,2016-May,11346,11051,295,2.6
Moore County,2016-Jun,11275,10912,363,3.2
Moore County,2016-Jul,11383,11020,363,3.2
Moore County,2016-Aug,11519,11172,347,3
Moore County,2016-Sep,11412,11063,349,3.1
Moore County,2016-Oct,11297,10955,342,3
Moore County,2016-Nov,11207,10884,323,2.9
Moore County,2016-Dec,11228,10895,333,3
Moore County,2017-Jan,11012,10653,359,3.3
Moore County,2017-Feb,11071,10714,357,3.2
Moore County,2017-Mar,11175,10855,320,2.9
Moore County,2017-Apr,11174,10882,292,2.6
Moore County,2017-May,11140,10822,318,2.9
Moore County,2017-Jun,10983,10636,347,3.2
Moore County,2017-Jul,10914,10576,338,3.1
Moore County,2017-Aug,10828,10504,324,3
Moore County,2017-Sep,10804,10501,303,2.8
Moore County,2017-Oct,10864,10587,277,2.5
Moore County,2017-Nov,10956,10654,302,2.8
Moore County,2017-Dec,10916,10630,286,2.6
Moore County,2018-Jan,10823,10504,319,2.9
Moore County,2018-Feb,10775,10463,312,2.9
Moore County,2018-Mar,10750,10445,305,2.8
Moore County,2018-Apr,10736,10462,274,2.6
Moore County,2018-May,10807,10532,275,2.5
Moore County,2018-Jun,10766,10443,323,3
Moore County,2018-Jul,10839,10545,294,2.7
Moore County,2018-Aug,11036,10743,293,2.7
Moore County,2018-Sep,10941,10659,282,2.6
Moore County,2018-Oct,10635,10379,256,2.4
Moore County,2018-Nov,10558,10300,258,2.4
Moore County,2018-Dec,10492,10225,267,2.5
Moore County,2019-Jan,10448,10159,289,2.8
Moore County,2019-Feb,10549,10294,255,2.4
Moore County,2019-Mar,10745,10499,246,2.3
Moore County,2019-Apr,10729,10527,202,1.9
Moore County,2019-May,10811,10593,218,2
Moore County,2019-Jun,10859,10588,271,2.5
Moore County,2019-Jul,10794,10518,276,2.6
Moore County,2019-Aug,10881,10612,269,2.5
Moore County,2019-Sep,10760,10513,247,2.3
Moore County,2019-Oct,10711,10482,229,2.1
Moore County,2019-Nov,10500,10267,233,2.2
Moore County,2019-Dec,10484,10258,226,2.2
Moore County,2020-Jan,10523,10272,251,2.4
Moore County,2020-Feb,10593,10351,242,2.3
Moore County,2020-Mar,10319,9955,364,3.5
Moore County,2020-Apr,9958,9548,410,4.1
Moore County,2020-May,10118,9627,491,4.9
Moore County,2020-Jun,10335,9808,527,5.1
Moore County,2020-Jul,10488,10007,481,4.6
Moore County,2020-Aug,10585,10182,403,3.8
Moore County,2020-Sep,10760,10367,393,3.7
Moore County,2020-Oct,10827,10461,366,3.4
Moore County,2020-Nov,10683,10305,378,3.5
Moore County,2020-Dec,10697,10295,402,3.8
Moore County,2021-Jan,11048,10595,453,4.1
Moore County,2021-Feb,11228,10763,465,4.1
Moore County,2021-Mar,11213,10785,428,3.8
Moore County,2021-Apr,10890,10530,360,3.3
Moore County,2021-May,10680,10336,344,3.2
Moore County,2021-Jun,10936,10526,410,3.7
Moore County,2021-Jul,11068,10693,375,3.4
Moore County,2021-Aug,11109,10749,360,3.2
Moore County,2021-Sep,11095,10771,324,2.9
Moore County,2021-Oct,10956,10645,311,2.8
Moore County,2021-Nov,10806,10511,295,2.7
Moore County,2021-Dec,10768,10493,275,2.6
Moore County,2022-Jan,11009,10685,324,2.9
Moore County,2022-Feb,11241,10915,326,2.9
Moore County,2022-Mar,11330,11066,264,2.3
Moore County,2022-Apr,11064,10816,248,2.2
Moore County,2022-May,10907,10646,261,2.4
Moore County,2022-Jun,11067,10758,309,2.8
Moore County,2022-Jul,11278(P),10981(P),297(P),2.6(P)
Morris County,2012-Jan,5743,5114,629,11
Morris County,2012-Feb,5800,5174,626,10.8
Morris County,2012-Mar,5783,5211,572,9.9
Morris County,2012-Apr,5772,5235,537,9.3
Morris County,2012-May,5860,5305,555,9.5
Morris County,2012-Jun,5881,5292,589,10
Morris County,2012-Jul,5971,5394,577,9.7
Morris County,2012-Aug,5870,5308,562,9.6
Morris County,2012-Sep,5858,5323,535,9.1
Morris County,2012-Oct,5789,5255,534,9.2
Morris County,2012-Nov,5759,5249,510,8.9
Morris County,2012-Dec,5766,5229,537,9.3
Morris County,2013-Jan,5852,5248,604,10.3
Morris County,2013-Feb,5828,5240,588,10.1
Morris County,2013-Mar,5792,5223,569,9.8
Morris County,2013-Apr,5887,5333,554,9.4
Morris County,2013-May,5910,5363,547,9.3
Morris County,2013-Jun,5977,5388,589,9.9
Morris County,2013-Jul,5876,5294,582,9.9
Morris County,2013-Aug,5873,5278,595,10.1
Morris County,2013-Sep,5907,5335,572,9.7
Morris County,2013-Oct,5705,5163,542,9.5
Morris County,2013-Nov,5698,5169,529,9.3
Morris County,2013-Dec,5669,5180,489,8.6
Morris County,2014-Jan,5759,5256,503,8.7
Morris County,2014-Feb,5774,5280,494,8.6
Morris County,2014-Mar,5750,5288,462,8
Morris County,2014-Apr,5613,5193,420,7.5
Morris County,2014-May,5638,5192,446,7.9
Morris County,2014-Jun,5668,5196,472,8.3
Morris County,2014-Jul,5588,5127,461,8.2
Morris County,2014-Aug,5567,5104,463,8.3
Morris County,2014-Sep,5560,5133,427,7.7
Morris County,2014-Oct,5499,5090,409,7.4
Morris County,2014-Nov,5520,5115,405,7.3
Morris County,2014-Dec,5496,5113,383,7
Morris County,2015-Jan,5488,5076,412,7.5
Morris County,2015-Feb,5501,5093,408,7.4
Morris County,2015-Mar,5464,5065,399,7.3
Morris County,2015-Apr,5446,4954,492,9
Morris County,2015-May,5432,4927,505,9.3
Morris County,2015-Jun,5412,4889,523,9.7
Morris County,2015-Jul,5278,4747,531,10.1
Morris County,2015-Aug,5268,4769,499,9.5
Morris County,2015-Sep,5201,4736,465,8.9
Morris County,2015-Oct,5080,4633,447,8.8
Morris County,2015-Nov,5113,4644,469,9.2
Morris County,2015-Dec,5131,4635,496,9.7
Morris County,2016-Jan,4926,4463,463,9.4
Morris County,2016-Feb,4934,4515,419,8.5
Morris County,2016-Mar,4921,4511,410,8.3
Morris County,2016-Apr,4954,4422,532,10.7
Morris County,2016-May,4941,4406,535,10.8
Morris County,2016-Jun,4945,4321,624,12.6
Morris County,2016-Jul,4961,4347,614,12.4
Morris County,2016-Aug,4988,4359,629,12.6
Morris County,2016-Sep,4955,4343,612,12.4
Morris County,2016-Oct,4761,4217,544,11.4
Morris County,2016-Nov,4766,4235,531,11.1
Morris County,2016-Dec,4696,4173,523,11.1
Morris County,2017-Jan,4685,4109,576,12.3
Morris County,2017-Feb,4691,4137,554,11.8
Morris County,2017-Mar,4635,4147,488,10.5
Morris County,2017-Apr,4679,4229,450,9.6
Morris County,2017-May,4649,4251,398,8.6
Morris County,2017-Jun,4600,4206,394,8.6
Morris County,2017-Jul,4654,4280,374,8
Morris County,2017-Aug,4684,4317,367,7.8
Morris County,2017-Sep,4658,4337,321,6.9
Morris County,2017-Oct,4627,4328,299,6.5
Morris County,2017-Nov,4603,4288,315,6.8
Morris County,2017-Dec,4578,4279,299,6.5
Morris County,2018-Jan,4644,4304,340,7.3
Morris County,2018-Feb,4709,4369,340,7.2
Morris County,2018-Mar,4670,4352,318,6.8
Morris County,2018-Apr,4675,4374,301,6.4
Morris County,2018-May,4698,4399,299,6.4
Morris County,2018-Jun,4694,4355,339,7.2
Morris County,2018-Jul,4690,4353,337,7.2
Morris County,2018-Aug,4660,4350,310,6.7
Morris County,2018-Sep,4659,4375,284,6.1
Morris County,2018-Oct,4640,4357,283,6.1
Morris County,2018-Nov,4637,4356,281,6.1
Morris County,2018-Dec,4605,4328,277,6
Morris County,2019-Jan,4655,4356,299,6.4
Morris County,2019-Feb,4718,4450,268,5.7
Morris County,2019-Mar,4717,4465,252,5.3
Morris County,2019-Apr,4719,4499,220,4.7
Morris County,2019-May,4721,4503,218,4.6
Morris County,2019-Jun,4776,4512,264,5.5
Morris County,2019-Jul,4812,4538,274,5.7
Morris County,2019-Aug,4820,4553,267,5.5
Morris County,2019-Sep,4793,4549,244,5.1
Morris County,2019-Oct,4765,4525,240,5
Morris County,2019-Nov,4777,4544,233,4.9
Morris County,2019-Dec,4761,4513,248,5.2
Morris County,2020-Jan,4737,4469,268,5.7
Morris County,2020-Feb,4804,4555,249,5.2
Morris County,2020-Mar,4762,4404,358,7.5
Morris County,2020-Apr,4714,4153,561,11.9
Morris County,2020-May,4744,4173,571,12
Morris County,2020-Jun,4792,4095,697,14.5
Morris County,2020-Jul,4891,4186,705,14.4
Morris County,2020-Aug,4855,4244,611,12.6
Morris County,2020-Sep,4846,4224,622,12.8
Morris County,2020-Oct,4864,4277,587,12.1
Morris County,2020-Nov,4940,4309,631,12.8
Morris County,2020-Dec,4894,4265,629,12.9
Morris County,2021-Jan,4714,4090,624,13.2
Morris County,2021-Feb,4722,4137,585,12.4
Morris County,2021-Mar,4700,4166,534,11.4
Morris County,2021-Apr,4580,4086,494,10.8
Morris County,2021-May,4549,4079,470,10.3
Morris County,2021-Jun,4586,4062,524,11.4
Morris County,2021-Jul,4645,4147,498,10.7
Morris County,2021-Aug,4668,4190,478,10.2
Morris County,2021-Sep,4613,4173,440,9.5
Morris County,2021-Oct,4583,4172,411,9
Morris County,2021-Nov,4598,4208,390,8.5
Morris County,2021-Dec,4530,4172,358,7.9
Morris County,2022-Jan,4487,4070,417,9.3
Morris County,2022-Feb,4551,4148,403,8.9
Morris County,2022-Mar,4546,4209,337,7.4
Morris County,2022-Apr,4389,4084,305,6.9
Morris County,2022-May,4388,4075,313,7.1
Morris County,2022-Jun,4367,4023,344,7.9
Morris County,2022-Jul,4438(P),4101(P),337(P),7.6(P)
Motley County,2012-Jan,525,485,40,7.6
Motley County,2012-Feb,506,469,37,7.3
Motley County,2012-Mar,513,479,34,6.6
Motley County,2012-Apr,518,488,30,5.8
Motley County,2012-May,521,489,32,6.1
Motley County,2012-Jun,540,509,31,5.7
Motley County,2012-Jul,540,507,33,6.1
Motley County,2012-Aug,535,505,30,5.6
Motley County,2012-Sep,524,497,27,5.2
Motley County,2012-Oct,518,492,26,5
Motley County,2012-Nov,512,487,25,4.9
Motley County,2012-Dec,496,469,27,5.4
Motley County,2013-Jan,482,451,31,6.4
Motley County,2013-Feb,479,449,30,6.3
Motley County,2013-Mar,470,443,27,5.7
Motley County,2013-Apr,491,459,32,6.5
Motley County,2013-May,503,470,33,6.6
Motley County,2013-Jun,529,493,36,6.8
Motley County,2013-Jul,538,506,32,5.9
Motley County,2013-Aug,518,488,30,5.8
Motley County,2013-Sep,518,489,29,5.6
Motley County,2013-Oct,508,478,30,5.9
Motley County,2013-Nov,480,455,25,5.2
Motley County,2013-Dec,489,466,23,4.7
Motley County,2014-Jan,477,453,24,5
Motley County,2014-Feb,485,462,23,4.7
Motley County,2014-Mar,488,465,23,4.7
Motley County,2014-Apr,499,478,21,4.2
Motley County,2014-May,504,482,22,4.4
Motley County,2014-Jun,523,499,24,4.6
Motley County,2014-Jul,525,501,24,4.6
Motley County,2014-Aug,504,483,21,4.2
Motley County,2014-Sep,498,479,19,3.8
Motley County,2014-Oct,487,469,18,3.7
Motley County,2014-Nov,484,464,20,4.1
Motley County,2014-Dec,477,459,18,3.8
Motley County,2015-Jan,476,455,21,4.4
Motley County,2015-Feb,477,459,18,3.8
Motley County,2015-Mar,496,477,19,3.8
Motley County,2015-Apr,480,463,17,3.5
Motley County,2015-May,487,470,17,3.5
Motley County,2015-Jun,505,486,19,3.8
Motley County,2015-Jul,522,504,18,3.4
Motley County,2015-Aug,502,487,15,3
Motley County,2015-Sep,488,472,16,3.3
Motley County,2015-Oct,501,484,17,3.4
Motley County,2015-Nov,487,469,18,3.7
Motley County,2015-Dec,488,473,15,3.1
Motley County,2016-Jan,479,460,19,4
Motley County,2016-Feb,509,490,19,3.7
Motley County,2016-Mar,525,505,20,3.8
Motley County,2016-Apr,518,502,16,3.1
Motley County,2016-May,535,519,16,3
Motley County,2016-Jun,525,506,19,3.6
Motley County,2016-Jul,510,490,20,3.9
Motley County,2016-Aug,517,498,19,3.7
Motley County,2016-Sep,497,479,18,3.6
Motley County,2016-Oct,502,485,17,3.4
Motley County,2016-Nov,498,480,18,3.6
Motley County,2016-Dec,487,468,19,3.9
Motley County,2017-Jan,479,459,20,4.2
Motley County,2017-Feb,496,474,22,4.4
Motley County,2017-Mar,521,503,18,3.5
Motley County,2017-Apr,512,496,16,3.1
Motley County,2017-May,521,504,17,3.3
Motley County,2017-Jun,518,499,19,3.7
Motley County,2017-Jul,484,466,18,3.7
Motley County,2017-Aug,482,463,19,3.9
Motley County,2017-Sep,470,454,16,3.4
Motley County,2017-Oct,480,463,17,3.5
Motley County,2017-Nov,463,446,17,3.7
Motley County,2017-Dec,464,447,17,3.7
Motley County,2018-Jan,436,417,19,4.4
Motley County,2018-Feb,445,425,20,4.5
Motley County,2018-Mar,476,457,19,4
Motley County,2018-Apr,454,439,15,3.3
Motley County,2018-May,472,456,16,3.4
Motley County,2018-Jun,460,443,17,3.7
Motley County,2018-Jul,455,438,17,3.7
Motley County,2018-Aug,485,468,17,3.5
Motley County,2018-Sep,453,435,18,4
Motley County,2018-Oct,461,444,17,3.7
Motley County,2018-Nov,458,443,15,3.3
Motley County,2018-Dec,441,425,16,3.6
Motley County,2019-Jan,439,422,17,3.9
Motley County,2019-Feb,462,443,19,4.1
Motley County,2019-Mar,474,455,19,4
Motley County,2019-Apr,471,457,14,3
Motley County,2019-May,472,458,14,3
Motley County,2019-Jun,476,457,19,4
Motley County,2019-Jul,481,463,18,3.7
Motley County,2019-Aug,489,473,16,3.3
Motley County,2019-Sep,470,454,16,3.4
Motley County,2019-Oct,473,459,14,3
Motley County,2019-Nov,455,439,16,3.5
Motley County,2019-Dec,444,431,13,2.9
Motley County,2020-Jan,434,418,16,3.7
Motley County,2020-Feb,442,428,14,3.2
Motley County,2020-Mar,441,415,26,5.9
Motley County,2020-Apr,412,392,20,4.9
Motley County,2020-May,418,399,19,4.5
Motley County,2020-Jun,425,400,25,5.9
Motley County,2020-Jul,419,397,22,5.3
Motley County,2020-Aug,436,417,19,4.4
Motley County,2020-Sep,423,403,20,4.7
Motley County,2020-Oct,455,437,18,4
Motley County,2020-Nov,426,410,16,3.8
Motley County,2020-Dec,424,407,17,4
Motley County,2021-Jan,443,419,24,5.4
Motley County,2021-Feb,459,434,25,5.4
Motley County,2021-Mar,473,446,27,5.7
Motley County,2021-Apr,474,452,22,4.6
Motley County,2021-May,460,435,25,5.4
Motley County,2021-Jun,446,419,27,6.1
Motley County,2021-Jul,448,426,22,4.9
Motley County,2021-Aug,464,442,22,4.7
Motley County,2021-Sep,452,429,23,5.1
Motley County,2021-Oct,454,433,21,4.6
Motley County,2021-Nov,437,417,20,4.6
Motley County,2021-Dec,429,411,18,4.2
Motley County,2022-Jan,434,412,22,5.1
Motley County,2022-Feb,475,451,24,5.1
Motley County,2022-Mar,491,471,20,4.1
Motley County,2022-Apr,486,469,17,3.5
Motley County,2022-May,468,448,20,4.3
Motley County,2022-Jun,459,437,22,4.8
Motley County,2022-Jul,485(P),465(P),20(P),4.1(P)
Nacogdoches County,2012-Jan,30119,28135,1984,6.6
Nacogdoches County,2012-Feb,30163,28208,1955,6.5
Nacogdoches County,2012-Mar,29935,28109,1826,6.1
Nacogdoches County,2012-Apr,29766,28017,1749,5.9
Nacogdoches County,2012-May,29601,27714,1887,6.4
Nacogdoches County,2012-Jun,29719,27451,2268,7.6
Nacogdoches County,2012-Jul,29348,27070,2278,7.8
Nacogdoches County,2012-Aug,28982,26875,2107,7.3
Nacogdoches County,2012-Sep,29136,27248,1888,6.5
Nacogdoches County,2012-Oct,29135,27300,1835,6.3
Nacogdoches County,2012-Nov,29090,27303,1787,6.1
Nacogdoches County,2012-Dec,29020,27215,1805,6.2
Nacogdoches County,2013-Jan,29231,27209,2022,6.9
Nacogdoches County,2013-Feb,29172,27277,1895,6.5
Nacogdoches County,2013-Mar,29011,27133,1878,6.5
Nacogdoches County,2013-Apr,29139,27326,1813,6.2
Nacogdoches County,2013-May,29232,27303,1929,6.6
Nacogdoches County,2013-Jun,29580,27353,2227,7.5
Nacogdoches County,2013-Jul,29297,27151,2146,7.3
Nacogdoches County,2013-Aug,29089,27071,2018,6.9
Nacogdoches County,2013-Sep,29279,27362,1917,6.5
Nacogdoches County,2013-Oct,29088,27296,1792,6.2
Nacogdoches County,2013-Nov,28967,27239,1728,6
Nacogdoches County,2013-Dec,28972,27353,1619,5.6
Nacogdoches County,2014-Jan,28703,27036,1667,5.8
Nacogdoches County,2014-Feb,28922,27225,1697,5.9
Nacogdoches County,2014-Mar,28715,27101,1614,5.6
Nacogdoches County,2014-Apr,28609,27215,1394,4.9
Nacogdoches County,2014-May,28595,27023,1572,5.5
Nacogdoches County,2014-Jun,28670,26905,1765,6.2
Nacogdoches County,2014-Jul,28778,26986,1792,6.2
Nacogdoches County,2014-Aug,28459,26741,1718,6
Nacogdoches County,2014-Sep,28593,27115,1478,5.2
Nacogdoches County,2014-Oct,28406,27049,1357,4.8
Nacogdoches County,2014-Nov,28376,27053,1323,4.7
Nacogdoches County,2014-Dec,28228,27045,1183,4.2
Nacogdoches County,2015-Jan,27676,26300,1376,5
Nacogdoches County,2015-Feb,27997,26703,1294,4.6
Nacogdoches County,2015-Mar,28050,26831,1219,4.3
Nacogdoches County,2015-Apr,28080,26888,1192,4.2
Nacogdoches County,2015-May,28295,26966,1329,4.7
Nacogdoches County,2015-Jun,28284,26738,1546,5.5
Nacogdoches County,2015-Jul,28330,26791,1539,5.4
Nacogdoches County,2015-Aug,28132,26717,1415,5
Nacogdoches County,2015-Sep,28243,26928,1315,4.7
Nacogdoches County,2015-Oct,28249,26969,1280,4.5
Nacogdoches County,2015-Nov,28233,26957,1276,4.5
Nacogdoches County,2015-Dec,28136,26945,1191,4.2
Nacogdoches County,2016-Jan,28141,26835,1306,4.6
Nacogdoches County,2016-Feb,28690,27434,1256,4.4
Nacogdoches County,2016-Mar,28654,27373,1281,4.5
Nacogdoches County,2016-Apr,28771,27564,1207,4.2
Nacogdoches County,2016-May,28938,27712,1226,4.2
Nacogdoches County,2016-Jun,28722,27202,1520,5.3
Nacogdoches County,2016-Jul,28704,27161,1543,5.4
Nacogdoches County,2016-Aug,28762,27237,1525,5.3
Nacogdoches County,2016-Sep,28855,27436,1419,4.9
Nacogdoches County,2016-Oct,28827,27505,1322,4.6
Nacogdoches County,2016-Nov,28802,27528,1274,4.4
Nacogdoches County,2016-Dec,28791,27512,1279,4.4
Nacogdoches County,2017-Jan,28265,26850,1415,5
Nacogdoches County,2017-Feb,28500,27132,1368,4.8
Nacogdoches County,2017-Mar,28539,27236,1303,4.6
Nacogdoches County,2017-Apr,28599,27436,1163,4.1
Nacogdoches County,2017-May,28581,27416,1165,4.1
Nacogdoches County,2017-Jun,28455,27104,1351,4.7
Nacogdoches County,2017-Jul,28192,26881,1311,4.7
Nacogdoches County,2017-Aug,28160,26850,1310,4.7
Nacogdoches County,2017-Sep,28301,27197,1104,3.9
Nacogdoches County,2017-Oct,28167,27171,996,3.5
Nacogdoches County,2017-Nov,28272,27210,1062,3.8
Nacogdoches County,2017-Dec,28121,27094,1027,3.7
Nacogdoches County,2018-Jan,28384,27199,1185,4.2
Nacogdoches County,2018-Feb,28720,27581,1139,4
Nacogdoches County,2018-Mar,28663,27537,1126,3.9
Nacogdoches County,2018-Apr,28455,27469,986,3.5
Nacogdoches County,2018-May,28346,27364,982,3.5
Nacogdoches County,2018-Jun,28335,27028,1307,4.6
Nacogdoches County,2018-Jul,28272,27011,1261,4.5
Nacogdoches County,2018-Aug,28260,27062,1198,4.2
Nacogdoches County,2018-Sep,28350,27296,1054,3.7
Nacogdoches County,2018-Oct,28258,27224,1034,3.7
Nacogdoches County,2018-Nov,28349,27313,1036,3.7
Nacogdoches County,2018-Dec,28178,27118,1060,3.8
Nacogdoches County,2019-Jan,28033,26803,1230,4.4
Nacogdoches County,2019-Feb,28070,26996,1074,3.8
Nacogdoches County,2019-Mar,28110,27122,988,3.5
Nacogdoches County,2019-Apr,27639,26810,829,3
Nacogdoches County,2019-May,27574,26705,869,3.2
Nacogdoches County,2019-Jun,27558,26360,1198,4.3
Nacogdoches County,2019-Jul,27673,26449,1224,4.4
Nacogdoches County,2019-Aug,27590,26453,1137,4.1
Nacogdoches County,2019-Sep,27810,26798,1012,3.6
Nacogdoches County,2019-Oct,28105,27122,983,3.5
Nacogdoches County,2019-Nov,27926,26945,981,3.5
Nacogdoches County,2019-Dec,27888,26977,911,3.3
Nacogdoches County,2020-Jan,28141,27117,1024,3.6
Nacogdoches County,2020-Feb,28367,27383,984,3.5
Nacogdoches County,2020-Mar,27913,26342,1571,5.6
Nacogdoches County,2020-Apr,25378,22965,2413,9.5
Nacogdoches County,2020-May,26324,23950,2374,9
Nacogdoches County,2020-Jun,26954,24530,2424,9
Nacogdoches County,2020-Jul,27931,25656,2275,8.1
Nacogdoches County,2020-Aug,27997,26139,1858,6.6
Nacogdoches County,2020-Sep,28066,26271,1795,6.4
Nacogdoches County,2020-Oct,28340,26764,1576,5.6
Nacogdoches County,2020-Nov,28251,26499,1752,6.2
Nacogdoches County,2020-Dec,28074,26318,1756,6.3
Nacogdoches County,2021-Jan,28523,26650,1873,6.6
Nacogdoches County,2021-Feb,28695,26855,1840,6.4
Nacogdoches County,2021-Mar,28643,26932,1711,6
Nacogdoches County,2021-Apr,28388,26856,1532,5.4
Nacogdoches County,2021-May,28380,26862,1518,5.3
Nacogdoches County,2021-Jun,28260,26490,1770,6.3
Nacogdoches County,2021-Jul,28011,26421,1590,5.7
Nacogdoches County,2021-Aug,27958,26470,1488,5.3
Nacogdoches County,2021-Sep,28115,26728,1387,4.9
Nacogdoches County,2021-Oct,28225,26890,1335,4.7
Nacogdoches County,2021-Nov,28017,26753,1264,4.5
Nacogdoches County,2021-Dec,27836,26657,1179,4.2
Nacogdoches County,2022-Jan,28190,26837,1353,4.8
Nacogdoches County,2022-Feb,28391,27052,1339,4.7
Nacogdoches County,2022-Mar,28437,27360,1077,3.8
Nacogdoches County,2022-Apr,28229,27221,1008,3.6
Nacogdoches County,2022-May,28306,27201,1105,3.9
Nacogdoches County,2022-Jun,28106,26816,1290,4.6
Nacogdoches County,2022-Jul,28081(P),26811(P),1270(P),4.5(P)
Navarro County,2012-Jan,22824,21090,1734,7.6
Navarro County,2012-Feb,23205,21341,1864,8
Navarro County,2012-Mar,22773,21034,1739,7.6
Navarro County,2012-Apr,23033,21473,1560,6.8
Navarro County,2012-May,23031,21410,1621,7
Navarro County,2012-Jun,22804,21020,1784,7.8
Navarro County,2012-Jul,23337,21512,1825,7.8
Navarro County,2012-Aug,23328,21605,1723,7.4
Navarro County,2012-Sep,23603,21979,1624,6.9
Navarro County,2012-Oct,23554,21982,1572,6.7
Navarro County,2012-Nov,23476,21970,1506,6.4
Navarro County,2012-Dec,23331,21792,1539,6.6
Navarro County,2013-Jan,22738,20944,1794,7.9
Navarro County,2013-Feb,23024,21222,1802,7.8
Navarro County,2013-Mar,22747,21030,1717,7.5
Navarro County,2013-Apr,23023,21525,1498,6.5
Navarro County,2013-May,23131,21601,1530,6.6
Navarro County,2013-Jun,22746,21056,1690,7.4
Navarro County,2013-Jul,23319,21729,1590,6.8
Navarro County,2013-Aug,23323,21876,1447,6.2
Navarro County,2013-Sep,23762,22317,1445,6.1
Navarro County,2013-Oct,23985,22597,1388,5.8
Navarro County,2013-Nov,24248,22939,1309,5.4
Navarro County,2013-Dec,24097,22858,1239,5.1
Navarro County,2014-Jan,23287,21920,1367,5.9
Navarro County,2014-Feb,23540,22137,1403,6
Navarro County,2014-Mar,22952,21569,1383,6
Navarro County,2014-Apr,23132,21959,1173,5.1
Navarro County,2014-May,23178,21936,1242,5.4
Navarro County,2014-Jun,23065,21727,1338,5.8
Navarro County,2014-Jul,22986,21641,1345,5.9
Navarro County,2014-Aug,22863,21607,1256,5.5
Navarro County,2014-Sep,23175,22021,1154,5
Navarro County,2014-Oct,23164,22107,1057,4.6
Navarro County,2014-Nov,23117,22088,1029,4.5
Navarro County,2014-Dec,22861,21939,922,4
Navarro County,2015-Jan,22631,21540,1091,4.8
Navarro County,2015-Feb,23066,22030,1036,4.5
Navarro County,2015-Mar,23072,22038,1034,4.5
Navarro County,2015-Apr,23150,22245,905,3.9
Navarro County,2015-May,23116,22141,975,4.2
Navarro County,2015-Jun,22812,21735,1077,4.7
Navarro County,2015-Jul,22942,21901,1041,4.5
Navarro County,2015-Aug,22713,21753,960,4.2
Navarro County,2015-Sep,22692,21766,926,4.1
Navarro County,2015-Oct,22956,22067,889,3.9
Navarro County,2015-Nov,22900,22010,890,3.9
Navarro County,2015-Dec,22721,21883,838,3.7
Navarro County,2016-Jan,22196,21280,916,4.1
Navarro County,2016-Feb,22589,21651,938,4.2
Navarro County,2016-Mar,22723,21805,918,4
Navarro County,2016-Apr,22762,21891,871,3.8
Navarro County,2016-May,22769,21870,899,3.9
Navarro County,2016-Jun,22765,21704,1061,4.7
Navarro County,2016-Jul,22701,21663,1038,4.6
Navarro County,2016-Aug,22758,21756,1002,4.4
Navarro County,2016-Sep,23006,21989,1017,4.4
Navarro County,2016-Oct,23076,22126,950,4.1
Navarro County,2016-Nov,23069,22152,917,4
Navarro County,2016-Dec,22884,21977,907,4
Navarro County,2017-Jan,22385,21288,1097,4.9
Navarro County,2017-Feb,22714,21656,1058,4.7
Navarro County,2017-Mar,22529,21448,1081,4.8
Navarro County,2017-Apr,22821,21970,851,3.7
Navarro County,2017-May,22754,21916,838,3.7
Navarro County,2017-Jun,22420,21457,963,4.3
Navarro County,2017-Jul,22578,21651,927,4.1
Navarro County,2017-Aug,22477,21581,896,4
Navarro County,2017-Sep,22723,21906,817,3.6
Navarro County,2017-Oct,22917,22187,730,3.2
Navarro County,2017-Nov,22889,22106,783,3.4
Navarro County,2017-Dec,22564,21828,736,3.3
Navarro County,2018-Jan,22667,21705,962,4.2
Navarro County,2018-Feb,23277,22367,910,3.9
Navarro County,2018-Mar,23159,22155,1004,4.3
Navarro County,2018-Apr,23375,22547,828,3.5
Navarro County,2018-May,23448,22643,805,3.4
Navarro County,2018-Jun,23123,22191,932,4
Navarro County,2018-Jul,23619,22673,946,4
Navarro County,2018-Aug,23527,22645,882,3.7
Navarro County,2018-Sep,23770,22936,834,3.5
Navarro County,2018-Oct,23881,23100,781,3.3
Navarro County,2018-Nov,23918,23141,777,3.2
Navarro County,2018-Dec,23315,22516,799,3.4
Navarro County,2019-Jan,23465,22534,931,4
Navarro County,2019-Feb,23762,22871,891,3.7
Navarro County,2019-Mar,23232,22362,870,3.7
Navarro County,2019-Apr,23274,22547,727,3.1
Navarro County,2019-May,23440,22768,672,2.9
Navarro County,2019-Jun,23557,22744,813,3.5
Navarro County,2019-Jul,23964,23141,823,3.4
Navarro County,2019-Aug,24117,23328,789,3.3
Navarro County,2019-Sep,24126,23401,725,3
Navarro County,2019-Oct,24421,23716,705,2.9
Navarro County,2019-Nov,24237,23543,694,2.9
Navarro County,2019-Dec,23555,22895,660,2.8
Navarro County,2020-Jan,23367,22449,918,3.9
Navarro County,2020-Feb,23578,22785,793,3.4
Navarro County,2020-Mar,23072,21829,1243,5.4
Navarro County,2020-Apr,21696,19719,1977,9.1
Navarro County,2020-May,22316,20266,2050,9.2
Navarro County,2020-Jun,22440,20497,1943,8.7
Navarro County,2020-Jul,23076,21337,1739,7.5
Navarro County,2020-Aug,23265,21865,1400,6
Navarro County,2020-Sep,23354,22012,1342,5.7
Navarro County,2020-Oct,23845,22659,1186,5
Navarro County,2020-Nov,23976,22702,1274,5.3
Navarro County,2020-Dec,23718,22408,1310,5.5
Navarro County,2021-Jan,23475,22048,1427,6.1
Navarro County,2021-Feb,23696,22272,1424,6
Navarro County,2021-Mar,23699,22245,1454,6.1
Navarro County,2021-Apr,23580,22362,1218,5.2
Navarro County,2021-May,23454,22243,1211,5.2
Navarro County,2021-Jun,23347,21998,1349,5.8
Navarro County,2021-Jul,23758,22528,1230,5.2
Navarro County,2021-Aug,23741,22591,1150,4.8
Navarro County,2021-Sep,23738,22671,1067,4.5
Navarro County,2021-Oct,24067,23021,1046,4.3
Navarro County,2021-Nov,24081,23091,990,4.1
Navarro County,2021-Dec,23589,22678,911,3.9
Navarro County,2022-Jan,23389,22323,1066,4.6
Navarro County,2022-Feb,23729,22657,1072,4.5
Navarro County,2022-Mar,23639,22766,873,3.7
Navarro County,2022-Apr,23531,22724,807,3.4
Navarro County,2022-May,23756,22893,863,3.6
Navarro County,2022-Jun,23610,22631,979,4.1
Navarro County,2022-Jul,24091(P),23130(P),961(P),4.0(P)
Newton County,2012-Jan,5853,5187,666,11.4
Newton County,2012-Feb,5870,5213,657,11.2
Newton County,2012-Mar,5833,5216,617,10.6
Newton County,2012-Apr,5855,5258,597,10.2
Newton County,2012-May,5842,5226,616,10.5
Newton County,2012-Jun,5870,5174,696,11.9
Newton County,2012-Jul,5783,5117,666,11.5
Newton County,2012-Aug,5729,5072,657,11.5
Newton County,2012-Sep,5726,5107,619,10.8
Newton County,2012-Oct,5725,5125,600,10.5
Newton County,2012-Nov,5665,5085,580,10.2
Newton County,2012-Dec,5711,5052,659,11.5
Newton County,2013-Jan,5657,4959,698,12.3
Newton County,2013-Feb,5660,5029,631,11.1
Newton County,2013-Mar,5662,5027,635,11.2
Newton County,2013-Apr,5614,5030,584,10.4
Newton County,2013-May,5631,5037,594,10.5
Newton County,2013-Jun,5646,5005,641,11.4
Newton County,2013-Jul,5581,4953,628,11.3
Newton County,2013-Aug,5529,4923,606,11
Newton County,2013-Sep,5555,4960,595,10.7
Newton County,2013-Oct,5531,4975,556,10.1
Newton County,2013-Nov,5544,4987,557,10
Newton County,2013-Dec,5546,4996,550,9.9
Newton County,2014-Jan,5514,4960,554,10
Newton County,2014-Feb,5541,5016,525,9.5
Newton County,2014-Mar,5553,5044,509,9.2
Newton County,2014-Apr,5561,5106,455,8.2
Newton County,2014-May,5576,5135,441,7.9
Newton County,2014-Jun,5582,5099,483,8.7
Newton County,2014-Jul,5584,5083,501,9
Newton County,2014-Aug,5551,5064,487,8.8
Newton County,2014-Sep,5552,5109,443,8
Newton County,2014-Oct,5561,5173,388,7
Newton County,2014-Nov,5546,5144,402,7.2
Newton County,2014-Dec,5536,5129,407,7.4
Newton County,2015-Jan,5418,4977,441,8.1
Newton County,2015-Feb,5449,5035,414,7.6
Newton County,2015-Mar,5383,5009,374,6.9
Newton County,2015-Apr,5367,4989,378,7
Newton County,2015-May,5421,5017,404,7.5
Newton County,2015-Jun,5412,4987,425,7.9
Newton County,2015-Jul,5370,4936,434,8.1
Newton County,2015-Aug,5313,4910,403,7.6
Newton County,2015-Sep,5332,4935,397,7.4
Newton County,2015-Oct,5327,4929,398,7.5
Newton County,2015-Nov,5323,4906,417,7.8
Newton County,2015-Dec,5332,4935,397,7.4
Newton County,2016-Jan,5366,4941,425,7.9
Newton County,2016-Feb,5400,5003,397,7.4
Newton County,2016-Mar,5390,4986,404,7.5
Newton County,2016-Apr,5350,4975,375,7
Newton County,2016-May,5325,4945,380,7.1
Newton County,2016-Jun,5371,4921,450,8.4
Newton County,2016-Jul,5333,4875,458,8.6
Newton County,2016-Aug,5340,4873,467,8.7
Newton County,2016-Sep,5375,4920,455,8.5
Newton County,2016-Oct,5340,4938,402,7.5
Newton County,2016-Nov,5330,4908,422,7.9
Newton County,2016-Dec,5330,4869,461,8.6
Newton County,2017-Jan,5288,4779,509,9.6
Newton County,2017-Feb,5317,4850,467,8.8
Newton County,2017-Mar,5310,4888,422,7.9
Newton County,2017-Apr,5284,4884,400,7.6
Newton County,2017-May,5251,4857,394,7.5
Newton County,2017-Jun,5286,4838,448,8.5
Newton County,2017-Jul,5249,4815,434,8.3
Newton County,2017-Aug,5187,4768,419,8.1
Newton County,2017-Sep,5173,4755,418,8.1
Newton County,2017-Oct,5160,4808,352,6.8
Newton County,2017-Nov,5184,4800,384,7.4
Newton County,2017-Dec,5183,4779,404,7.8
Newton County,2018-Jan,5183,4738,445,8.6
Newton County,2018-Feb,5205,4812,393,7.6
Newton County,2018-Mar,5160,4797,363,7
Newton County,2018-Apr,5151,4805,346,6.7
Newton County,2018-May,5147,4823,324,6.3
Newton County,2018-Jun,5166,4810,356,6.9
Newton County,2018-Jul,5122,4771,351,6.9
Newton County,2018-Aug,5106,4766,340,6.7
Newton County,2018-Sep,5109,4794,315,6.2
Newton County,2018-Oct,5094,4806,288,5.7
Newton County,2018-Nov,5111,4811,300,5.9
Newton County,2018-Dec,5113,4764,349,6.8
Newton County,2019-Jan,5118,4710,408,8
Newton County,2019-Feb,5107,4776,331,6.5
Newton County,2019-Mar,5079,4785,294,5.8
Newton County,2019-Apr,5041,4778,263,5.2
Newton County,2019-May,5034,4763,271,5.4
Newton County,2019-Jun,5071,4729,342,6.7
Newton County,2019-Jul,5075,4706,369,7.3
Newton County,2019-Aug,5079,4730,349,6.9
Newton County,2019-Sep,5080,4769,311,6.1
Newton County,2019-Oct,5107,4819,288,5.6
Newton County,2019-Nov,5101,4801,300,5.9
Newton County,2019-Dec,5104,4784,320,6.3
Newton County,2020-Jan,5070,4703,367,7.2
Newton County,2020-Feb,5073,4763,310,6.1
Newton County,2020-Mar,5098,4585,513,10.1
Newton County,2020-Apr,4739,4026,713,15
Newton County,2020-May,4874,4133,741,15.2
Newton County,2020-Jun,4920,4218,702,14.3
Newton County,2020-Jul,4933,4253,680,13.8
Newton County,2020-Aug,4915,4363,552,11.2
Newton County,2020-Sep,4927,4371,556,11.3
Newton County,2020-Oct,4902,4437,465,9.5
Newton County,2020-Nov,4941,4454,487,9.9
Newton County,2020-Dec,4945,4418,527,10.7
Newton County,2021-Jan,4942,4353,589,11.9
Newton County,2021-Feb,4967,4377,590,11.9
Newton County,2021-Mar,4985,4426,559,11.2
Newton County,2021-Apr,4950,4412,538,10.9
Newton County,2021-May,4889,4367,522,10.7
Newton County,2021-Jun,4907,4336,571,11.6
Newton County,2021-Jul,4871,4343,528,10.8
Newton County,2021-Aug,4845,4361,484,10
Newton County,2021-Sep,4827,4384,443,9.2
Newton County,2021-Oct,4839,4407,432,8.9
Newton County,2021-Nov,4874,4436,438,9
Newton County,2021-Dec,4871,4447,424,8.7
Newton County,2022-Jan,4921,4455,466,9.5
Newton County,2022-Feb,4972,4524,448,9
Newton County,2022-Mar,4930,4566,364,7.4
Newton County,2022-Apr,4889,4550,339,6.9
Newton County,2022-May,4879,4522,357,7.3
Newton County,2022-Jun,4901,4505,396,8.1
Newton County,2022-Jul,4895(P),4507(P),388(P),7.9(P)
Nolan County,2012-Jan,7088,6631,457,6.4
Nolan County,2012-Feb,7022,6574,448,6.4
Nolan County,2012-Mar,7033,6602,431,6.1
Nolan County,2012-Apr,7094,6693,401,5.7
Nolan County,2012-May,7107,6691,416,5.9
Nolan County,2012-Jun,7215,6743,472,6.5
Nolan County,2012-Jul,7165,6701,464,6.5
Nolan County,2012-Aug,7087,6666,421,5.9
Nolan County,2012-Sep,7066,6687,379,5.4
Nolan County,2012-Oct,7061,6680,381,5.4
Nolan County,2012-Nov,7001,6632,369,5.3
Nolan County,2012-Dec,6983,6603,380,5.4
Nolan County,2013-Jan,6986,6539,447,6.4
Nolan County,2013-Feb,6955,6528,427,6.1
Nolan County,2013-Mar,6934,6519,415,6
Nolan County,2013-Apr,6951,6534,417,6
Nolan County,2013-May,6943,6536,407,5.9
Nolan County,2013-Jun,6992,6542,450,6.4
Nolan County,2013-Jul,6994,6564,430,6.1
Nolan County,2013-Aug,6915,6533,382,5.5
Nolan County,2013-Sep,6919,6535,384,5.5
Nolan County,2013-Oct,6948,6590,358,5.2
Nolan County,2013-Nov,6976,6628,348,5
Nolan County,2013-Dec,6930,6605,325,4.7
Nolan County,2014-Jan,7003,6672,331,4.7
Nolan County,2014-Feb,7067,6729,338,4.8
Nolan County,2014-Mar,7113,6779,334,4.7
Nolan County,2014-Apr,7042,6749,293,4.2
Nolan County,2014-May,7063,6748,315,4.5
Nolan County,2014-Jun,7076,6744,332,4.7
Nolan County,2014-Jul,7059,6718,341,4.8
Nolan County,2014-Aug,7060,6759,301,4.3
Nolan County,2014-Sep,7059,6768,291,4.1
Nolan County,2014-Oct,6970,6701,269,3.9
Nolan County,2014-Nov,7007,6733,274,3.9
Nolan County,2014-Dec,6923,6672,251,3.6
Nolan County,2015-Jan,6853,6571,282,4.1
Nolan County,2015-Feb,6845,6571,274,4
Nolan County,2015-Mar,6862,6602,260,3.8
Nolan County,2015-Apr,6886,6633,253,3.7
Nolan County,2015-May,6886,6607,279,4.1
Nolan County,2015-Jun,6924,6623,301,4.3
Nolan County,2015-Jul,7038,6734,304,4.3
Nolan County,2015-Aug,7001,6719,282,4
Nolan County,2015-Sep,6946,6659,287,4.1
Nolan County,2015-Oct,6941,6666,275,4
Nolan County,2015-Nov,6915,6628,287,4.2
Nolan County,2015-Dec,6882,6588,294,4.3
Nolan County,2016-Jan,6790,6470,320,4.7
Nolan County,2016-Feb,6878,6555,323,4.7
Nolan County,2016-Mar,6930,6594,336,4.8
Nolan County,2016-Apr,6906,6595,311,4.5
Nolan County,2016-May,6884,6576,308,4.5
Nolan County,2016-Jun,6962,6612,350,5
Nolan County,2016-Jul,6941,6584,357,5.1
Nolan County,2016-Aug,6904,6562,342,5
Nolan County,2016-Sep,6848,6492,356,5.2
Nolan County,2016-Oct,6819,6487,332,4.9
Nolan County,2016-Nov,6798,6483,315,4.6
Nolan County,2016-Dec,6749,6438,311,4.6
Nolan County,2017-Jan,6722,6392,330,4.9
Nolan County,2017-Feb,6774,6439,335,4.9
Nolan County,2017-Mar,6769,6461,308,4.6
Nolan County,2017-Apr,6735,6464,271,4
Nolan County,2017-May,6700,6430,270,4
Nolan County,2017-Jun,6769,6469,300,4.4
Nolan County,2017-Jul,6765,6484,281,4.2
Nolan County,2017-Aug,6796,6522,274,4
Nolan County,2017-Sep,6704,6460,244,3.6
Nolan County,2017-Oct,6678,6458,220,3.3
Nolan County,2017-Nov,6651,6429,222,3.3
Nolan County,2017-Dec,6677,6455,222,3.3
Nolan County,2018-Jan,6493,6255,238,3.7
Nolan County,2018-Feb,6590,6353,237,3.6
Nolan County,2018-Mar,6623,6398,225,3.4
Nolan County,2018-Apr,6618,6420,198,3
Nolan County,2018-May,6577,6382,195,3
Nolan County,2018-Jun,6681,6432,249,3.7
Nolan County,2018-Jul,6789,6543,246,3.6
Nolan County,2018-Aug,6751,6523,228,3.4
Nolan County,2018-Sep,6696,6475,221,3.3
Nolan County,2018-Oct,6720,6515,205,3.1
Nolan County,2018-Nov,6652,6454,198,3
Nolan County,2018-Dec,6647,6444,203,3.1
Nolan County,2019-Jan,6782,6549,233,3.4
Nolan County,2019-Feb,6754,6536,218,3.2
Nolan County,2019-Mar,6786,6580,206,3
Nolan County,2019-Apr,6787,6620,167,2.5
Nolan County,2019-May,6791,6618,173,2.5
Nolan County,2019-Jun,7004,6783,221,3.2
Nolan County,2019-Jul,7100,6875,225,3.2
Nolan County,2019-Aug,7130,6910,220,3.1
Nolan County,2019-Sep,7133,6924,209,2.9
Nolan County,2019-Oct,7154,6957,197,2.8
Nolan County,2019-Nov,7048,6846,202,2.9
Nolan County,2019-Dec,6991,6809,182,2.6
Nolan County,2020-Jan,7118,6896,222,3.1
Nolan County,2020-Feb,7198,6990,208,2.9
Nolan County,2020-Mar,7074,6759,315,4.5
Nolan County,2020-Apr,6605,6230,375,5.7
Nolan County,2020-May,6836,6379,457,6.7
Nolan County,2020-Jun,6933,6434,499,7.2
Nolan County,2020-Jul,7019,6547,472,6.7
Nolan County,2020-Aug,7116,6724,392,5.5
Nolan County,2020-Sep,7236,6851,385,5.3
Nolan County,2020-Oct,7025,6663,362,5.2
Nolan County,2020-Nov,6926,6526,400,5.8
Nolan County,2020-Dec,6991,6575,416,6
Nolan County,2021-Jan,7079,6642,437,6.2
Nolan County,2021-Feb,7166,6757,409,5.7
Nolan County,2021-Mar,7263,6876,387,5.3
Nolan County,2021-Apr,7136,6797,339,4.8
Nolan County,2021-May,6985,6660,325,4.7
Nolan County,2021-Jun,7046,6672,374,5.3
Nolan County,2021-Jul,7170,6819,351,4.9
Nolan County,2021-Aug,7133,6813,320,4.5
Nolan County,2021-Sep,7151,6850,301,4.2
Nolan County,2021-Oct,7070,6778,292,4.1
Nolan County,2021-Nov,6956,6691,265,3.8
Nolan County,2021-Dec,6931,6689,242,3.5
Nolan County,2022-Jan,7062,6766,296,4.2
Nolan County,2022-Feb,7142,6851,291,4.1
Nolan County,2022-Mar,7216,6973,243,3.4
Nolan County,2022-Apr,6966,6744,222,3.2
Nolan County,2022-May,6915,6684,231,3.3
Nolan County,2022-Jun,6964,6691,273,3.9
Nolan County,2022-Jul,7055(P),6793(P),262(P),3.7(P)
Nueces County,2012-Jan,164191,152089,12102,7.4
Nueces County,2012-Feb,165837,154225,11612,7
Nueces County,2012-Mar,165794,155070,10724,6.5
Nueces County,2012-Apr,166881,156647,10234,6.1
Nueces County,2012-May,167712,156970,10742,6.4
Nueces County,2012-Jun,167714,155831,11883,7.1
Nueces County,2012-Jul,167629,155666,11963,7.1
Nueces County,2012-Aug,166760,155657,11103,6.7
Nueces County,2012-Sep,166740,156445,10295,6.2
Nueces County,2012-Oct,167451,157398,10053,6
Nueces County,2012-Nov,166917,157135,9782,5.9
Nueces County,2012-Dec,165933,155870,10063,6.1
Nueces County,2013-Jan,166154,154866,11288,6.8
Nueces County,2013-Feb,167618,157116,10502,6.3
Nueces County,2013-Mar,168235,157921,10314,6.1
Nueces County,2013-Apr,168172,158261,9911,5.9
Nueces County,2013-May,168321,158014,10307,6.1
Nueces County,2013-Jun,169158,157763,11395,6.7
Nueces County,2013-Jul,168331,157255,11076,6.6
Nueces County,2013-Aug,168081,157572,10509,6.3
Nueces County,2013-Sep,168278,157867,10411,6.2
Nueces County,2013-Oct,167302,157398,9904,5.9
Nueces County,2013-Nov,168405,158802,9603,5.7
Nueces County,2013-Dec,167647,158568,9079,5.4
Nueces County,2014-Jan,166445,156923,9522,5.7
Nueces County,2014-Feb,168203,158759,9444,5.6
Nueces County,2014-Mar,168990,159932,9058,5.4
Nueces County,2014-Apr,167689,159637,8052,4.8
Nueces County,2014-May,168196,159661,8535,5.1
Nueces County,2014-Jun,168405,159161,9244,5.5
Nueces County,2014-Jul,168470,158953,9517,5.6
Nueces County,2014-Aug,167971,158838,9133,5.4
Nueces County,2014-Sep,168337,159911,8426,5
Nueces County,2014-Oct,168350,160255,8095,4.8
Nueces County,2014-Nov,168005,159936,8069,4.8
Nueces County,2014-Dec,167115,159602,7513,4.5
Nueces County,2015-Jan,165216,156935,8281,5
Nueces County,2015-Feb,165370,157496,7874,4.8
Nueces County,2015-Mar,165718,158107,7611,4.6
Nueces County,2015-Apr,166134,158665,7469,4.5
Nueces County,2015-May,166500,158489,8011,4.8
Nueces County,2015-Jun,166635,157974,8661,5.2
Nueces County,2015-Jul,165863,157104,8759,5.3
Nueces County,2015-Aug,166312,157785,8527,5.1
Nueces County,2015-Sep,165711,157256,8455,5.1
Nueces County,2015-Oct,165716,157330,8386,5.1
Nueces County,2015-Nov,166045,157380,8665,5.2
Nueces County,2015-Dec,165460,157028,8432,5.1
Nueces County,2016-Jan,165621,156621,9000,5.4
Nueces County,2016-Feb,167468,158475,8993,5.4
Nueces County,2016-Mar,168034,158781,9253,5.5
Nueces County,2016-Apr,167222,158474,8748,5.2
Nueces County,2016-May,167133,158490,8643,5.2
Nueces County,2016-Jun,168291,158309,9982,5.9
Nueces County,2016-Jul,169018,158906,10112,6
Nueces County,2016-Aug,168695,158712,9983,5.9
Nueces County,2016-Sep,168199,158107,10092,6
Nueces County,2016-Oct,167635,158158,9477,5.7
Nueces County,2016-Nov,168647,159114,9533,5.7
Nueces County,2016-Dec,167958,158110,9848,5.9
Nueces County,2017-Jan,166608,155866,10742,6.4
Nueces County,2017-Feb,167954,157639,10315,6.1
Nueces County,2017-Mar,169191,159713,9478,5.6
Nueces County,2017-Apr,168424,159538,8886,5.3
Nueces County,2017-May,167544,159045,8499,5.1
Nueces County,2017-Jun,167787,158614,9173,5.5
Nueces County,2017-Jul,166696,157689,9007,5.4
Nueces County,2017-Aug,165882,156640,9242,5.6
Nueces County,2017-Sep,165189,156182,9007,5.5
Nueces County,2017-Oct,164786,156569,8217,5
Nueces County,2017-Nov,165274,156812,8462,5.1
Nueces County,2017-Dec,165688,157537,8151,4.9
Nueces County,2018-Jan,165647,156750,8897,5.4
Nueces County,2018-Feb,167590,159052,8538,5.1
Nueces County,2018-Mar,167514,159247,8267,4.9
Nueces County,2018-Apr,167480,159772,7708,4.6
Nueces County,2018-May,166861,159561,7300,4.4
Nueces County,2018-Jun,167432,158956,8476,5.1
Nueces County,2018-Jul,166964,158736,8228,4.9
Nueces County,2018-Aug,165302,157474,7828,4.7
Nueces County,2018-Sep,164183,156667,7516,4.6
Nueces County,2018-Oct,165007,158171,6836,4.1
Nueces County,2018-Nov,165376,158474,6902,4.2
Nueces County,2018-Dec,165719,158533,7186,4.3
Nueces County,2019-Jan,165113,157120,7993,4.8
Nueces County,2019-Feb,165726,158128,7598,4.6
Nueces County,2019-Mar,165210,158235,6975,4.2
Nueces County,2019-Apr,164877,159097,5780,3.5
Nueces County,2019-May,164497,158509,5988,3.6
Nueces County,2019-Jun,165457,158250,7207,4.4
Nueces County,2019-Jul,165440,158168,7272,4.4
Nueces County,2019-Aug,165133,158129,7004,4.2
Nueces County,2019-Sep,164303,157736,6567,4
Nueces County,2019-Oct,164615,158374,6241,3.8
Nueces County,2019-Nov,164799,158438,6361,3.9
Nueces County,2019-Dec,164767,158306,6461,3.9
Nueces County,2020-Jan,163836,156626,7210,4.4
Nueces County,2020-Feb,164955,158399,6556,4
Nueces County,2020-Mar,163352,153307,10045,6.1
Nueces County,2020-Apr,156947,134825,22122,14.1
Nueces County,2020-May,161778,140372,21406,13.2
Nueces County,2020-Jun,164642,145698,18944,11.5
Nueces County,2020-Jul,164541,145477,19064,11.6
Nueces County,2020-Aug,163887,148604,15283,9.3
Nueces County,2020-Sep,163402,148804,14598,8.9
Nueces County,2020-Oct,164088,151266,12822,7.8
Nueces County,2020-Nov,164481,151178,13303,8.1
Nueces County,2020-Dec,164185,150955,13230,8.1
Nueces County,2021-Jan,162716,148966,13750,8.5
Nueces County,2021-Feb,164286,150818,13468,8.2
Nueces County,2021-Mar,164960,152365,12595,7.6
Nueces County,2021-Apr,163974,152240,11734,7.2
Nueces County,2021-May,163499,152311,11188,6.8
Nueces County,2021-Jun,164609,151958,12651,7.7
Nueces County,2021-Jul,164204,152613,11591,7.1
Nueces County,2021-Aug,163476,152494,10982,6.7
Nueces County,2021-Sep,163144,152921,10223,6.3
Nueces County,2021-Oct,163371,153718,9653,5.9
Nueces County,2021-Nov,163858,154524,9334,5.7
Nueces County,2021-Dec,163800,154893,8907,5.4
Nueces County,2022-Jan,163522,153313,10209,6.2
Nueces County,2022-Feb,165388,155460,9928,6
Nueces County,2022-Mar,165203,156868,8335,5
Nueces County,2022-Apr,163334,155528,7806,4.8
Nueces County,2022-May,163914,155926,7988,4.9
Nueces County,2022-Jun,164880,155796,9084,5.5
Nueces County,2022-Jul,164536(P),155677(P),8859(P),5.4(P)
Ochiltree County,2012-Jan,5071,4860,211,4.2
Ochiltree County,2012-Feb,5121,4915,206,4
Ochiltree County,2012-Mar,5176,4987,189,3.7
Ochiltree County,2012-Apr,5314,5128,186,3.5
Ochiltree County,2012-May,5396,5194,202,3.7
Ochiltree County,2012-Jun,5492,5259,233,4.2
Ochiltree County,2012-Jul,5506,5271,235,4.3
Ochiltree County,2012-Aug,5414,5201,213,3.9
Ochiltree County,2012-Sep,5381,5179,202,3.8
Ochiltree County,2012-Oct,5336,5146,190,3.6
Ochiltree County,2012-Nov,5280,5094,186,3.5
Ochiltree County,2012-Dec,5212,5025,187,3.6
Ochiltree County,2013-Jan,5279,5058,221,4.2
Ochiltree County,2013-Feb,5292,5077,215,4.1
Ochiltree County,2013-Mar,5256,5059,197,3.7
Ochiltree County,2013-Apr,5384,5193,191,3.5
Ochiltree County,2013-May,5463,5253,210,3.8
Ochiltree County,2013-Jun,5562,5326,236,4.2
Ochiltree County,2013-Jul,5608,5381,227,4
Ochiltree County,2013-Aug,5507,5299,208,3.8
Ochiltree County,2013-Sep,5438,5231,207,3.8
Ochiltree County,2013-Oct,5418,5228,190,3.5
Ochiltree County,2013-Nov,5366,5178,188,3.5
Ochiltree County,2013-Dec,5441,5265,176,3.2
Ochiltree County,2014-Jan,5497,5314,183,3.3
Ochiltree County,2014-Feb,5526,5338,188,3.4
Ochiltree County,2014-Mar,5509,5336,173,3.1
Ochiltree County,2014-Apr,5501,5353,148,2.7
Ochiltree County,2014-May,5585,5418,167,3
Ochiltree County,2014-Jun,5704,5522,182,3.2
Ochiltree County,2014-Jul,5709,5518,191,3.3
Ochiltree County,2014-Aug,5638,5457,181,3.2
Ochiltree County,2014-Sep,5635,5468,167,3
Ochiltree County,2014-Oct,5537,5384,153,2.8
Ochiltree County,2014-Nov,5532,5384,148,2.7
Ochiltree County,2014-Dec,5385,5252,133,2.5
Ochiltree County,2015-Jan,5395,5230,165,3.1
Ochiltree County,2015-Feb,5386,5193,193,3.6
Ochiltree County,2015-Mar,5325,5116,209,3.9
Ochiltree County,2015-Apr,5277,5065,212,4
Ochiltree County,2015-May,5277,5034,243,4.6
Ochiltree County,2015-Jun,5348,5097,251,4.7
Ochiltree County,2015-Jul,5404,5163,241,4.5
Ochiltree County,2015-Aug,5300,5067,233,4.4
Ochiltree County,2015-Sep,5247,5003,244,4.7
Ochiltree County,2015-Oct,5224,4982,242,4.6
Ochiltree County,2015-Nov,5106,4860,246,4.8
Ochiltree County,2015-Dec,4995,4760,235,4.7
Ochiltree County,2016-Jan,4881,4643,238,4.9
Ochiltree County,2016-Feb,4970,4728,242,4.9
Ochiltree County,2016-Mar,4902,4646,256,5.2
Ochiltree County,2016-Apr,4793,4545,248,5.2
Ochiltree County,2016-May,4789,4537,252,5.3
Ochiltree County,2016-Jun,4770,4497,273,5.7
Ochiltree County,2016-Jul,4673,4401,272,5.8
Ochiltree County,2016-Aug,4576,4314,262,5.7
Ochiltree County,2016-Sep,4507,4262,245,5.4
Ochiltree County,2016-Oct,4417,4194,223,5
Ochiltree County,2016-Nov,4354,4137,217,5
Ochiltree County,2016-Dec,4336,4126,210,4.8
Ochiltree County,2017-Jan,4354,4139,215,4.9
Ochiltree County,2017-Feb,4450,4242,208,4.7
Ochiltree County,2017-Mar,4533,4344,189,4.2
Ochiltree County,2017-Apr,4530,4360,170,3.8
Ochiltree County,2017-May,4501,4344,157,3.5
Ochiltree County,2017-Jun,4515,4348,167,3.7
Ochiltree County,2017-Jul,4567,4403,164,3.6
Ochiltree County,2017-Aug,4519,4353,166,3.7
Ochiltree County,2017-Sep,4461,4318,143,3.2
Ochiltree County,2017-Oct,4512,4383,129,2.9
Ochiltree County,2017-Nov,4488,4351,137,3.1
Ochiltree County,2017-Dec,4445,4315,130,2.9
Ochiltree County,2018-Jan,4411,4274,137,3.1
Ochiltree County,2018-Feb,4410,4273,137,3.1
Ochiltree County,2018-Mar,4443,4312,131,2.9
Ochiltree County,2018-Apr,4358,4241,117,2.7
Ochiltree County,2018-May,4410,4295,115,2.6
Ochiltree County,2018-Jun,4447,4310,137,3.1
Ochiltree County,2018-Jul,4493,4362,131,2.9
Ochiltree County,2018-Aug,4465,4344,121,2.7
Ochiltree County,2018-Sep,4463,4344,119,2.7
Ochiltree County,2018-Oct,4404,4293,111,2.5
Ochiltree County,2018-Nov,4348,4235,113,2.6
Ochiltree County,2018-Dec,4293,4179,114,2.7
Ochiltree County,2019-Jan,4277,4153,124,2.9
Ochiltree County,2019-Feb,4312,4199,113,2.6
Ochiltree County,2019-Mar,4303,4190,113,2.6
Ochiltree County,2019-Apr,4243,4148,95,2.2
Ochiltree County,2019-May,4248,4150,98,2.3
Ochiltree County,2019-Jun,4235,4115,120,2.8
Ochiltree County,2019-Jul,4256,4131,125,2.9
Ochiltree County,2019-Aug,4238,4126,112,2.6
Ochiltree County,2019-Sep,4268,4156,112,2.6
Ochiltree County,2019-Oct,4267,4161,106,2.5
Ochiltree County,2019-Nov,4186,4067,119,2.8
Ochiltree County,2019-Dec,4173,4049,124,3
Ochiltree County,2020-Jan,4178,4048,130,3.1
Ochiltree County,2020-Feb,4205,4072,133,3.2
Ochiltree County,2020-Mar,4135,3928,207,5
Ochiltree County,2020-Apr,3824,3561,263,6.9
Ochiltree County,2020-May,3927,3635,292,7.4
Ochiltree County,2020-Jun,4013,3701,312,7.8
Ochiltree County,2020-Jul,4019,3723,296,7.4
Ochiltree County,2020-Aug,3976,3735,241,6.1
Ochiltree County,2020-Sep,3968,3733,235,5.9
Ochiltree County,2020-Oct,3957,3741,216,5.5
Ochiltree County,2020-Nov,3900,3660,240,6.2
Ochiltree County,2020-Dec,3902,3670,232,5.9
Ochiltree County,2021-Jan,3982,3744,238,6
Ochiltree County,2021-Feb,4020,3792,228,5.7
Ochiltree County,2021-Mar,4069,3866,203,5
Ochiltree County,2021-Apr,4001,3824,177,4.4
Ochiltree County,2021-May,3923,3753,170,4.3
Ochiltree County,2021-Jun,3997,3788,209,5.2
Ochiltree County,2021-Jul,3961,3777,184,4.6
Ochiltree County,2021-Aug,3946,3778,168,4.3
Ochiltree County,2021-Sep,3964,3807,157,4
Ochiltree County,2021-Oct,3906,3753,153,3.9
Ochiltree County,2021-Nov,3835,3694,141,3.7
Ochiltree County,2021-Dec,3816,3687,129,3.4
Ochiltree County,2022-Jan,3876,3729,147,3.8
Ochiltree County,2022-Feb,3970,3820,150,3.8
Ochiltree County,2022-Mar,4035,3910,125,3.1
Ochiltree County,2022-Apr,4038,3923,115,2.8
Ochiltree County,2022-May,3962,3841,121,3.1
Ochiltree County,2022-Jun,4010,3869,141,3.5
Ochiltree County,2022-Jul,4050(P),3918(P),132(P),3.3(P)
Oldham County,2012-Jan,934,894,40,4.3
Oldham County,2012-Feb,932,894,38,4.1
Oldham County,2012-Mar,937,900,37,3.9
Oldham County,2012-Apr,949,916,33,3.5
Oldham County,2012-May,951,914,37,3.9
Oldham County,2012-Jun,966,921,45,4.7
Oldham County,2012-Jul,964,920,44,4.6
Oldham County,2012-Aug,945,904,41,4.3
Oldham County,2012-Sep,956,914,42,4.4
Oldham County,2012-Oct,956,915,41,4.3
Oldham County,2012-Nov,952,912,40,4.2
Oldham County,2012-Dec,940,898,42,4.5
Oldham County,2013-Jan,944,894,50,5.3
Oldham County,2013-Feb,948,898,50,5.3
Oldham County,2013-Mar,934,893,41,4.4
Oldham County,2013-Apr,959,920,39,4.1
Oldham County,2013-May,968,928,40,4.1
Oldham County,2013-Jun,976,931,45,4.6
Oldham County,2013-Jul,981,934,47,4.8
Oldham County,2013-Aug,953,914,39,4.1
Oldham County,2013-Sep,964,923,41,4.3
Oldham County,2013-Oct,969,926,43,4.4
Oldham County,2013-Nov,950,909,41,4.3
Oldham County,2013-Dec,956,919,37,3.9
Oldham County,2014-Jan,927,888,39,4.2
Oldham County,2014-Feb,951,907,44,4.6
Oldham County,2014-Mar,945,907,38,4
Oldham County,2014-Apr,955,922,33,3.5
Oldham County,2014-May,957,924,33,3.4
Oldham County,2014-Jun,956,920,36,3.8
Oldham County,2014-Jul,950,913,37,3.9
Oldham County,2014-Aug,930,895,35,3.8
Oldham County,2014-Sep,933,901,32,3.4
Oldham County,2014-Oct,937,905,32,3.4
Oldham County,2014-Nov,925,894,31,3.4
Oldham County,2014-Dec,913,887,26,2.8
Oldham County,2015-Jan,901,873,28,3.1
Oldham County,2015-Feb,922,896,26,2.8
Oldham County,2015-Mar,928,903,25,2.7
Oldham County,2015-Apr,924,899,25,2.7
Oldham County,2015-May,934,905,29,3.1
Oldham County,2015-Jun,925,898,27,2.9
Oldham County,2015-Jul,912,883,29,3.2
Oldham County,2015-Aug,900,871,29,3.2
Oldham County,2015-Sep,910,880,30,3.3
Oldham County,2015-Oct,912,883,29,3.2
Oldham County,2015-Nov,897,873,24,2.7
Oldham County,2015-Dec,905,881,24,2.7
Oldham County,2016-Jan,884,859,25,2.8
Oldham County,2016-Feb,919,894,25,2.7
Oldham County,2016-Mar,928,903,25,2.7
Oldham County,2016-Apr,931,906,25,2.7
Oldham County,2016-May,942,915,27,2.9
Oldham County,2016-Jun,919,892,27,2.9
Oldham County,2016-Jul,898,869,29,3.2
Oldham County,2016-Aug,904,876,28,3.1
Oldham County,2016-Sep,900,868,32,3.6
Oldham County,2016-Oct,894,866,28,3.1
Oldham County,2016-Nov,893,866,27,3
Oldham County,2016-Dec,891,862,29,3.3
Oldham County,2017-Jan,875,851,24,2.7
Oldham County,2017-Feb,895,870,25,2.8
Oldham County,2017-Mar,919,895,24,2.6
Oldham County,2017-Apr,918,897,21,2.3
Oldham County,2017-May,918,894,24,2.6
Oldham County,2017-Jun,903,879,24,2.7
Oldham County,2017-Jul,880,856,24,2.7
Oldham County,2017-Aug,887,864,23,2.6
Oldham County,2017-Sep,884,861,23,2.6
Oldham County,2017-Oct,893,874,19,2.1
Oldham County,2017-Nov,885,863,22,2.5
Oldham County,2017-Dec,883,863,20,2.3
Oldham County,2018-Jan,874,852,22,2.5
Oldham County,2018-Feb,895,872,23,2.6
Oldham County,2018-Mar,917,892,25,2.7
Oldham County,2018-Apr,902,881,21,2.3
Oldham County,2018-May,918,895,23,2.5
Oldham County,2018-Jun,902,878,24,2.7
Oldham County,2018-Jul,892,868,24,2.7
Oldham County,2018-Aug,903,878,25,2.8
Oldham County,2018-Sep,899,874,25,2.8
Oldham County,2018-Oct,893,869,24,2.7
Oldham County,2018-Nov,891,866,25,2.8
Oldham County,2018-Dec,878,854,24,2.7
Oldham County,2019-Jan,870,842,28,3.2
Oldham County,2019-Feb,890,864,26,2.9
Oldham County,2019-Mar,904,878,26,2.9
Oldham County,2019-Apr,901,878,23,2.6
Oldham County,2019-May,908,885,23,2.5
Oldham County,2019-Jun,902,873,29,3.2
Oldham County,2019-Jul,899,870,29,3.2
Oldham County,2019-Aug,915,886,29,3.2
Oldham County,2019-Sep,898,873,25,2.8
Oldham County,2019-Oct,909,888,21,2.3
Oldham County,2019-Nov,899,873,26,2.9
Oldham County,2019-Dec,900,876,24,2.7
Oldham County,2020-Jan,906,878,28,3.1
Oldham County,2020-Feb,914,887,27,3
Oldham County,2020-Mar,898,863,35,3.9
Oldham County,2020-Apr,819,774,45,5.5
Oldham County,2020-May,856,814,42,4.9
Oldham County,2020-Jun,868,831,37,4.3
Oldham County,2020-Jul,876,840,36,4.1
Oldham County,2020-Aug,899,870,29,3.2
Oldham County,2020-Sep,894,862,32,3.6
Oldham County,2020-Oct,916,884,32,3.5
Oldham County,2020-Nov,899,866,33,3.7
Oldham County,2020-Dec,908,865,43,4.7
Oldham County,2021-Jan,918,874,44,4.8
Oldham County,2021-Feb,929,892,37,4
Oldham County,2021-Mar,945,908,37,3.9
Oldham County,2021-Apr,931,901,30,3.2
Oldham County,2021-May,917,887,30,3.3
Oldham County,2021-Jun,910,876,34,3.7
Oldham County,2021-Jul,904,874,30,3.3
Oldham County,2021-Aug,913,883,30,3.3
Oldham County,2021-Sep,915,883,32,3.5
Oldham County,2021-Oct,915,886,29,3.2
Oldham County,2021-Nov,906,877,29,3.2
Oldham County,2021-Dec,902,877,25,2.8
Oldham County,2022-Jan,906,879,27,3
Oldham County,2022-Feb,948,917,31,3.3
Oldham County,2022-Mar,969,943,26,2.7
Oldham County,2022-Apr,958,933,25,2.6
Oldham County,2022-May,937,911,26,2.8
Oldham County,2022-Jun,923,897,26,2.8
Oldham County,2022-Jul,947(P),921(P),26(P),2.7(P)
Orange County,2012-Jan,39218,35052,4166,10.6
Orange County,2012-Feb,39276,35257,4019,10.2
Orange County,2012-Mar,38997,35212,3785,9.7
Orange County,2012-Apr,39026,35430,3596,9.2
Orange County,2012-May,39041,35169,3872,9.9
Orange County,2012-Jun,39178,34776,4402,11.2
Orange County,2012-Jul,38815,34399,4416,11.4
Orange County,2012-Aug,38358,34161,4197,10.9
Orange County,2012-Sep,38426,34419,4007,10.4
Orange County,2012-Oct,38456,34582,3874,10.1
Orange County,2012-Nov,38184,34350,3834,10
Orange County,2012-Dec,38382,34177,4205,11
Orange County,2013-Jan,38320,33838,4482,11.7
Orange County,2013-Feb,38445,34317,4128,10.7
Orange County,2013-Mar,38300,34284,4016,10.5
Orange County,2013-Apr,38119,34245,3874,10.2
Orange County,2013-May,38116,34204,3912,10.3
Orange County,2013-Jun,38127,33921,4206,11
Orange County,2013-Jul,37643,33549,4094,10.9
Orange County,2013-Aug,37517,33448,4069,10.8
Orange County,2013-Sep,37571,33676,3895,10.4
Orange County,2013-Oct,37523,33773,3750,10
Orange County,2013-Nov,37708,34023,3685,9.8
Orange County,2013-Dec,37594,34004,3590,9.5
Orange County,2014-Jan,37670,33967,3703,9.8
Orange County,2014-Feb,37847,34288,3559,9.4
Orange County,2014-Mar,37796,34464,3332,8.8
Orange County,2014-Apr,37741,34842,2899,7.7
Orange County,2014-May,37877,34997,2880,7.6
Orange County,2014-Jun,37835,34765,3070,8.1
Orange County,2014-Jul,37938,34680,3258,8.6
Orange County,2014-Aug,37857,34628,3229,8.5
Orange County,2014-Sep,37870,34942,2928,7.7
Orange County,2014-Oct,38070,35431,2639,6.9
Orange County,2014-Nov,37988,35324,2664,7
Orange County,2014-Dec,37768,35218,2550,6.8
Orange County,2015-Jan,37648,34879,2769,7.4
Orange County,2015-Feb,37661,35163,2498,6.6
Orange County,2015-Mar,37261,34937,2324,6.2
Orange County,2015-Apr,37106,34898,2208,6
Orange County,2015-May,37378,35057,2321,6.2
Orange County,2015-Jun,37294,34830,2464,6.6
Orange County,2015-Jul,37124,34555,2569,6.9
Orange County,2015-Aug,36940,34440,2500,6.8
Orange County,2015-Sep,37007,34581,2426,6.6
Orange County,2015-Oct,36952,34556,2396,6.5
Orange County,2015-Nov,37025,34505,2520,6.8
Orange County,2015-Dec,37069,34661,2408,6.5
Orange County,2016-Jan,37507,35041,2466,6.6
Orange County,2016-Feb,37642,35294,2348,6.2
Orange County,2016-Mar,37525,35132,2393,6.4
Orange County,2016-Apr,37346,35073,2273,6.1
Orange County,2016-May,37093,34779,2314,6.2
Orange County,2016-Jun,37341,34743,2598,7
Orange County,2016-Jul,37256,34557,2699,7.2
Orange County,2016-Aug,37209,34475,2734,7.3
Orange County,2016-Sep,37501,34822,2679,7.1
Orange County,2016-Oct,37393,34997,2396,6.4
Orange County,2016-Nov,37347,34814,2533,6.8
Orange County,2016-Dec,37255,34581,2674,7.2
Orange County,2017-Jan,37067,34123,2944,7.9
Orange County,2017-Feb,37361,34566,2795,7.5
Orange County,2017-Mar,37155,34640,2515,6.8
Orange County,2017-Apr,37042,34645,2397,6.5
Orange County,2017-May,36771,34446,2325,6.3
Orange County,2017-Jun,36857,34381,2476,6.7
Orange County,2017-Jul,36788,34365,2423,6.6
Orange County,2017-Aug,36384,33946,2438,6.7
Orange County,2017-Sep,37135,33939,3196,8.6
Orange County,2017-Oct,36674,34221,2453,6.7
Orange County,2017-Nov,36695,34275,2420,6.6
Orange County,2017-Dec,36598,34127,2471,6.8
Orange County,2018-Jan,36455,33806,2649,7.3
Orange County,2018-Feb,36713,34270,2443,6.7
Orange County,2018-Mar,36302,34023,2279,6.3
Orange County,2018-Apr,36292,34176,2116,5.8
Orange County,2018-May,36167,34186,1981,5.5
Orange County,2018-Jun,36279,34149,2130,5.9
Orange County,2018-Jul,36075,33949,2126,5.9
Orange County,2018-Aug,35881,33789,2092,5.8
Orange County,2018-Sep,36011,34037,1974,5.5
Orange County,2018-Oct,35947,34164,1783,5
Orange County,2018-Nov,36037,34245,1792,5
Orange County,2018-Dec,35957,34007,1950,5.4
Orange County,2019-Jan,36151,33931,2220,6.1
Orange County,2019-Feb,36257,34320,1937,5.3
Orange County,2019-Mar,36059,34283,1776,4.9
Orange County,2019-Apr,35832,34264,1568,4.4
Orange County,2019-May,35707,34085,1622,4.5
Orange County,2019-Jun,35865,33898,1967,5.5
Orange County,2019-Jul,35835,33748,2087,5.8
Orange County,2019-Aug,35818,33802,2016,5.6
Orange County,2019-Sep,36048,34192,1856,5.1
Orange County,2019-Oct,36168,34461,1707,4.7
Orange County,2019-Nov,36283,34488,1795,4.9
Orange County,2019-Dec,36119,34334,1785,4.9
Orange County,2020-Jan,35939,34004,1935,5.4
Orange County,2020-Feb,36130,34409,1721,4.8
Orange County,2020-Mar,35846,33061,2785,7.8
Orange County,2020-Apr,34467,28966,5501,16
Orange County,2020-May,35357,29801,5556,15.7
Orange County,2020-Jun,35426,30453,4973,14
Orange County,2020-Jul,35377,30732,4645,13.1
Orange County,2020-Aug,35262,31477,3785,10.7
Orange County,2020-Sep,35448,31594,3854,10.9
Orange County,2020-Oct,35288,31988,3300,9.4
Orange County,2020-Nov,35653,32206,3447,9.7
Orange County,2020-Dec,35509,31952,3557,10
Orange County,2021-Jan,35240,31425,3815,10.8
Orange County,2021-Feb,35189,31525,3664,10.4
Orange County,2021-Mar,35096,31794,3302,9.4
Orange County,2021-Apr,34966,31756,3210,9.2
Orange County,2021-May,34740,31555,3185,9.2
Orange County,2021-Jun,34859,31367,3492,10
Orange County,2021-Jul,34778,31463,3315,9.5
Orange County,2021-Aug,34669,31558,3111,9
Orange County,2021-Sep,34576,31738,2838,8.2
Orange County,2021-Oct,34577,31922,2655,7.7
Orange County,2021-Nov,34807,32216,2591,7.4
Orange County,2021-Dec,34795,32309,2486,7.1
Orange County,2022-Jan,35069,32282,2787,7.9
Orange County,2022-Feb,35268,32579,2689,7.6
Orange County,2022-Mar,35004,32776,2228,6.4
Orange County,2022-Apr,34751,32656,2095,6
Orange County,2022-May,34747,32593,2154,6.2
Orange County,2022-Jun,34978,32545,2433,7
Orange County,2022-Jul,34826(P),32407(P),2419(P),6.9(P)
Palo Pinto County,2012-Jan,13167,12202,965,7.3
Palo Pinto County,2012-Feb,13207,12265,942,7.1
Palo Pinto County,2012-Mar,13186,12310,876,6.6
Palo Pinto County,2012-Apr,13266,12438,828,6.2
Palo Pinto County,2012-May,13362,12475,887,6.6
Palo Pinto County,2012-Jun,13646,12664,982,7.2
Palo Pinto County,2012-Jul,13698,12732,966,7.1
Palo Pinto County,2012-Aug,13553,12654,899,6.6
Palo Pinto County,2012-Sep,13484,12623,861,6.4
Palo Pinto County,2012-Oct,13400,12550,850,6.3
Palo Pinto County,2012-Nov,13351,12511,840,6.3
Palo Pinto County,2012-Dec,13307,12449,858,6.4
Palo Pinto County,2013-Jan,13122,12179,943,7.2
Palo Pinto County,2013-Feb,13267,12320,947,7.1
Palo Pinto County,2013-Mar,13217,12328,889,6.7
Palo Pinto County,2013-Apr,13351,12525,826,6.2
Palo Pinto County,2013-May,13477,12616,861,6.4
Palo Pinto County,2013-Jun,13647,12699,948,6.9
Palo Pinto County,2013-Jul,13540,12634,906,6.7
Palo Pinto County,2013-Aug,13486,12632,854,6.3
Palo Pinto County,2013-Sep,13562,12654,908,6.7
Palo Pinto County,2013-Oct,13282,12402,880,6.6
Palo Pinto County,2013-Nov,13229,12400,829,6.3
Palo Pinto County,2013-Dec,13127,12348,779,5.9
Palo Pinto County,2014-Jan,13193,12391,802,6.1
Palo Pinto County,2014-Feb,13318,12512,806,6.1
Palo Pinto County,2014-Mar,13384,12612,772,5.8
Palo Pinto County,2014-Apr,13427,12756,671,5
Palo Pinto County,2014-May,13437,12744,693,5.2
Palo Pinto County,2014-Jun,13506,12777,729,5.4
Palo Pinto County,2014-Jul,13545,12799,746,5.5
Palo Pinto County,2014-Aug,13457,12769,688,5.1
Palo Pinto County,2014-Sep,13417,12764,653,4.9
Palo Pinto County,2014-Oct,13343,12726,617,4.6
Palo Pinto County,2014-Nov,13224,12610,614,4.6
Palo Pinto County,2014-Dec,13030,12460,570,4.4
Palo Pinto County,2015-Jan,12926,12286,640,5
Palo Pinto County,2015-Feb,13039,12373,666,5.1
Palo Pinto County,2015-Mar,13056,12412,644,4.9
Palo Pinto County,2015-Apr,13103,12474,629,4.8
Palo Pinto County,2015-May,13171,12482,689,5.2
Palo Pinto County,2015-Jun,13243,12523,720,5.4
Palo Pinto County,2015-Jul,13292,12561,731,5.5
Palo Pinto County,2015-Aug,13214,12519,695,5.3
Palo Pinto County,2015-Sep,13183,12494,689,5.2
Palo Pinto County,2015-Oct,13249,12543,706,5.3
Palo Pinto County,2015-Nov,13302,12548,754,5.7
Palo Pinto County,2015-Dec,13290,12567,723,5.4
Palo Pinto County,2016-Jan,13243,12490,753,5.7
Palo Pinto County,2016-Feb,13384,12642,742,5.5
Palo Pinto County,2016-Mar,13420,12651,769,5.7
Palo Pinto County,2016-Apr,13416,12685,731,5.4
Palo Pinto County,2016-May,13380,12687,693,5.2
Palo Pinto County,2016-Jun,13446,12681,765,5.7
Palo Pinto County,2016-Jul,13266,12489,777,5.9
Palo Pinto County,2016-Aug,13248,12493,755,5.7
Palo Pinto County,2016-Sep,13249,12520,729,5.5
Palo Pinto County,2016-Oct,13030,12358,672,5.2
Palo Pinto County,2016-Nov,13011,12348,663,5.1
Palo Pinto County,2016-Dec,12980,12320,660,5.1
Palo Pinto County,2017-Jan,12930,12258,672,5.2
Palo Pinto County,2017-Feb,13132,12450,682,5.2
Palo Pinto County,2017-Mar,13175,12567,608,4.6
Palo Pinto County,2017-Apr,13245,12709,536,4
Palo Pinto County,2017-May,13364,12833,531,4
Palo Pinto County,2017-Jun,13502,12943,559,4.1
Palo Pinto County,2017-Jul,13509,12947,562,4.2
Palo Pinto County,2017-Aug,13447,12904,543,4
Palo Pinto County,2017-Sep,13466,12956,510,3.8
Palo Pinto County,2017-Oct,13308,12843,465,3.5
Palo Pinto County,2017-Nov,13290,12809,481,3.6
Palo Pinto County,2017-Dec,13244,12794,450,3.4
Palo Pinto County,2018-Jan,13149,12645,504,3.8
Palo Pinto County,2018-Feb,13296,12794,502,3.8
Palo Pinto County,2018-Mar,13407,12929,478,3.6
Palo Pinto County,2018-Apr,13332,12917,415,3.1
Palo Pinto County,2018-May,13315,12905,410,3.1
Palo Pinto County,2018-Jun,13521,13026,495,3.7
Palo Pinto County,2018-Jul,13520,13051,469,3.5
Palo Pinto County,2018-Aug,13391,12947,444,3.3
Palo Pinto County,2018-Sep,13410,12975,435,3.2
Palo Pinto County,2018-Oct,13364,12956,408,3.1
Palo Pinto County,2018-Nov,13406,12976,430,3.2
Palo Pinto County,2018-Dec,13347,12918,429,3.2
Palo Pinto County,2019-Jan,13269,12776,493,3.7
Palo Pinto County,2019-Feb,13373,12906,467,3.5
Palo Pinto County,2019-Mar,13441,12994,447,3.3
Palo Pinto County,2019-Apr,13355,12992,363,2.7
Palo Pinto County,2019-May,13473,13082,391,2.9
Palo Pinto County,2019-Jun,13561,13101,460,3.4
Palo Pinto County,2019-Jul,13557,13083,474,3.5
Palo Pinto County,2019-Aug,13442,13001,441,3.3
Palo Pinto County,2019-Sep,13433,13019,414,3.1
Palo Pinto County,2019-Oct,13417,13029,388,2.9
Palo Pinto County,2019-Nov,13347,12956,391,2.9
Palo Pinto County,2019-Dec,13302,12939,363,2.7
Palo Pinto County,2020-Jan,13209,12788,421,3.2
Palo Pinto County,2020-Feb,13278,12883,395,3
Palo Pinto County,2020-Mar,13128,12510,618,4.7
Palo Pinto County,2020-Apr,12560,11364,1196,9.5
Palo Pinto County,2020-May,12942,11649,1293,10
Palo Pinto County,2020-Jun,13199,11937,1262,9.6
Palo Pinto County,2020-Jul,13146,11961,1185,9
Palo Pinto County,2020-Aug,13158,12171,987,7.5
Palo Pinto County,2020-Sep,13046,12067,979,7.5
Palo Pinto County,2020-Oct,13162,12298,864,6.6
Palo Pinto County,2020-Nov,13086,12164,922,7
Palo Pinto County,2020-Dec,13056,12143,913,7
Palo Pinto County,2021-Jan,12862,11896,966,7.5
Palo Pinto County,2021-Feb,12949,12014,935,7.2
Palo Pinto County,2021-Mar,13051,12189,862,6.6
Palo Pinto County,2021-Apr,12929,12162,767,5.9
Palo Pinto County,2021-May,12878,12143,735,5.7
Palo Pinto County,2021-Jun,13064,12245,819,6.3
Palo Pinto County,2021-Jul,12956,12228,728,5.6
Palo Pinto County,2021-Aug,12922,12221,701,5.4
Palo Pinto County,2021-Sep,12850,12209,641,5
Palo Pinto County,2021-Oct,12840,12229,611,4.8
Palo Pinto County,2021-Nov,12798,12206,592,4.6
Palo Pinto County,2021-Dec,12725,12192,533,4.2
Palo Pinto County,2022-Jan,12572,11959,613,4.9
Palo Pinto County,2022-Feb,12779,12163,616,4.8
Palo Pinto County,2022-Mar,12931,12426,505,3.9
Palo Pinto County,2022-Apr,12662,12208,454,3.6
Palo Pinto County,2022-May,12674,12198,476,3.8
Palo Pinto County,2022-Jun,12776,12241,535,4.2
Palo Pinto County,2022-Jul,12910(P),12381(P),529(P),4.1(P)
Panola County,2012-Jan,12091,11181,910,7.5
Panola County,2012-Feb,12084,11213,871,7.2
Panola County,2012-Mar,12032,11211,821,6.8
Panola County,2012-Apr,12227,11459,768,6.3
Panola County,2012-May,12201,11392,809,6.6
Panola County,2012-Jun,12247,11337,910,7.4
Panola County,2012-Jul,12426,11525,901,7.3
Panola County,2012-Aug,12336,11472,864,7
Panola County,2012-Sep,12452,11659,793,6.4
Panola County,2012-Oct,12510,11727,783,6.3
Panola County,2012-Nov,12441,11652,789,6.3
Panola County,2012-Dec,12455,11618,837,6.7
Panola County,2013-Jan,12692,11791,901,7.1
Panola County,2013-Feb,12652,11802,850,6.7
Panola County,2013-Mar,12497,11702,795,6.4
Panola County,2013-Apr,12624,11858,766,6.1
Panola County,2013-May,12625,11852,773,6.1
Panola County,2013-Jun,12727,11860,867,6.8
Panola County,2013-Jul,12902,12066,836,6.5
Panola County,2013-Aug,12935,12144,791,6.1
Panola County,2013-Sep,12913,12138,775,6
Panola County,2013-Oct,12720,11969,751,5.9
Panola County,2013-Nov,12716,11987,729,5.7
Panola County,2013-Dec,12674,11994,680,5.4
Panola County,2014-Jan,12574,11884,690,5.5
Panola County,2014-Feb,12756,12058,698,5.5
Panola County,2014-Mar,12905,12241,664,5.1
Panola County,2014-Apr,12637,12063,574,4.5
Panola County,2014-May,12673,12035,638,5
Panola County,2014-Jun,12760,12081,679,5.3
Panola County,2014-Jul,12823,12142,681,5.3
Panola County,2014-Aug,12708,12042,666,5.2
Panola County,2014-Sep,12625,12019,606,4.8
Panola County,2014-Oct,12249,11672,577,4.7
Panola County,2014-Nov,11991,11439,552,4.6
Panola County,2014-Dec,11785,11279,506,4.3
Panola County,2015-Jan,12156,11585,571,4.7
Panola County,2015-Feb,12117,11569,548,4.5
Panola County,2015-Mar,12017,11489,528,4.4
Panola County,2015-Apr,12065,11510,555,4.6
Panola County,2015-May,12035,11440,595,4.9
Panola County,2015-Jun,11766,11124,642,5.5
Panola County,2015-Jul,11720,11053,667,5.7
Panola County,2015-Aug,11523,10884,639,5.5
Panola County,2015-Sep,11380,10736,644,5.7
Panola County,2015-Oct,10886,10248,638,5.9
Panola County,2015-Nov,10697,10044,653,6.1
Panola County,2015-Dec,10532,9903,629,6
Panola County,2016-Jan,10313,9642,671,6.5
Panola County,2016-Feb,10350,9665,685,6.6
Panola County,2016-Mar,10426,9698,728,7
Panola County,2016-Apr,10181,9463,718,7.1
Panola County,2016-May,10166,9452,714,7
Panola County,2016-Jun,10122,9291,831,8.2
Panola County,2016-Jul,10188,9374,814,8
Panola County,2016-Aug,10203,9408,795,7.8
Panola County,2016-Sep,10221,9452,769,7.5
Panola County,2016-Oct,10240,9532,708,6.9
Panola County,2016-Nov,10175,9479,696,6.8
Panola County,2016-Dec,10229,9542,687,6.7
Panola County,2017-Jan,10023,9294,729,7.3
Panola County,2017-Feb,10435,9733,702,6.7
Panola County,2017-Mar,10588,9949,639,6
Panola County,2017-Apr,10265,9704,561,5.5
Panola County,2017-May,10197,9652,545,5.3
Panola County,2017-Jun,10225,9622,603,5.9
Panola County,2017-Jul,10259,9686,573,5.6
Panola County,2017-Aug,10430,9847,583,5.6
Panola County,2017-Sep,10416,9933,483,4.6
Panola County,2017-Oct,10426,9985,441,4.2
Panola County,2017-Nov,10355,9891,464,4.5
Panola County,2017-Dec,10352,9894,458,4.4
Panola County,2018-Jan,10533,10017,516,4.9
Panola County,2018-Feb,10799,10305,494,4.6
Panola County,2018-Mar,10813,10336,477,4.4
Panola County,2018-Apr,10541,10100,441,4.2
Panola County,2018-May,10289,9863,426,4.1
Panola County,2018-Jun,10212,9698,514,5
Panola County,2018-Jul,10349,9874,475,4.6
Panola County,2018-Aug,10542,10098,444,4.2
Panola County,2018-Sep,10654,10241,413,3.9
Panola County,2018-Oct,10636,10247,389,3.7
Panola County,2018-Nov,10914,10528,386,3.5
Panola County,2018-Dec,10886,10505,381,3.5
Panola County,2019-Jan,10426,9981,445,4.3
Panola County,2019-Feb,10330,9902,428,4.1
Panola County,2019-Mar,10349,9933,416,4
Panola County,2019-Apr,10098,9765,333,3.3
Panola County,2019-May,9917,9562,355,3.6
Panola County,2019-Jun,9968,9541,427,4.3
Panola County,2019-Jul,9974,9525,449,4.5
Panola County,2019-Aug,9946,9528,418,4.2
Panola County,2019-Sep,9917,9513,404,4.1
Panola County,2019-Oct,9808,9415,393,4
Panola County,2019-Nov,9691,9284,407,4.2
Panola County,2019-Dec,9558,9173,385,4
Panola County,2020-Jan,9539,9079,460,4.8
Panola County,2020-Feb,9470,9032,438,4.6
Panola County,2020-Mar,9440,8776,664,7
Panola County,2020-Apr,9028,8152,876,9.7
Panola County,2020-May,9348,8320,1028,11
Panola County,2020-Jun,9392,8373,1019,10.8
Panola County,2020-Jul,9401,8424,977,10.4
Panola County,2020-Aug,9350,8509,841,9
Panola County,2020-Sep,9300,8481,819,8.8
Panola County,2020-Oct,9255,8525,730,7.9
Panola County,2020-Nov,9301,8519,782,8.4
Panola County,2020-Dec,9233,8454,779,8.4
Panola County,2021-Jan,9591,8785,806,8.4
Panola County,2021-Feb,9657,8884,773,8
Panola County,2021-Mar,9648,8932,716,7.4
Panola County,2021-Apr,9545,8889,656,6.9
Panola County,2021-May,9709,9039,670,6.9
Panola County,2021-Jun,9725,8985,740,7.6
Panola County,2021-Jul,9812,9148,664,6.8
Panola County,2021-Aug,9790,9168,622,6.4
Panola County,2021-Sep,9784,9208,576,5.9
Panola County,2021-Oct,9691,9135,556,5.7
Panola County,2021-Nov,9718,9175,543,5.6
Panola County,2021-Dec,9628,9133,495,5.1
Panola County,2022-Jan,9851,9274,577,5.9
Panola County,2022-Feb,9852,9270,582,5.9
Panola County,2022-Mar,9871,9399,472,4.8
Panola County,2022-Apr,9585,9156,429,4.5
Panola County,2022-May,9680,9222,458,4.7
Panola County,2022-Jun,9630,9108,522,5.4
Panola County,2022-Jul,9746(P),9235(P),511(P),5.2(P)
Parker County,2012-Jan,56964,53354,3610,6.3
Parker County,2012-Feb,57259,53694,3565,6.2
Parker County,2012-Mar,57348,53960,3388,5.9
Parker County,2012-Apr,57450,54258,3192,5.6
Parker County,2012-May,57753,54357,3396,5.9
Parker County,2012-Jun,58256,54456,3800,6.5
Parker County,2012-Jul,58157,54392,3765,6.5
Parker County,2012-Aug,57846,54372,3474,6
Parker County,2012-Sep,57981,54739,3242,5.6
Parker County,2012-Oct,58048,54868,3180,5.5
Parker County,2012-Nov,58171,55042,3129,5.4
Parker County,2012-Dec,58166,55021,3145,5.4
Parker County,2013-Jan,57833,54256,3577,6.2
Parker County,2013-Feb,58008,54621,3387,5.8
Parker County,2013-Mar,58007,54717,3290,5.7
Parker County,2013-Apr,58343,55246,3097,5.3
Parker County,2013-May,58721,55450,3271,5.6
Parker County,2013-Jun,59021,55419,3602,6.1
Parker County,2013-Jul,59027,55525,3502,5.9
Parker County,2013-Aug,58762,55488,3274,5.6
Parker County,2013-Sep,58970,55725,3245,5.5
Parker County,2013-Oct,58475,55359,3116,5.3
Parker County,2013-Nov,58836,55824,3012,5.1
Parker County,2013-Dec,58783,55945,2838,4.8
Parker County,2014-Jan,58139,55166,2973,5.1
Parker County,2014-Feb,58654,55635,3019,5.1
Parker County,2014-Mar,58920,55993,2927,5
Parker County,2014-Apr,58816,56317,2499,4.2
Parker County,2014-May,59141,56400,2741,4.6
Parker County,2014-Jun,59410,56454,2956,5
Parker County,2014-Jul,59379,56356,3023,5.1
Parker County,2014-Aug,59101,56238,2863,4.8
Parker County,2014-Sep,59137,56482,2655,4.5
Parker County,2014-Oct,59205,56734,2471,4.2
Parker County,2014-Nov,59260,56830,2430,4.1
Parker County,2014-Dec,59053,56846,2207,3.7
Parker County,2015-Jan,58966,56433,2533,4.3
Parker County,2015-Feb,59087,56630,2457,4.2
Parker County,2015-Mar,59043,56635,2408,4.1
Parker County,2015-Apr,59456,57144,2312,3.9
Parker County,2015-May,59842,57360,2482,4.1
Parker County,2015-Jun,59821,57141,2680,4.5
Parker County,2015-Jul,59816,57102,2714,4.5
Parker County,2015-Aug,59655,57107,2548,4.3
Parker County,2015-Sep,59603,57073,2530,4.2
Parker County,2015-Oct,59775,57283,2492,4.2
Parker County,2015-Nov,59940,57498,2442,4.1
Parker County,2015-Dec,60067,57737,2330,3.9
Parker County,2016-Jan,60178,57694,2484,4.1
Parker County,2016-Feb,60840,58367,2473,4.1
Parker County,2016-Mar,61039,58525,2514,4.1
Parker County,2016-Apr,61148,58826,2322,3.8
Parker County,2016-May,61236,58921,2315,3.8
Parker County,2016-Jun,61405,58756,2649,4.3
Parker County,2016-Jul,61578,58856,2722,4.4
Parker County,2016-Aug,61534,58909,2625,4.3
Parker County,2016-Sep,61621,59005,2616,4.2
Parker County,2016-Oct,61462,58985,2477,4
Parker County,2016-Nov,61784,59394,2390,3.9
Parker County,2016-Dec,61738,59341,2397,3.9
Parker County,2017-Jan,61856,59311,2545,4.1
Parker County,2017-Feb,62274,59707,2567,4.1
Parker County,2017-Mar,62458,60105,2353,3.8
Parker County,2017-Apr,62552,60441,2111,3.4
Parker County,2017-May,62430,60290,2140,3.4
Parker County,2017-Jun,62732,60437,2295,3.7
Parker County,2017-Jul,62965,60661,2304,3.7
Parker County,2017-Aug,63011,60743,2268,3.6
Parker County,2017-Sep,63238,61197,2041,3.2
Parker County,2017-Oct,62975,61129,1846,2.9
Parker County,2017-Nov,63396,61416,1980,3.1
Parker County,2017-Dec,63251,61374,1877,3
Parker County,2018-Jan,64285,62155,2130,3.3
Parker County,2018-Feb,64979,62824,2155,3.3
Parker County,2018-Mar,65019,62908,2111,3.2
Parker County,2018-Apr,65094,63200,1894,2.9
Parker County,2018-May,65168,63284,1884,2.9
Parker County,2018-Jun,65514,63270,2244,3.4
Parker County,2018-Jul,65581,63416,2165,3.3
Parker County,2018-Aug,65291,63193,2098,3.2
Parker County,2018-Sep,65437,63430,2007,3.1
Parker County,2018-Oct,65660,63736,1924,2.9
Parker County,2018-Nov,65822,63897,1925,2.9
Parker County,2018-Dec,65881,63935,1946,3
Parker County,2019-Jan,67042,64757,2285,3.4
Parker County,2019-Feb,67454,65318,2136,3.2
Parker County,2019-Mar,67412,65413,1999,3
Parker County,2019-Apr,67095,65417,1678,2.5
Parker County,2019-May,67222,65494,1728,2.6
Parker County,2019-Jun,67728,65608,2120,3.1
Parker County,2019-Jul,68066,65906,2160,3.2
Parker County,2019-Aug,68104,66046,2058,3
Parker County,2019-Sep,68335,66389,1946,2.8
Parker County,2019-Oct,68648,66744,1904,2.8
Parker County,2019-Nov,69014,67107,1907,2.8
Parker County,2019-Dec,68948,67163,1785,2.6
Parker County,2020-Jan,70279,68162,2117,3
Parker County,2020-Feb,70739,68701,2038,2.9
Parker County,2020-Mar,69451,66306,3145,4.5
Parker County,2020-Apr,64102,58173,5929,9.2
Parker County,2020-May,66380,60515,5865,8.8
Parker County,2020-Jun,68109,62692,5417,8
Parker County,2020-Jul,68770,63793,4977,7.2
Parker County,2020-Aug,69286,65300,3986,5.8
Parker County,2020-Sep,69438,65540,3898,5.6
Parker County,2020-Oct,70596,67102,3494,4.9
Parker County,2020-Nov,70744,67111,3633,5.1
Parker County,2020-Dec,70930,67254,3676,5.2
Parker County,2021-Jan,70559,66646,3913,5.5
Parker County,2021-Feb,70950,67066,3884,5.5
Parker County,2021-Mar,71201,67563,3638,5.1
Parker County,2021-Apr,70976,67782,3194,4.5
Parker County,2021-May,70884,67776,3108,4.4
Parker County,2021-Jun,71326,67812,3514,4.9
Parker County,2021-Jul,71531,68353,3178,4.4
Parker County,2021-Aug,71673,68644,3029,4.2
Parker County,2021-Sep,71849,68973,2876,4
Parker County,2021-Oct,72255,69497,2758,3.8
Parker County,2021-Nov,72952,70358,2594,3.6
Parker County,2021-Dec,72867,70487,2380,3.3
Parker County,2022-Jan,72552,69848,2704,3.7
Parker County,2022-Feb,73638,70899,2739,3.7
Parker County,2022-Mar,73953,71730,2223,3
Parker County,2022-Apr,73564,71498,2066,2.8
Parker County,2022-May,73729,71525,2204,3
Parker County,2022-Jun,73832,71297,2535,3.4
Parker County,2022-Jul,74302(P),71826(P),2476(P),3.3(P)
Parmer County,2012-Jan,4987,4772,215,4.3
Parmer County,2012-Feb,4923,4721,202,4.1
Parmer County,2012-Mar,4911,4722,189,3.8
Parmer County,2012-Apr,4991,4811,180,3.6
Parmer County,2012-May,5022,4824,198,3.9
Parmer County,2012-Jun,5128,4893,235,4.6
Parmer County,2012-Jul,5119,4879,240,4.7
Parmer County,2012-Aug,5041,4825,216,4.3
Parmer County,2012-Sep,5065,4867,198,3.9
Parmer County,2012-Oct,4954,4760,194,3.9
Parmer County,2012-Nov,4935,4747,188,3.8
Parmer County,2012-Dec,4847,4657,190,3.9
Parmer County,2013-Jan,4826,4612,214,4.4
Parmer County,2013-Feb,4871,4673,198,4.1
Parmer County,2013-Mar,4837,4651,186,3.8
Parmer County,2013-Apr,4996,4818,178,3.6
Parmer County,2013-May,5162,4965,197,3.8
Parmer County,2013-Jun,5213,4985,228,4.4
Parmer County,2013-Jul,5259,5041,218,4.1
Parmer County,2013-Aug,5124,4924,200,3.9
Parmer County,2013-Sep,5207,5000,207,4
Parmer County,2013-Oct,5135,4945,190,3.7
Parmer County,2013-Nov,4997,4814,183,3.7
Parmer County,2013-Dec,5054,4884,170,3.4
Parmer County,2014-Jan,5023,4849,174,3.5
Parmer County,2014-Feb,5173,4997,176,3.4
Parmer County,2014-Mar,5147,4977,170,3.3
Parmer County,2014-Apr,5185,5043,142,2.7
Parmer County,2014-May,5225,5065,160,3.1
Parmer County,2014-Jun,5253,5073,180,3.4
Parmer County,2014-Jul,5200,5014,186,3.6
Parmer County,2014-Aug,5101,4935,166,3.3
Parmer County,2014-Sep,5124,4969,155,3
Parmer County,2014-Oct,5084,4943,141,2.8
Parmer County,2014-Nov,4985,4851,134,2.7
Parmer County,2014-Dec,4923,4805,118,2.4
Parmer County,2015-Jan,4906,4773,133,2.7
Parmer County,2015-Feb,5010,4888,122,2.4
Parmer County,2015-Mar,5033,4923,110,2.2
Parmer County,2015-Apr,4970,4867,103,2.1
Parmer County,2015-May,5037,4919,118,2.3
Parmer County,2015-Jun,5028,4902,126,2.5
Parmer County,2015-Jul,5008,4876,132,2.6
Parmer County,2015-Aug,4925,4810,115,2.3
Parmer County,2015-Sep,4962,4842,120,2.4
Parmer County,2015-Oct,4953,4834,119,2.4
Parmer County,2015-Nov,4877,4761,116,2.4
Parmer County,2015-Dec,4916,4812,104,2.1
Parmer County,2016-Jan,4743,4627,116,2.4
Parmer County,2016-Feb,4979,4855,124,2.5
Parmer County,2016-Mar,5069,4953,116,2.3
Parmer County,2016-Apr,5038,4932,106,2.1
Parmer County,2016-May,5152,5037,115,2.2
Parmer County,2016-Jun,5090,4955,135,2.7
Parmer County,2016-Jul,4938,4796,142,2.9
Parmer County,2016-Aug,4984,4845,139,2.8
Parmer County,2016-Sep,4858,4725,133,2.7
Parmer County,2016-Oct,4880,4752,128,2.6
Parmer County,2016-Nov,4839,4719,120,2.5
Parmer County,2016-Dec,4824,4703,121,2.5
Parmer County,2017-Jan,4752,4627,125,2.6
Parmer County,2017-Feb,4883,4744,139,2.8
Parmer County,2017-Mar,5056,4923,133,2.6
Parmer County,2017-Apr,4978,4867,111,2.2
Parmer County,2017-May,4987,4868,119,2.4
Parmer County,2017-Jun,4945,4812,133,2.7
Parmer County,2017-Jul,4847,4715,132,2.7
Parmer County,2017-Aug,4891,4764,127,2.6
Parmer County,2017-Sep,4772,4655,117,2.5
Parmer County,2017-Oct,4880,4774,106,2.2
Parmer County,2017-Nov,4784,4669,115,2.4
Parmer County,2017-Dec,4819,4714,105,2.2
Parmer County,2018-Jan,4712,4591,121,2.6
Parmer County,2018-Feb,4775,4658,117,2.5
Parmer County,2018-Mar,4903,4785,118,2.4
Parmer County,2018-Apr,4868,4763,105,2.2
Parmer County,2018-May,4941,4832,109,2.2
Parmer County,2018-Jun,4901,4767,134,2.7
Parmer County,2018-Jul,4877,4755,122,2.5
Parmer County,2018-Aug,4969,4854,115,2.3
Parmer County,2018-Sep,4822,4713,109,2.3
Parmer County,2018-Oct,4803,4696,107,2.2
Parmer County,2018-Nov,4771,4664,107,2.2
Parmer County,2018-Dec,4725,4618,107,2.3
Parmer County,2019-Jan,4674,4554,120,2.6
Parmer County,2019-Feb,4781,4664,117,2.4
Parmer County,2019-Mar,4808,4694,114,2.4
Parmer County,2019-Apr,4777,4686,91,1.9
Parmer County,2019-May,4849,4757,92,1.9
Parmer County,2019-Jun,4847,4730,117,2.4
Parmer County,2019-Jul,4822,4705,117,2.4
Parmer County,2019-Aug,4952,4843,109,2.2
Parmer County,2019-Sep,4778,4676,102,2.1
Parmer County,2019-Oct,4908,4809,99,2
Parmer County,2019-Nov,4739,4638,101,2.1
Parmer County,2019-Dec,4791,4699,92,1.9
Parmer County,2020-Jan,4749,4643,106,2.2
Parmer County,2020-Feb,4804,4701,103,2.1
Parmer County,2020-Mar,4739,4586,153,3.2
Parmer County,2020-Apr,4558,4459,99,2.2
Parmer County,2020-May,4622,4504,118,2.6
Parmer County,2020-Jun,4665,4526,139,3
Parmer County,2020-Jul,4881,4745,136,2.8
Parmer County,2020-Aug,4964,4856,108,2.2
Parmer County,2020-Sep,4980,4860,120,2.4
Parmer County,2020-Oct,5039,4921,118,2.3
Parmer County,2020-Nov,4834,4695,139,2.9
Parmer County,2020-Dec,4936,4795,141,2.9
Parmer County,2021-Jan,5024,4862,162,3.2
Parmer County,2021-Feb,5159,4998,161,3.1
Parmer County,2021-Mar,5196,5043,153,2.9
Parmer County,2021-Apr,5052,4925,127,2.5
Parmer County,2021-May,4925,4794,131,2.7
Parmer County,2021-Jun,4970,4787,183,3.7
Parmer County,2021-Jul,4958,4801,157,3.2
Parmer County,2021-Aug,4942,4807,135,2.7
Parmer County,2021-Sep,4966,4841,125,2.5
Parmer County,2021-Oct,4919,4793,126,2.6
Parmer County,2021-Nov,4764,4639,125,2.6
Parmer County,2021-Dec,4832,4717,115,2.4
Parmer County,2022-Jan,4864,4739,125,2.6
Parmer County,2022-Feb,5111,4984,127,2.5
Parmer County,2022-Mar,5203,5102,101,1.9
Parmer County,2022-Apr,5109,5014,95,1.9
Parmer County,2022-May,4983,4880,103,2.1
Parmer County,2022-Jun,4969,4837,132,2.7
Parmer County,2022-Jul,5178(P),5048(P),130(P),2.5(P)
Pecos County,2012-Jan,7095,6713,382,5.4
Pecos County,2012-Feb,7157,6773,384,5.4
Pecos County,2012-Mar,7129,6765,364,5.1
Pecos County,2012-Apr,7040,6707,333,4.7
Pecos County,2012-May,7126,6774,352,4.9
Pecos County,2012-Jun,7114,6727,387,5.4
Pecos County,2012-Jul,7145,6767,378,5.3
Pecos County,2012-Aug,6921,6561,360,5.2
Pecos County,2012-Sep,6865,6521,344,5
Pecos County,2012-Oct,6796,6459,337,5
Pecos County,2012-Nov,6697,6371,326,4.9
Pecos County,2012-Dec,6648,6321,327,4.9
Pecos County,2013-Jan,6708,6298,410,6.1
Pecos County,2013-Feb,6684,6319,365,5.5
Pecos County,2013-Mar,6614,6251,363,5.5
Pecos County,2013-Apr,6628,6293,335,5.1
Pecos County,2013-May,6730,6377,353,5.2
Pecos County,2013-Jun,6735,6345,390,5.8
Pecos County,2013-Jul,6798,6414,384,5.6
Pecos County,2013-Aug,6761,6362,399,5.9
Pecos County,2013-Sep,6743,6350,393,5.8
Pecos County,2013-Oct,6588,6236,352,5.3
Pecos County,2013-Nov,6655,6325,330,5
Pecos County,2013-Dec,6656,6350,306,4.6
Pecos County,2014-Jan,6758,6442,316,4.7
Pecos County,2014-Feb,6852,6537,315,4.6
Pecos County,2014-Mar,6847,6545,302,4.4
Pecos County,2014-Apr,6858,6596,262,3.8
Pecos County,2014-May,6857,6568,289,4.2
Pecos County,2014-Jun,6894,6571,323,4.7
Pecos County,2014-Jul,6952,6634,318,4.6
Pecos County,2014-Aug,6879,6582,297,4.3
Pecos County,2014-Sep,6818,6541,277,4.1
Pecos County,2014-Oct,6835,6573,262,3.8
Pecos County,2014-Nov,6854,6592,262,3.8
Pecos County,2014-Dec,6835,6597,238,3.5
Pecos County,2015-Jan,6992,6696,296,4.2
Pecos County,2015-Feb,7091,6768,323,4.6
Pecos County,2015-Mar,7056,6738,318,4.5
Pecos County,2015-Apr,6955,6633,322,4.6
Pecos County,2015-May,6962,6584,378,5.4
Pecos County,2015-Jun,6944,6521,423,6.1
Pecos County,2015-Jul,6947,6541,406,5.8
Pecos County,2015-Aug,6940,6567,373,5.4
Pecos County,2015-Sep,6766,6405,361,5.3
Pecos County,2015-Oct,6658,6285,373,5.6
Pecos County,2015-Nov,6606,6234,372,5.6
Pecos County,2015-Dec,6504,6167,337,5.2
Pecos County,2016-Jan,6418,6093,325,5.1
Pecos County,2016-Feb,6548,6214,334,5.1
Pecos County,2016-Mar,6505,6121,384,5.9
Pecos County,2016-Apr,6510,6140,370,5.7
Pecos County,2016-May,6416,6057,359,5.6
Pecos County,2016-Jun,6499,6108,391,6
Pecos County,2016-Jul,6634,6239,395,6
Pecos County,2016-Aug,6562,6169,393,6
Pecos County,2016-Sep,6532,6096,436,6.7
Pecos County,2016-Oct,6503,6101,402,6.2
Pecos County,2016-Nov,6489,6089,400,6.2
Pecos County,2016-Dec,6365,5966,399,6.3
Pecos County,2017-Jan,6217,5819,398,6.4
Pecos County,2017-Feb,6259,5871,388,6.2
Pecos County,2017-Mar,6305,5956,349,5.5
Pecos County,2017-Apr,6161,5850,311,5
Pecos County,2017-May,6109,5821,288,4.7
Pecos County,2017-Jun,6196,5897,299,4.8
Pecos County,2017-Jul,6246,5972,274,4.4
Pecos County,2017-Aug,6300,6003,297,4.7
Pecos County,2017-Sep,6189,5939,250,4
Pecos County,2017-Oct,6238,6015,223,3.6
Pecos County,2017-Nov,6245,6018,227,3.6
Pecos County,2017-Dec,6217,6007,210,3.4
Pecos County,2018-Jan,6263,6022,241,3.8
Pecos County,2018-Feb,6379,6123,256,4
Pecos County,2018-Mar,6343,6092,251,4
Pecos County,2018-Apr,6248,6020,228,3.6
Pecos County,2018-May,6293,6075,218,3.5
Pecos County,2018-Jun,6416,6164,252,3.9
Pecos County,2018-Jul,6376,6130,246,3.9
Pecos County,2018-Aug,6396,6164,232,3.6
Pecos County,2018-Sep,6427,6209,218,3.4
Pecos County,2018-Oct,6393,6171,222,3.5
Pecos County,2018-Nov,6401,6185,216,3.4
Pecos County,2018-Dec,6326,6106,220,3.5
Pecos County,2019-Jan,6375,6142,233,3.7
Pecos County,2019-Feb,6297,6084,213,3.4
Pecos County,2019-Mar,6365,6166,199,3.1
Pecos County,2019-Apr,6293,6115,178,2.8
Pecos County,2019-May,6266,6084,182,2.9
Pecos County,2019-Jun,6408,6197,211,3.3
Pecos County,2019-Jul,6399,6177,222,3.5
Pecos County,2019-Aug,6367,6157,210,3.3
Pecos County,2019-Sep,6248,6049,199,3.2
Pecos County,2019-Oct,6242,6038,204,3.3
Pecos County,2019-Nov,6161,5942,219,3.6
Pecos County,2019-Dec,6155,5947,208,3.4
Pecos County,2020-Jan,6254,6013,241,3.9
Pecos County,2020-Feb,6216,5995,221,3.6
Pecos County,2020-Mar,6224,5884,340,5.5
Pecos County,2020-Apr,5986,5459,527,8.8
Pecos County,2020-May,6221,5503,718,11.5
Pecos County,2020-Jun,6318,5593,725,11.5
Pecos County,2020-Jul,6696,5985,711,10.6
Pecos County,2020-Aug,6699,6109,590,8.8
Pecos County,2020-Sep,6696,6126,570,8.5
Pecos County,2020-Oct,6338,5796,542,8.6
Pecos County,2020-Nov,6307,5759,548,8.7
Pecos County,2020-Dec,6376,5808,568,8.9
Pecos County,2021-Jan,6272,5705,567,9
Pecos County,2021-Feb,6328,5769,559,8.8
Pecos County,2021-Mar,6364,5859,505,7.9
Pecos County,2021-Apr,6417,5951,466,7.3
Pecos County,2021-May,6280,5838,442,7
Pecos County,2021-Jun,6277,5794,483,7.7
Pecos County,2021-Jul,6188,5755,433,7
Pecos County,2021-Aug,6134,5734,400,6.5
Pecos County,2021-Sep,6126,5742,384,6.3
Pecos County,2021-Oct,5867,5504,363,6.2
Pecos County,2021-Nov,5848,5499,349,6
Pecos County,2021-Dec,5867,5533,334,5.7
Pecos County,2022-Jan,5878,5500,378,6.4
Pecos County,2022-Feb,5916,5552,364,6.2
Pecos County,2022-Mar,5984,5682,302,5
Pecos County,2022-Apr,5880,5597,283,4.8
Pecos County,2022-May,5786,5507,279,4.8
Pecos County,2022-Jun,5791,5478,313,5.4
Pecos County,2022-Jul,5874(P),5581(P),293(P),5.0(P)
Polk County,2012-Jan,17480,15949,1531,8.8
Polk County,2012-Feb,17389,15910,1479,8.5
Polk County,2012-Mar,17492,16099,1393,8
Polk County,2012-Apr,17475,16155,1320,7.6
Polk County,2012-May,17511,16130,1381,7.9
Polk County,2012-Jun,17657,16146,1511,8.6
Polk County,2012-Jul,17616,16095,1521,8.6
Polk County,2012-Aug,17537,16104,1433,8.2
Polk County,2012-Sep,17494,16173,1321,7.6
Polk County,2012-Oct,17540,16258,1282,7.3
Polk County,2012-Nov,17439,16182,1257,7.2
Polk County,2012-Dec,17377,16040,1337,7.7
Polk County,2013-Jan,17373,15854,1519,8.7
Polk County,2013-Feb,17389,15943,1446,8.3
Polk County,2013-Mar,17308,15924,1384,8
Polk County,2013-Apr,17444,16128,1316,7.5
Polk County,2013-May,17449,16147,1302,7.5
Polk County,2013-Jun,17607,16163,1444,8.2
Polk County,2013-Jul,17524,16093,1431,8.2
Polk County,2013-Aug,17270,15902,1368,7.9
Polk County,2013-Sep,17270,15915,1355,7.8
Polk County,2013-Oct,17120,15859,1261,7.4
Polk County,2013-Nov,17191,15974,1217,7.1
Polk County,2013-Dec,17140,15975,1165,6.8
Polk County,2014-Jan,17118,15885,1233,7.2
Polk County,2014-Feb,17175,15930,1245,7.2
Polk County,2014-Mar,17263,16069,1194,6.9
Polk County,2014-Apr,17236,16175,1061,6.2
Polk County,2014-May,17335,16170,1165,6.7
Polk County,2014-Jun,17401,16231,1170,6.7
Polk County,2014-Jul,17350,16146,1204,6.9
Polk County,2014-Aug,17073,15932,1141,6.7
Polk County,2014-Sep,17139,16077,1062,6.2
Polk County,2014-Oct,17194,16192,1002,5.8
Polk County,2014-Nov,17197,16162,1035,6
Polk County,2014-Dec,17021,16044,977,5.7
Polk County,2015-Jan,17209,16125,1084,6.3
Polk County,2015-Feb,17262,16209,1053,6.1
Polk County,2015-Mar,17310,16320,990,5.7
Polk County,2015-Apr,17114,16199,915,5.3
Polk County,2015-May,17073,16074,999,5.9
Polk County,2015-Jun,17090,16008,1082,6.3
Polk County,2015-Jul,16952,15828,1124,6.6
Polk County,2015-Aug,16762,15681,1081,6.4
Polk County,2015-Sep,16690,15664,1026,6.1
Polk County,2015-Oct,16889,15871,1018,6
Polk County,2015-Nov,17127,16065,1062,6.2
Polk County,2015-Dec,17104,16059,1045,6.1
Polk County,2016-Jan,17042,15947,1095,6.4
Polk County,2016-Feb,17169,16124,1045,6.1
Polk County,2016-Mar,17309,16227,1082,6.3
Polk County,2016-Apr,17200,16182,1018,5.9
Polk County,2016-May,17412,16428,984,5.7
Polk County,2016-Jun,17490,16369,1121,6.4
Polk County,2016-Jul,17557,16343,1214,6.9
Polk County,2016-Aug,17482,16307,1175,6.7
Polk County,2016-Sep,17456,16301,1155,6.6
Polk County,2016-Oct,17458,16393,1065,6.1
Polk County,2016-Nov,17513,16416,1097,6.3
Polk County,2016-Dec,17570,16411,1159,6.6
Polk County,2017-Jan,17500,16184,1316,7.5
Polk County,2017-Feb,17675,16402,1273,7.2
Polk County,2017-Mar,17747,16583,1164,6.6
Polk County,2017-Apr,17381,16316,1065,6.1
Polk County,2017-May,17314,16323,991,5.7
Polk County,2017-Jun,17427,16352,1075,6.2
Polk County,2017-Jul,17328,16272,1056,6.1
Polk County,2017-Aug,17234,16161,1073,6.2
Polk County,2017-Sep,17218,16213,1005,5.8
Polk County,2017-Oct,17305,16394,911,5.3
Polk County,2017-Nov,17330,16379,951,5.5
Polk County,2017-Dec,17328,16385,943,5.4
Polk County,2018-Jan,17635,16554,1081,6.1
Polk County,2018-Feb,17733,16702,1031,5.8
Polk County,2018-Mar,17789,16820,969,5.4
Polk County,2018-Apr,17686,16821,865,4.9
Polk County,2018-May,17661,16817,844,4.8
Polk County,2018-Jun,17734,16787,947,5.3
Polk County,2018-Jul,17688,16771,917,5.2
Polk County,2018-Aug,17532,16653,879,5
Polk County,2018-Sep,17609,16770,839,4.8
Polk County,2018-Oct,17614,16845,769,4.4
Polk County,2018-Nov,17719,16896,823,4.6
Polk County,2018-Dec,17619,16783,836,4.7
Polk County,2019-Jan,17840,16810,1030,5.8
Polk County,2019-Feb,17905,16974,931,5.2
Polk County,2019-Mar,17855,17019,836,4.7
Polk County,2019-Apr,17629,16927,702,4
Polk County,2019-May,17593,16869,724,4.1
Polk County,2019-Jun,17749,16871,878,4.9
Polk County,2019-Jul,17888,16941,947,5.3
Polk County,2019-Aug,17810,16937,873,4.9
Polk County,2019-Sep,17846,17029,817,4.6
Polk County,2019-Oct,17867,17060,807,4.5
Polk County,2019-Nov,17860,17011,849,4.8
Polk County,2019-Dec,17969,17094,875,4.9
Polk County,2020-Jan,18186,17209,977,5.4
Polk County,2020-Feb,18223,17319,904,5
Polk County,2020-Mar,18116,16763,1353,7.5
Polk County,2020-Apr,17051,15176,1875,11
Polk County,2020-May,17823,15733,2090,11.7
Polk County,2020-Jun,18180,16127,2053,11.3
Polk County,2020-Jul,18412,16438,1974,10.7
Polk County,2020-Aug,18425,16777,1648,8.9
Polk County,2020-Sep,18520,16900,1620,8.7
Polk County,2020-Oct,18460,16988,1472,8
Polk County,2020-Nov,18665,17053,1612,8.6
Polk County,2020-Dec,18698,17021,1677,9
Polk County,2021-Jan,18691,16914,1777,9.5
Polk County,2021-Feb,18833,17047,1786,9.5
Polk County,2021-Mar,18807,17106,1701,9
Polk County,2021-Apr,18416,16874,1542,8.4
Polk County,2021-May,18342,16873,1469,8
Polk County,2021-Jun,18533,16886,1647,8.9
Polk County,2021-Jul,18630,17093,1537,8.3
Polk County,2021-Aug,18497,17060,1437,7.8
Polk County,2021-Sep,18576,17259,1317,7.1
Polk County,2021-Oct,18487,17211,1276,6.9
Polk County,2021-Nov,18562,17312,1250,6.7
Polk County,2021-Dec,18480,17310,1170,6.3
Polk County,2022-Jan,18538,17171,1367,7.4
Polk County,2022-Feb,18669,17315,1354,7.3
Polk County,2022-Mar,18681,17559,1122,6
Polk County,2022-Apr,18177,17116,1061,5.8
Polk County,2022-May,18194,17116,1078,5.9
Polk County,2022-Jun,18370,17154,1216,6.6
Polk County,2022-Jul,18526(P),17330(P),1196(P),6.5(P)
Potter County,2012-Jan,57989,54700,3289,5.7
Potter County,2012-Feb,58213,55012,3201,5.5
Potter County,2012-Mar,57992,54951,3041,5.2
Potter County,2012-Apr,58202,55372,2830,4.9
Potter County,2012-May,58074,55078,2996,5.2
Potter County,2012-Jun,58367,54888,3479,6
Potter County,2012-Jul,58550,55058,3492,6
Potter County,2012-Aug,57636,54369,3267,5.7
Potter County,2012-Sep,58061,55140,2921,5
Potter County,2012-Oct,58521,55656,2865,4.9
Potter County,2012-Nov,58533,55694,2839,4.9
Potter County,2012-Dec,58261,55371,2890,5
Potter County,2013-Jan,57387,54211,3176,5.5
Potter County,2013-Feb,57250,54250,3000,5.2
Potter County,2013-Mar,57029,54046,2983,5.2
Potter County,2013-Apr,57780,55010,2770,4.8
Potter County,2013-May,57799,54863,2936,5.1
Potter County,2013-Jun,57689,54440,3249,5.6
Potter County,2013-Jul,57658,54458,3200,5.5
Potter County,2013-Aug,57204,54206,2998,5.2
Potter County,2013-Sep,57373,54478,2895,5
Potter County,2013-Oct,57238,54512,2726,4.8
Potter County,2013-Nov,57384,54793,2591,4.5
Potter County,2013-Dec,57226,54804,2422,4.2
Potter County,2014-Jan,56561,54062,2499,4.4
Potter County,2014-Feb,56982,54473,2509,4.4
Potter County,2014-Mar,56837,54419,2418,4.3
Potter County,2014-Apr,57033,54967,2066,3.6
Potter County,2014-May,57021,54797,2224,3.9
Potter County,2014-Jun,57018,54527,2491,4.4
Potter County,2014-Jul,56912,54335,2577,4.5
Potter County,2014-Aug,56339,53930,2409,4.3
Potter County,2014-Sep,56393,54173,2220,3.9
Potter County,2014-Oct,56802,54742,2060,3.6
Potter County,2014-Nov,56765,54737,2028,3.6
Potter County,2014-Dec,56373,54551,1822,3.2
Potter County,2015-Jan,56033,53986,2047,3.7
Potter County,2015-Feb,56278,54342,1936,3.4
Potter County,2015-Mar,56109,54311,1798,3.2
Potter County,2015-Apr,56308,54658,1650,2.9
Potter County,2015-May,56524,54690,1834,3.2
Potter County,2015-Jun,56263,54233,2030,3.6
Potter County,2015-Jul,56176,54090,2086,3.7
Potter County,2015-Aug,55885,53965,1920,3.4
Potter County,2015-Sep,56030,54133,1897,3.4
Potter County,2015-Oct,56338,54451,1887,3.3
Potter County,2015-Nov,56622,54772,1850,3.3
Potter County,2015-Dec,56688,54956,1732,3.1
Potter County,2016-Jan,55744,53931,1813,3.3
Potter County,2016-Feb,56351,54547,1804,3.2
Potter County,2016-Mar,56329,54549,1780,3.2
Potter County,2016-Apr,56478,54836,1642,2.9
Potter County,2016-May,56369,54713,1656,2.9
Potter County,2016-Jun,56169,54193,1976,3.5
Potter County,2016-Jul,56284,54184,2100,3.7
Potter County,2016-Aug,56016,54039,1977,3.5
Potter County,2016-Sep,55992,53918,2074,3.7
Potter County,2016-Oct,56039,54082,1957,3.5
Potter County,2016-Nov,56229,54310,1919,3.4
Potter County,2016-Dec,56129,54230,1899,3.4
Potter County,2017-Jan,54722,52710,2012,3.7
Potter County,2017-Feb,55283,53276,2007,3.6
Potter County,2017-Mar,55234,53309,1925,3.5
Potter County,2017-Apr,55459,53795,1664,3
Potter County,2017-May,55116,53408,1708,3.1
Potter County,2017-Jun,55038,53103,1935,3.5
Potter County,2017-Jul,54840,52900,1940,3.5
Potter County,2017-Aug,54694,52837,1857,3.4
Potter County,2017-Sep,55026,53354,1672,3
Potter County,2017-Oct,54862,53331,1531,2.8
Potter County,2017-Nov,55094,53477,1617,2.9
Potter County,2017-Dec,54864,53331,1533,2.8
Potter County,2018-Jan,54070,52376,1694,3.1
Potter County,2018-Feb,54814,53111,1703,3.1
Potter County,2018-Mar,54743,53005,1738,3.2
Potter County,2018-Apr,54595,53120,1475,2.7
Potter County,2018-May,54597,53159,1438,2.6
Potter County,2018-Jun,54414,52620,1794,3.3
Potter County,2018-Jul,54495,52742,1753,3.2
Potter County,2018-Aug,53984,52361,1623,3
Potter County,2018-Sep,54080,52524,1556,2.9
Potter County,2018-Oct,54031,52563,1468,2.7
Potter County,2018-Nov,54336,52841,1495,2.8
Potter County,2018-Dec,54225,52718,1507,2.8
Potter County,2019-Jan,53168,51485,1683,3.2
Potter County,2019-Feb,53727,52158,1569,2.9
Potter County,2019-Mar,53646,52107,1539,2.9
Potter County,2019-Apr,53686,52482,1204,2.2
Potter County,2019-May,53720,52472,1248,2.3
Potter County,2019-Jun,53767,52145,1622,3
Potter County,2019-Jul,53696,52004,1692,3.2
Potter County,2019-Aug,53523,51977,1546,2.9
Potter County,2019-Sep,53617,52157,1460,2.7
Potter County,2019-Oct,53906,52495,1411,2.6
Potter County,2019-Nov,54131,52723,1408,2.6
Potter County,2019-Dec,53984,52674,1310,2.4
Potter County,2020-Jan,53095,51633,1462,2.8
Potter County,2020-Feb,53239,51873,1366,2.6
Potter County,2020-Mar,52217,50162,2055,3.9
Potter County,2020-Apr,48885,44581,4304,8.8
Potter County,2020-May,51913,47445,4468,8.6
Potter County,2020-Jun,52787,48664,4123,7.8
Potter County,2020-Jul,52828,49260,3568,6.8
Potter County,2020-Aug,53437,50537,2900,5.4
Potter County,2020-Sep,53524,50731,2793,5.2
Potter County,2020-Oct,53962,51342,2620,4.9
Potter County,2020-Nov,53924,51230,2694,5
Potter County,2020-Dec,53835,51121,2714,5
Potter County,2021-Jan,53991,51115,2876,5.3
Potter County,2021-Feb,54452,51583,2869,5.3
Potter County,2021-Mar,54422,51695,2727,5
Potter County,2021-Apr,54095,51772,2323,4.3
Potter County,2021-May,54114,51863,2251,4.2
Potter County,2021-Jun,54302,51698,2604,4.8
Potter County,2021-Jul,54030,51632,2398,4.4
Potter County,2021-Aug,54115,51868,2247,4.2
Potter County,2021-Sep,54061,51985,2076,3.8
Potter County,2021-Oct,54454,52468,1986,3.6
Potter County,2021-Nov,54607,52708,1899,3.5
Potter County,2021-Dec,54463,52728,1735,3.2
Potter County,2022-Jan,54494,52461,2033,3.7
Potter County,2022-Feb,55029,52982,2047,3.7
Potter County,2022-Mar,55140,53511,1629,3
Potter County,2022-Apr,54490,52981,1509,2.8
Potter County,2022-May,54359,52746,1613,3
Potter County,2022-Jun,54300,52405,1895,3.5
Potter County,2022-Jul,54345(P),52513(P),1832(P),3.4(P)
Presidio County,2012-Jan,3689,3188,501,13.6
Presidio County,2012-Feb,3719,3239,480,12.9
Presidio County,2012-Mar,3724,3308,416,11.2
Presidio County,2012-Apr,3788,3371,417,11
Presidio County,2012-May,3754,3299,455,12.1
Presidio County,2012-Jun,3966,3378,588,14.8
Presidio County,2012-Jul,3988,3389,599,15
Presidio County,2012-Aug,3929,3336,593,15.1
Presidio County,2012-Sep,3891,3330,561,14.4
Presidio County,2012-Oct,3797,3307,490,12.9
Presidio County,2012-Nov,3753,3306,447,11.9
Presidio County,2012-Dec,3799,3294,505,13.3
Presidio County,2013-Jan,3820,3280,540,14.1
Presidio County,2013-Feb,3798,3298,500,13.2
Presidio County,2013-Mar,3751,3294,457,12.2
Presidio County,2013-Apr,3721,3276,445,12
Presidio County,2013-May,3764,3299,465,12.4
Presidio County,2013-Jun,3884,3368,516,13.3
Presidio County,2013-Jul,3865,3345,520,13.5
Presidio County,2013-Aug,3754,3253,501,13.3
Presidio County,2013-Sep,3716,3220,496,13.3
Presidio County,2013-Oct,3717,3248,469,12.6
Presidio County,2013-Nov,3656,3192,464,12.7
Presidio County,2013-Dec,3566,3112,454,12.7
Presidio County,2014-Jan,3659,3176,483,13.2
Presidio County,2014-Feb,3655,3207,448,12.3
Presidio County,2014-Mar,3496,3056,440,12.6
Presidio County,2014-Apr,3458,3056,402,11.6
Presidio County,2014-May,3469,3054,415,12
Presidio County,2014-Jun,3467,3034,433,12.5
Presidio County,2014-Jul,3468,3038,430,12.4
Presidio County,2014-Aug,3370,2948,422,12.5
Presidio County,2014-Sep,3306,2919,387,11.7
Presidio County,2014-Oct,3217,2892,325,10.1
Presidio County,2014-Nov,3170,2848,322,10.2
Presidio County,2014-Dec,3191,2872,319,10
Presidio County,2015-Jan,3165,2811,354,11.2
Presidio County,2015-Feb,3204,2859,345,10.8
Presidio County,2015-Mar,3193,2870,323,10.1
Presidio County,2015-Apr,3070,2781,289,9.4
Presidio County,2015-May,3117,2811,306,9.8
Presidio County,2015-Jun,3217,2843,374,11.6
Presidio County,2015-Jul,3173,2791,382,12
Presidio County,2015-Aug,3068,2717,351,11.4
Presidio County,2015-Sep,3052,2714,338,11.1
Presidio County,2015-Oct,3066,2762,304,9.9
Presidio County,2015-Nov,3067,2754,313,10.2
Presidio County,2015-Dec,3027,2695,332,11
Presidio County,2016-Jan,2978,2637,341,11.5
Presidio County,2016-Feb,3052,2732,320,10.5
Presidio County,2016-Mar,3097,2787,310,10
Presidio County,2016-Apr,3090,2784,306,9.9
Presidio County,2016-May,3111,2813,298,9.6
Presidio County,2016-Jun,3127,2775,352,11.3
Presidio County,2016-Jul,3144,2805,339,10.8
Presidio County,2016-Aug,3129,2785,344,11
Presidio County,2016-Sep,3058,2730,328,10.7
Presidio County,2016-Oct,3075,2749,326,10.6
Presidio County,2016-Nov,3034,2717,317,10.4
Presidio County,2016-Dec,3071,2695,376,12.2
Presidio County,2017-Jan,3030,2619,411,13.6
Presidio County,2017-Feb,3104,2723,381,12.3
Presidio County,2017-Mar,3111,2789,322,10.4
Presidio County,2017-Apr,3091,2782,309,10
Presidio County,2017-May,3070,2802,268,8.7
Presidio County,2017-Jun,3091,2785,306,9.9
Presidio County,2017-Jul,2959,2681,278,9.4
Presidio County,2017-Aug,2989,2710,279,9.3
Presidio County,2017-Sep,2976,2730,246,8.3
Presidio County,2017-Oct,2974,2768,206,6.9
Presidio County,2017-Nov,2917,2703,214,7.3
Presidio County,2017-Dec,2933,2708,225,7.7
Presidio County,2018-Jan,2981,2717,264,8.9
Presidio County,2018-Feb,2960,2716,244,8.2
Presidio County,2018-Mar,2966,2743,223,7.5
Presidio County,2018-Apr,2939,2718,221,7.5
Presidio County,2018-May,3001,2809,192,6.4
Presidio County,2018-Jun,3058,2833,225,7.4
Presidio County,2018-Jul,3091,2874,217,7
Presidio County,2018-Aug,3110,2898,212,6.8
Presidio County,2018-Sep,3008,2810,198,6.6
Presidio County,2018-Oct,3028,2849,179,5.9
Presidio County,2018-Nov,3014,2842,172,5.7
Presidio County,2018-Dec,2995,2818,177,5.9
Presidio County,2019-Jan,2987,2775,212,7.1
Presidio County,2019-Feb,2997,2827,170,5.7
Presidio County,2019-Mar,2998,2838,160,5.3
Presidio County,2019-Apr,3000,2846,154,5.1
Presidio County,2019-May,2998,2824,174,5.8
Presidio County,2019-Jun,3073,2876,197,6.4
Presidio County,2019-Jul,3071,2863,208,6.8
Presidio County,2019-Aug,3100,2903,197,6.4
Presidio County,2019-Sep,3091,2883,208,6.7
Presidio County,2019-Oct,3188,2991,197,6.2
Presidio County,2019-Nov,3199,2960,239,7.5
Presidio County,2019-Dec,3195,2940,255,8
Presidio County,2020-Jan,3204,2922,282,8.8
Presidio County,2020-Feb,3196,2946,250,7.8
Presidio County,2020-Mar,3200,2844,356,11.1
Presidio County,2020-Apr,3122,2522,600,19.2
Presidio County,2020-May,3248,2568,680,20.9
Presidio County,2020-Jun,3213,2587,626,19.5
Presidio County,2020-Jul,3190,2614,576,18.1
Presidio County,2020-Aug,3199,2687,512,16
Presidio County,2020-Sep,3162,2650,512,16.2
Presidio County,2020-Oct,3126,2693,433,13.9
Presidio County,2020-Nov,3129,2719,410,13.1
Presidio County,2020-Dec,3113,2693,420,13.5
Presidio County,2021-Jan,3134,2707,427,13.6
Presidio County,2021-Feb,3135,2734,401,12.8
Presidio County,2021-Mar,3130,2763,367,11.7
Presidio County,2021-Apr,3140,2775,365,11.6
Presidio County,2021-May,3093,2754,339,11
Presidio County,2021-Jun,3074,2705,369,12
Presidio County,2021-Jul,3105,2775,330,10.6
Presidio County,2021-Aug,3109,2791,318,10.2
Presidio County,2021-Sep,3076,2802,274,8.9
Presidio County,2021-Oct,3085,2820,265,8.6
Presidio County,2021-Nov,3089,2844,245,7.9
Presidio County,2021-Dec,3041,2814,227,7.5
Presidio County,2022-Jan,3081,2822,259,8.4
Presidio County,2022-Feb,3142,2885,257,8.2
Presidio County,2022-Mar,3165,2942,223,7
Presidio County,2022-Apr,3158,2944,214,6.8
Presidio County,2022-May,3134,2918,216,6.9
Presidio County,2022-Jun,3106,2861,245,7.9
Presidio County,2022-Jul,3233(P),2980(P),253(P),7.8(P)
Rains County,2012-Jan,5270,4870,400,7.6
Rains County,2012-Feb,5290,4898,392,7.4
Rains County,2012-Mar,5256,4904,352,6.7
Rains County,2012-Apr,5282,4940,342,6.5
Rains County,2012-May,5176,4825,351,6.8
Rains County,2012-Jun,5192,4811,381,7.3
Rains County,2012-Jul,5197,4811,386,7.4
Rains County,2012-Aug,5180,4806,374,7.2
Rains County,2012-Sep,5222,4870,352,6.7
Rains County,2012-Oct,5198,4853,345,6.6
Rains County,2012-Nov,5156,4829,327,6.3
Rains County,2012-Dec,5205,4858,347,6.7
Rains County,2013-Jan,5355,4981,374,7
Rains County,2013-Feb,5400,5055,345,6.4
Rains County,2013-Mar,5348,5025,323,6
Rains County,2013-Apr,5355,5041,314,5.9
Rains County,2013-May,5354,5026,328,6.1
Rains County,2013-Jun,5289,4930,359,6.8
Rains County,2013-Jul,5268,4918,350,6.6
Rains County,2013-Aug,5254,4917,337,6.4
Rains County,2013-Sep,5329,4998,331,6.2
Rains County,2013-Oct,5342,5024,318,6
Rains County,2013-Nov,5348,5046,302,5.6
Rains County,2013-Dec,5295,5014,281,5.3
Rains County,2014-Jan,5359,5071,288,5.4
Rains County,2014-Feb,5462,5176,286,5.2
Rains County,2014-Mar,5442,5164,278,5.1
Rains County,2014-Apr,5463,5220,243,4.4
Rains County,2014-May,5458,5194,264,4.8
Rains County,2014-Jun,5379,5105,274,5.1
Rains County,2014-Jul,5360,5073,287,5.4
Rains County,2014-Aug,5341,5060,281,5.3
Rains County,2014-Sep,5422,5147,275,5.1
Rains County,2014-Oct,5411,5157,254,4.7
Rains County,2014-Nov,5356,5108,248,4.6
Rains County,2014-Dec,5321,5065,256,4.8
Rains County,2015-Jan,5432,5147,285,5.2
Rains County,2015-Feb,5434,5167,267,4.9
Rains County,2015-Mar,5400,5146,254,4.7
Rains County,2015-Apr,5450,5210,240,4.4
Rains County,2015-May,5480,5223,257,4.7
Rains County,2015-Jun,5461,5200,261,4.8
Rains County,2015-Jul,5376,5117,259,4.8
Rains County,2015-Aug,5345,5101,244,4.6
Rains County,2015-Sep,5382,5147,235,4.4
Rains County,2015-Oct,5415,5176,239,4.4
Rains County,2015-Nov,5395,5167,228,4.2
Rains County,2015-Dec,5394,5179,215,4
Rains County,2016-Jan,5583,5357,226,4
Rains County,2016-Feb,5652,5432,220,3.9
Rains County,2016-Mar,5631,5408,223,4
Rains County,2016-Apr,5654,5451,203,3.6
Rains County,2016-May,5586,5372,214,3.8
Rains County,2016-Jun,5544,5300,244,4.4
Rains County,2016-Jul,5457,5209,248,4.5
Rains County,2016-Aug,5443,5208,235,4.3
Rains County,2016-Sep,5490,5256,234,4.3
Rains County,2016-Oct,5532,5316,216,3.9
Rains County,2016-Nov,5536,5328,208,3.8
Rains County,2016-Dec,5562,5356,206,3.7
Rains County,2017-Jan,5667,5434,233,4.1
Rains County,2017-Feb,5718,5492,226,4
Rains County,2017-Mar,5697,5484,213,3.7
Rains County,2017-Apr,5727,5545,182,3.2
Rains County,2017-May,5596,5408,188,3.4
Rains County,2017-Jun,5611,5402,209,3.7
Rains County,2017-Jul,5597,5381,216,3.9
Rains County,2017-Aug,5615,5389,226,4
Rains County,2017-Sep,5655,5456,199,3.5
Rains County,2017-Oct,5658,5471,187,3.3
Rains County,2017-Nov,5655,5460,195,3.4
Rains County,2017-Dec,5712,5525,187,3.3
Rains County,2018-Jan,5858,5639,219,3.7
Rains County,2018-Feb,5932,5716,216,3.6
Rains County,2018-Mar,5937,5730,207,3.5
Rains County,2018-Apr,5894,5704,190,3.2
Rains County,2018-May,5800,5610,190,3.3
Rains County,2018-Jun,5815,5596,219,3.8
Rains County,2018-Jul,5772,5549,223,3.9
Rains County,2018-Aug,5717,5504,213,3.7
Rains County,2018-Sep,5785,5583,202,3.5
Rains County,2018-Oct,5860,5671,189,3.2
Rains County,2018-Nov,5880,5682,198,3.4
Rains County,2018-Dec,5969,5769,200,3.4
Rains County,2019-Jan,5976,5752,224,3.7
Rains County,2019-Feb,6033,5825,208,3.4
Rains County,2019-Mar,6011,5821,190,3.2
Rains County,2019-Apr,6103,5945,158,2.6
Rains County,2019-May,5970,5811,159,2.7
Rains County,2019-Jun,5961,5770,191,3.2
Rains County,2019-Jul,5928,5732,196,3.3
Rains County,2019-Aug,5908,5715,193,3.3
Rains County,2019-Sep,5925,5744,181,3.1
Rains County,2019-Oct,5993,5827,166,2.8
Rains County,2019-Nov,5968,5803,165,2.8
Rains County,2019-Dec,6028,5870,158,2.6
Rains County,2020-Jan,6063,5880,183,3
Rains County,2020-Feb,6153,5982,171,2.8
Rains County,2020-Mar,5925,5662,263,4.4
Rains County,2020-Apr,5568,5201,367,6.6
Rains County,2020-May,5722,5353,369,6.4
Rains County,2020-Jun,5849,5488,361,6.2
Rains County,2020-Jul,5919,5584,335,5.7
Rains County,2020-Aug,5978,5703,275,4.6
Rains County,2020-Sep,6040,5760,280,4.6
Rains County,2020-Oct,6074,5835,239,3.9
Rains County,2020-Nov,6049,5794,255,4.2
Rains County,2020-Dec,6106,5845,261,4.3
Rains County,2021-Jan,6171,5896,275,4.5
Rains County,2021-Feb,6254,5965,289,4.6
Rains County,2021-Mar,6279,6003,276,4.4
Rains County,2021-Apr,6354,6118,236,3.7
Rains County,2021-May,6307,6068,239,3.8
Rains County,2021-Jun,6313,6026,287,4.5
Rains County,2021-Jul,6269,6017,252,4
Rains County,2021-Aug,6265,6026,239,3.8
Rains County,2021-Sep,6366,6134,232,3.6
Rains County,2021-Oct,6400,6176,224,3.5
Rains County,2021-Nov,6396,6189,207,3.2
Rains County,2021-Dec,6441,6256,185,2.9
Rains County,2022-Jan,6529,6305,224,3.4
Rains County,2022-Feb,6633,6391,242,3.6
Rains County,2022-Mar,6631,6437,194,2.9
Rains County,2022-Apr,6664,6488,176,2.6
Rains County,2022-May,6652,6456,196,2.9
Rains County,2022-Jun,6625,6402,223,3.4
Rains County,2022-Jul,6590(P),6365(P),225(P),3.4(P)
Randall County,2012-Jan,67573,64418,3155,4.7
Randall County,2012-Feb,67941,64839,3102,4.6
Randall County,2012-Mar,67703,64817,2886,4.3
Randall County,2012-Apr,68128,65375,2753,4
Randall County,2012-May,68092,65144,2948,4.3
Randall County,2012-Jun,68213,64851,3362,4.9
Randall County,2012-Jul,68459,65047,3412,5
Randall County,2012-Aug,67271,64133,3138,4.7
Randall County,2012-Sep,67796,64953,2843,4.2
Randall County,2012-Oct,68359,65575,2784,4.1
Randall County,2012-Nov,68220,65499,2721,4
Randall County,2012-Dec,67864,65133,2731,4
Randall County,2013-Jan,68091,64953,3138,4.6
Randall County,2013-Feb,67965,65023,2942,4.3
Randall County,2013-Mar,67732,64838,2894,4.3
Randall County,2013-Apr,68763,65969,2794,4.1
Randall County,2013-May,68924,65934,2990,4.3
Randall County,2013-Jun,68880,65471,3409,4.9
Randall County,2013-Jul,68781,65475,3306,4.8
Randall County,2013-Aug,68142,65102,3040,4.5
Randall County,2013-Sep,68450,65425,3025,4.4
Randall County,2013-Oct,68318,65476,2842,4.2
Randall County,2013-Nov,68303,65595,2708,4
Randall County,2013-Dec,68235,65708,2527,3.7
Randall County,2014-Jan,68469,65819,2650,3.9
Randall County,2014-Feb,69017,66330,2687,3.9
Randall County,2014-Mar,68828,66295,2533,3.7
Randall County,2014-Apr,69160,67006,2154,3.1
Randall County,2014-May,69251,66863,2388,3.4
Randall County,2014-Jun,69114,66499,2615,3.8
Randall County,2014-Jul,68983,66252,2731,4
Randall County,2014-Aug,68215,65710,2505,3.7
Randall County,2014-Sep,68238,65892,2346,3.4
Randall County,2014-Oct,68735,66529,2206,3.2
Randall County,2014-Nov,68537,66409,2128,3.1
Randall County,2014-Dec,68198,66296,1902,2.8
Randall County,2015-Jan,68830,66640,2190,3.2
Randall County,2015-Feb,69306,67267,2039,2.9
Randall County,2015-Mar,69116,67172,1944,2.8
Randall County,2015-Apr,69205,67424,1781,2.6
Randall County,2015-May,69463,67454,2009,2.9
Randall County,2015-Jun,69145,66931,2214,3.2
Randall County,2015-Jul,68974,66699,2275,3.3
Randall County,2015-Aug,68575,66529,2046,3
Randall County,2015-Sep,68771,66746,2025,2.9
Randall County,2015-Oct,69044,67094,1950,2.8
Randall County,2015-Nov,69338,67403,1935,2.8
Randall County,2015-Dec,69530,67740,1790,2.6
Randall County,2016-Jan,70108,68125,1983,2.8
Randall County,2016-Feb,71064,69081,1983,2.8
Randall County,2016-Mar,71054,69045,2009,2.8
Randall County,2016-Apr,71137,69324,1813,2.5
Randall County,2016-May,71108,69231,1877,2.6
Randall County,2016-Jun,70646,68414,2232,3.2
Randall County,2016-Jul,70671,68336,2335,3.3
Randall County,2016-Aug,70453,68242,2211,3.1
Randall County,2016-Sep,70450,68174,2276,3.2
Randall County,2016-Oct,70450,68276,2174,3.1
Randall County,2016-Nov,70660,68559,2101,3
Randall County,2016-Dec,70421,68336,2085,3
Randall County,2017-Jan,69871,67619,2252,3.2
Randall County,2017-Feb,70719,68379,2340,3.3
Randall County,2017-Mar,70777,68605,2172,3.1
Randall County,2017-Apr,71128,69236,1892,2.7
Randall County,2017-May,70696,68729,1967,2.8
Randall County,2017-Jun,70374,68207,2167,3.1
Randall County,2017-Jul,70038,67902,2136,3
Randall County,2017-Aug,69926,67887,2039,2.9
Randall County,2017-Sep,70375,68532,1843,2.6
Randall County,2017-Oct,70247,68540,1707,2.4
Randall County,2017-Nov,70400,68596,1804,2.6
Randall County,2017-Dec,70002,68307,1695,2.4
Randall County,2018-Jan,70314,68404,1910,2.7
Randall County,2018-Feb,71423,69481,1942,2.7
Randall County,2018-Mar,71295,69382,1913,2.7
Randall County,2018-Apr,71171,69460,1711,2.4
Randall County,2018-May,71385,69670,1715,2.4
Randall County,2018-Jun,71046,68952,2094,2.9
Randall County,2018-Jul,71035,69036,1999,2.8
Randall County,2018-Aug,70630,68694,1936,2.7
Randall County,2018-Sep,70738,68873,1865,2.6
Randall County,2018-Oct,70677,68908,1769,2.5
Randall County,2018-Nov,70963,69209,1754,2.5
Randall County,2018-Dec,70622,68862,1760,2.5
Randall County,2019-Jan,71302,69261,2041,2.9
Randall County,2019-Feb,72146,70283,1863,2.6
Randall County,2019-Mar,72110,70313,1797,2.5
Randall County,2019-Apr,72314,70854,1460,2
Randall County,2019-May,72424,70915,1509,2.1
Randall County,2019-Jun,72302,70417,1885,2.6
Randall County,2019-Jul,72142,70212,1930,2.7
Randall County,2019-Aug,72095,70243,1852,2.6
Randall County,2019-Sep,72132,70421,1711,2.4
Randall County,2019-Oct,72673,71036,1637,2.3
Randall County,2019-Nov,72768,71149,1619,2.2
Randall County,2019-Dec,72555,71069,1486,2
Randall County,2020-Jan,73424,71651,1773,2.4
Randall County,2020-Feb,73670,71977,1693,2.3
Randall County,2020-Mar,72291,69702,2589,3.6
Randall County,2020-Apr,67328,62143,5185,7.7
Randall County,2020-May,70950,66010,4940,7
Randall County,2020-Jun,72093,67629,4464,6.2
Randall County,2020-Jul,72134,68361,3773,5.2
Randall County,2020-Aug,73074,70122,2952,4
Randall County,2020-Sep,73313,70409,2904,4
Randall County,2020-Oct,74071,71401,2670,3.6
Randall County,2020-Nov,74053,71181,2872,3.9
Randall County,2020-Dec,73908,70986,2922,4
Randall County,2021-Jan,74235,71034,3201,4.3
Randall County,2021-Feb,74882,71737,3145,4.2
Randall County,2021-Mar,74798,71859,2939,3.9
Randall County,2021-Apr,74522,71958,2564,3.4
Randall County,2021-May,74446,71928,2518,3.4
Randall County,2021-Jun,74658,71671,2987,4
Randall County,2021-Jul,74066,71394,2672,3.6
Randall County,2021-Aug,74277,71735,2542,3.4
Randall County,2021-Sep,74358,71920,2438,3.3
Randall County,2021-Oct,74994,72651,2343,3.1
Randall County,2021-Nov,75098,72915,2183,2.9
Randall County,2021-Dec,74897,72929,1968,2.6
Randall County,2022-Jan,75111,72800,2311,3.1
Randall County,2022-Feb,76075,73710,2365,3.1
Randall County,2022-Mar,76318,74410,1908,2.5
Randall County,2022-Apr,75522,73762,1760,2.3
Randall County,2022-May,75171,73239,1932,2.6
Randall County,2022-Jun,74886,72637,2249,3
Randall County,2022-Jul,75068(P),72882(P),2186(P),2.9(P)
Reagan County,2012-Jan,2071,1998,73,3.5
Reagan County,2012-Feb,2076,2008,68,3.3
Reagan County,2012-Mar,2070,2007,63,3
Reagan County,2012-Apr,2133,2071,62,2.9
Reagan County,2012-May,2117,2049,68,3.2
Reagan County,2012-Jun,2188,2110,78,3.6
Reagan County,2012-Jul,2161,2080,81,3.7
Reagan County,2012-Aug,2065,1994,71,3.4
Reagan County,2012-Sep,2046,1979,67,3.3
Reagan County,2012-Oct,2031,1961,70,3.4
Reagan County,2012-Nov,1949,1880,69,3.5
Reagan County,2012-Dec,1971,1898,73,3.7
Reagan County,2013-Jan,1958,1872,86,4.4
Reagan County,2013-Feb,1932,1852,80,4.1
Reagan County,2013-Mar,1902,1825,77,4
Reagan County,2013-Apr,1985,1910,75,3.8
Reagan County,2013-May,1936,1860,76,3.9
Reagan County,2013-Jun,1938,1848,90,4.6
Reagan County,2013-Jul,1953,1866,87,4.5
Reagan County,2013-Aug,1926,1846,80,4.2
Reagan County,2013-Sep,1916,1838,78,4.1
Reagan County,2013-Oct,2009,1936,73,3.6
Reagan County,2013-Nov,1991,1922,69,3.5
Reagan County,2013-Dec,2007,1937,70,3.5
Reagan County,2014-Jan,2023,1943,80,4
Reagan County,2014-Feb,2005,1932,73,3.6
Reagan County,2014-Mar,1997,1927,70,3.5
Reagan County,2014-Apr,2017,1957,60,3
Reagan County,2014-May,2054,1986,68,3.3
Reagan County,2014-Jun,2088,2011,77,3.7
Reagan County,2014-Jul,2117,2038,79,3.7
Reagan County,2014-Aug,2119,2051,68,3.2
Reagan County,2014-Sep,2133,2070,63,3
Reagan County,2014-Oct,2164,2106,58,2.7
Reagan County,2014-Nov,2097,2040,57,2.7
Reagan County,2014-Dec,2077,2023,54,2.6
Reagan County,2015-Jan,2097,2024,73,3.5
Reagan County,2015-Feb,2058,1987,71,3.4
Reagan County,2015-Mar,2058,1985,73,3.5
Reagan County,2015-Apr,2023,1945,78,3.9
Reagan County,2015-May,1954,1866,88,4.5
Reagan County,2015-Jun,1973,1879,94,4.8
Reagan County,2015-Jul,1925,1831,94,4.9
Reagan County,2015-Aug,1907,1813,94,4.9
Reagan County,2015-Sep,1855,1764,91,4.9
Reagan County,2015-Oct,1791,1695,96,5.4
Reagan County,2015-Nov,1760,1656,104,5.9
Reagan County,2015-Dec,1749,1647,102,5.8
Reagan County,2016-Jan,1696,1597,99,5.8
Reagan County,2016-Feb,1701,1589,112,6.6
Reagan County,2016-Mar,1699,1594,105,6.2
Reagan County,2016-Apr,1722,1612,110,6.4
Reagan County,2016-May,1733,1623,110,6.3
Reagan County,2016-Jun,1747,1631,116,6.6
Reagan County,2016-Jul,1721,1610,111,6.4
Reagan County,2016-Aug,1721,1599,122,7.1
Reagan County,2016-Sep,1681,1569,112,6.7
Reagan County,2016-Oct,1666,1573,93,5.6
Reagan County,2016-Nov,1666,1579,87,5.2
Reagan County,2016-Dec,1668,1585,83,5
Reagan County,2017-Jan,1707,1620,87,5.1
Reagan County,2017-Feb,1743,1653,90,5.2
Reagan County,2017-Mar,1786,1703,83,4.6
Reagan County,2017-Apr,1782,1706,76,4.3
Reagan County,2017-May,1783,1714,69,3.9
Reagan County,2017-Jun,1803,1731,72,4
Reagan County,2017-Jul,1777,1709,68,3.8
Reagan County,2017-Aug,1822,1759,63,3.5
Reagan County,2017-Sep,1785,1725,60,3.4
Reagan County,2017-Oct,1790,1738,52,2.9
Reagan County,2017-Nov,1785,1730,55,3.1
Reagan County,2017-Dec,1798,1745,53,2.9
Reagan County,2018-Jan,1795,1736,59,3.3
Reagan County,2018-Feb,1849,1795,54,2.9
Reagan County,2018-Mar,1875,1826,49,2.6
Reagan County,2018-Apr,1873,1827,46,2.5
Reagan County,2018-May,1861,1820,41,2.2
Reagan County,2018-Jun,1886,1835,51,2.7
Reagan County,2018-Jul,1910,1861,49,2.6
Reagan County,2018-Aug,1916,1868,48,2.5
Reagan County,2018-Sep,1869,1828,41,2.2
Reagan County,2018-Oct,1839,1798,41,2.2
Reagan County,2018-Nov,1816,1776,40,2.2
Reagan County,2018-Dec,1783,1743,40,2.2
Reagan County,2019-Jan,1791,1745,46,2.6
Reagan County,2019-Feb,1824,1781,43,2.4
Reagan County,2019-Mar,1835,1794,41,2.2
Reagan County,2019-Apr,1917,1879,38,2
Reagan County,2019-May,1910,1869,41,2.1
Reagan County,2019-Jun,1933,1881,52,2.7
Reagan County,2019-Jul,1914,1860,54,2.8
Reagan County,2019-Aug,1907,1857,50,2.6
Reagan County,2019-Sep,1889,1835,54,2.9
Reagan County,2019-Oct,1878,1824,54,2.9
Reagan County,2019-Nov,1820,1769,51,2.8
Reagan County,2019-Dec,1829,1771,58,3.2
Reagan County,2020-Jan,1844,1785,59,3.2
Reagan County,2020-Feb,1875,1825,50,2.7
Reagan County,2020-Mar,1848,1766,82,4.4
Reagan County,2020-Apr,1813,1622,191,10.5
Reagan County,2020-May,1815,1566,249,13.7
Reagan County,2020-Jun,1816,1568,248,13.7
Reagan County,2020-Jul,1771,1533,238,13.4
Reagan County,2020-Aug,1782,1576,206,11.6
Reagan County,2020-Sep,1751,1541,210,12
Reagan County,2020-Oct,1740,1550,190,10.9
Reagan County,2020-Nov,1718,1527,191,11.1
Reagan County,2020-Dec,1698,1516,182,10.7
Reagan County,2021-Jan,1704,1523,181,10.6
Reagan County,2021-Feb,1695,1526,169,10
Reagan County,2021-Mar,1702,1555,147,8.6
Reagan County,2021-Apr,1670,1535,135,8.1
Reagan County,2021-May,1644,1513,131,8
Reagan County,2021-Jun,1646,1504,142,8.6
Reagan County,2021-Jul,1657,1532,125,7.5
Reagan County,2021-Aug,1661,1549,112,6.7
Reagan County,2021-Sep,1667,1561,106,6.4
Reagan County,2021-Oct,1622,1523,99,6.1
Reagan County,2021-Nov,1591,1499,92,5.8
Reagan County,2021-Dec,1575,1492,83,5.3
Reagan County,2022-Jan,1589,1495,94,5.9
Reagan County,2022-Feb,1615,1527,88,5.4
Reagan County,2022-Mar,1642,1565,77,4.7
Reagan County,2022-Apr,1595,1527,68,4.3
Reagan County,2022-May,1564,1496,68,4.3
Reagan County,2022-Jun,1562,1487,75,4.8
Reagan County,2022-Jul,1605(P),1531(P),74(P),4.6(P)
Real County,2012-Jan,1034,927,107,10.3
Real County,2012-Feb,1020,917,103,10.1
Real County,2012-Mar,1032,931,101,9.8
Real County,2012-Apr,1032,941,91,8.8
Real County,2012-May,1015,917,98,9.7
Real County,2012-Jun,1160,1048,112,9.7
Real County,2012-Jul,1192,1085,107,9
Real County,2012-Aug,1152,1050,102,8.9
Real County,2012-Sep,1058,963,95,9
Real County,2012-Oct,1030,940,90,8.7
Real County,2012-Nov,1026,937,89,8.7
Real County,2012-Dec,1019,927,92,9
Real County,2013-Jan,1016,919,97,9.5
Real County,2013-Feb,1021,931,90,8.8
Real County,2013-Mar,1017,933,84,8.3
Real County,2013-Apr,1041,961,80,7.7
Real County,2013-May,1061,978,83,7.8
Real County,2013-Jun,1186,1092,94,7.9
Real County,2013-Jul,1186,1093,93,7.8
Real County,2013-Aug,1130,1050,80,7.1
Real County,2013-Sep,1038,951,87,8.4
Real County,2013-Oct,1038,954,84,8.1
Real County,2013-Nov,980,900,80,8.2
Real County,2013-Dec,1014,939,75,7.4
Real County,2014-Jan,982,906,76,7.7
Real County,2014-Feb,1036,960,76,7.3
Real County,2014-Mar,1053,979,74,7
Real County,2014-Apr,1035,976,59,5.7
Real County,2014-May,1070,1002,68,6.4
Real County,2014-Jun,1177,1104,73,6.2
Real County,2014-Jul,1166,1092,74,6.3
Real County,2014-Aug,1135,1064,71,6.3
Real County,2014-Sep,1043,980,63,6
Real County,2014-Oct,1003,947,56,5.6
Real County,2014-Nov,1006,947,59,5.9
Real County,2014-Dec,980,930,50,5.1
Real County,2015-Jan,997,939,58,5.8
Real County,2015-Feb,1051,988,63,6
Real County,2015-Mar,1034,982,52,5
Real County,2015-Apr,1035,989,46,4.4
Real County,2015-May,1069,1012,57,5.3
Real County,2015-Jun,1191,1131,60,5
Real County,2015-Jul,1180,1122,58,4.9
Real County,2015-Aug,1081,1022,59,5.5
Real County,2015-Sep,1057,1004,53,5
Real County,2015-Oct,1044,992,52,5
Real County,2015-Nov,1020,966,54,5.3
Real County,2015-Dec,1009,959,50,5
Real County,2016-Jan,991,934,57,5.8
Real County,2016-Feb,1034,979,55,5.3
Real County,2016-Mar,1035,983,52,5
Real County,2016-Apr,1046,991,55,5.3
Real County,2016-May,1064,1011,53,5
Real County,2016-Jun,1203,1144,59,4.9
Real County,2016-Jul,1126,1063,63,5.6
Real County,2016-Aug,1010,949,61,6
Real County,2016-Sep,987,923,64,6.5
Real County,2016-Oct,997,933,64,6.4
Real County,2016-Nov,999,934,65,6.5
Real County,2016-Dec,1001,943,58,5.8
Real County,2017-Jan,1002,937,65,6.5
Real County,2017-Feb,1034,969,65,6.3
Real County,2017-Mar,1061,1000,61,5.7
Real County,2017-Apr,983,924,59,6
Real County,2017-May,987,932,55,5.6
Real County,2017-Jun,1144,1080,64,5.6
Real County,2017-Jul,1165,1095,70,6
Real County,2017-Aug,1129,1067,62,5.5
Real County,2017-Sep,999,944,55,5.5
Real County,2017-Oct,1012,959,53,5.2
Real County,2017-Nov,1029,970,59,5.7
Real County,2017-Dec,1012,959,53,5.2
Real County,2018-Jan,989,933,56,5.7
Real County,2018-Feb,1012,958,54,5.3
Real County,2018-Mar,1041,986,55,5.3
Real County,2018-Apr,1029,974,55,5.3
Real County,2018-May,1053,1003,50,4.7
Real County,2018-Jun,1159,1102,57,4.9
Real County,2018-Jul,1122,1067,55,4.9
Real County,2018-Aug,1138,1085,53,4.7
Real County,2018-Sep,1001,946,55,5.5
Real County,2018-Oct,986,939,47,4.8
Real County,2018-Nov,981,933,48,4.9
Real County,2018-Dec,961,917,44,4.6
Real County,2019-Jan,1012,960,52,5.1
Real County,2019-Feb,998,955,43,4.3
Real County,2019-Mar,1025,982,43,4.2
Real County,2019-Apr,1041,1006,35,3.4
Real County,2019-May,1050,1014,36,3.4
Real County,2019-Jun,1208,1157,51,4.2
Real County,2019-Jul,1156,1111,45,3.9
Real County,2019-Aug,1117,1078,39,3.5
Real County,2019-Sep,985,945,40,4.1
Real County,2019-Oct,1007,969,38,3.8
Real County,2019-Nov,980,942,38,3.9
Real County,2019-Dec,1002,968,34,3.4
Real County,2020-Jan,1018,977,41,4
Real County,2020-Feb,1027,984,43,4.2
Real County,2020-Mar,1045,976,69,6.6
Real County,2020-Apr,960,889,71,7.4
Real County,2020-May,1012,926,86,8.5
Real County,2020-Jun,1045,958,87,8.3
Real County,2020-Jul,1162,1068,94,8.1
Real County,2020-Aug,1156,1084,72,6.2
Real County,2020-Sep,1102,1027,75,6.8
Real County,2020-Oct,1123,1062,61,5.4
Real County,2020-Nov,1135,1065,70,6.2
Real County,2020-Dec,1111,1040,71,6.4
Real County,2021-Jan,1077,1001,76,7.1
Real County,2021-Feb,1111,1029,82,7.4
Real County,2021-Mar,1124,1052,72,6.4
Real County,2021-Apr,1249,1178,71,5.7
Real County,2021-May,1228,1161,67,5.5
Real County,2021-Jun,1246,1175,71,5.7
Real County,2021-Jul,1219,1150,69,5.7
Real County,2021-Aug,1174,1103,71,6
Real County,2021-Sep,1079,1012,67,6.2
Real County,2021-Oct,1085,1024,61,5.6
Real County,2021-Nov,1075,1019,56,5.2
Real County,2021-Dec,1057,1007,50,4.7
Real County,2022-Jan,1047,988,59,5.6
Real County,2022-Feb,1097,1034,63,5.7
Real County,2022-Mar,1122,1072,50,4.5
Real County,2022-Apr,1177,1131,46,3.9
Real County,2022-May,1170,1119,51,4.4
Real County,2022-Jun,1198,1141,57,4.8
Real County,2022-Jul,1242(P),1187(P),55(P),4.4(P)
Red River County,2012-Jan,5315,4696,619,11.6
Red River County,2012-Feb,5296,4701,595,11.2
Red River County,2012-Mar,5256,4703,553,10.5
Red River County,2012-Apr,5282,4760,522,9.9
Red River County,2012-May,5271,4733,538,10.2
Red River County,2012-Jun,5318,4712,606,11.4
Red River County,2012-Jul,5285,4664,621,11.8
Red River County,2012-Aug,5197,4638,559,10.8
Red River County,2012-Sep,5207,4676,531,10.2
Red River County,2012-Oct,5223,4697,526,10.1
Red River County,2012-Nov,5178,4676,502,9.7
Red River County,2012-Dec,5155,4629,526,10.2
Red River County,2013-Jan,5208,4645,563,10.8
Red River County,2013-Feb,5216,4675,541,10.4
Red River County,2013-Mar,5168,4627,541,10.5
Red River County,2013-Apr,5164,4637,527,10.2
Red River County,2013-May,5173,4647,526,10.2
Red River County,2013-Jun,5190,4640,550,10.6
Red River County,2013-Jul,5108,4579,529,10.4
Red River County,2013-Aug,5034,4512,522,10.4
Red River County,2013-Sep,5120,4609,511,10
Red River County,2013-Oct,5087,4582,505,9.9
Red River County,2013-Nov,5081,4611,470,9.3
Red River County,2013-Dec,5045,4597,448,8.9
Red River County,2014-Jan,5017,4530,487,9.7
Red River County,2014-Feb,5020,4569,451,9
Red River County,2014-Mar,5001,4571,430,8.6
Red River County,2014-Apr,4973,4591,382,7.7
Red River County,2014-May,4959,4569,390,7.9
Red River County,2014-Jun,4919,4516,403,8.2
Red River County,2014-Jul,4887,4483,404,8.3
Red River County,2014-Aug,4777,4388,389,8.1
Red River County,2014-Sep,4890,4532,358,7.3
Red River County,2014-Oct,4923,4589,334,6.8
Red River County,2014-Nov,4912,4590,322,6.6
Red River County,2014-Dec,4899,4595,304,6.2
Red River County,2015-Jan,4927,4560,367,7.4
Red River County,2015-Feb,4919,4579,340,6.9
Red River County,2015-Mar,4908,4592,316,6.4
Red River County,2015-Apr,4856,4562,294,6.1
Red River County,2015-May,4879,4569,310,6.4
Red River County,2015-Jun,4916,4599,317,6.4
Red River County,2015-Jul,4918,4605,313,6.4
Red River County,2015-Aug,4934,4631,303,6.1
Red River County,2015-Sep,4910,4603,307,6.3
Red River County,2015-Oct,4934,4632,302,6.1
Red River County,2015-Nov,4920,4625,295,6
Red River County,2015-Dec,4930,4647,283,5.7
Red River County,2016-Jan,4893,4611,282,5.8
Red River County,2016-Feb,4960,4682,278,5.6
Red River County,2016-Mar,4961,4684,277,5.6
Red River County,2016-Apr,5002,4739,263,5.3
Red River County,2016-May,4999,4737,262,5.2
Red River County,2016-Jun,5047,4740,307,6.1
Red River County,2016-Jul,5080,4752,328,6.5
Red River County,2016-Aug,5111,4796,315,6.2
Red River County,2016-Sep,5094,4784,310,6.1
Red River County,2016-Oct,5058,4770,288,5.7
Red River County,2016-Nov,5076,4782,294,5.8
Red River County,2016-Dec,5142,4845,297,5.8
Red River County,2017-Jan,5184,4857,327,6.3
Red River County,2017-Feb,5210,4892,318,6.1
Red River County,2017-Mar,5229,4941,288,5.5
Red River County,2017-Apr,5220,4962,258,4.9
Red River County,2017-May,5170,4916,254,4.9
Red River County,2017-Jun,5271,4989,282,5.4
Red River County,2017-Jul,5167,4884,283,5.5
Red River County,2017-Aug,5107,4822,285,5.6
Red River County,2017-Sep,5129,4879,250,4.9
Red River County,2017-Oct,5076,4841,235,4.6
Red River County,2017-Nov,5073,4830,243,4.8
Red River County,2017-Dec,5100,4847,253,5
Red River County,2018-Jan,5077,4796,281,5.5
Red River County,2018-Feb,5101,4815,286,5.6
Red River County,2018-Mar,5132,4870,262,5.1
Red River County,2018-Apr,5039,4785,254,5
Red River County,2018-May,5028,4764,264,5.3
Red River County,2018-Jun,5084,4776,308,6.1
Red River County,2018-Jul,5024,4723,301,6
Red River County,2018-Aug,4983,4693,290,5.8
Red River County,2018-Sep,5009,4717,292,5.8
Red River County,2018-Oct,5012,4749,263,5.2
Red River County,2018-Nov,5002,4753,249,5
Red River County,2018-Dec,4988,4738,250,5
Red River County,2019-Jan,4964,4685,279,5.6
Red River County,2019-Feb,4987,4741,246,4.9
Red River County,2019-Mar,4981,4749,232,4.7
Red River County,2019-Apr,5015,4814,201,4
Red River County,2019-May,5004,4804,200,4
Red River County,2019-Jun,5008,4772,236,4.7
Red River County,2019-Jul,5022,4777,245,4.9
Red River County,2019-Aug,5106,4846,260,5.1
Red River County,2019-Sep,5060,4831,229,4.5
Red River County,2019-Oct,5055,4836,219,4.3
Red River County,2019-Nov,5003,4781,222,4.4
Red River County,2019-Dec,5015,4801,214,4.3
Red River County,2020-Jan,5067,4829,238,4.7
Red River County,2020-Feb,5061,4837,224,4.4
Red River County,2020-Mar,5048,4723,325,6.4
Red River County,2020-Apr,4742,4382,360,7.6
Red River County,2020-May,4936,4545,391,7.9
Red River County,2020-Jun,5035,4619,416,8.3
Red River County,2020-Jul,5105,4723,382,7.5
Red River County,2020-Aug,5190,4896,294,5.7
Red River County,2020-Sep,5221,4910,311,6
Red River County,2020-Oct,5161,4868,293,5.7
Red River County,2020-Nov,5114,4800,314,6.1
Red River County,2020-Dec,5152,4822,330,6.4
Red River County,2021-Jan,5262,4887,375,7.1
Red River County,2021-Feb,5341,4959,382,7.2
Red River County,2021-Mar,5365,5017,348,6.5
Red River County,2021-Apr,5349,5033,316,5.9
Red River County,2021-May,5279,4971,308,5.8
Red River County,2021-Jun,5295,4970,325,6.1
Red River County,2021-Jul,5390,5078,312,5.8
Red River County,2021-Aug,5367,5068,299,5.6
Red River County,2021-Sep,5372,5079,293,5.5
Red River County,2021-Oct,5291,5018,273,5.2
Red River County,2021-Nov,5261,4986,275,5.2
Red River County,2021-Dec,5276,5010,266,5
Red River County,2022-Jan,5345,5041,304,5.7
Red River County,2022-Feb,5395,5096,299,5.5
Red River County,2022-Mar,5449,5206,243,4.5
Red River County,2022-Apr,5349,5109,240,4.5
Red River County,2022-May,5343,5098,245,4.6
Red River County,2022-Jun,5372,5086,286,5.3
Red River County,2022-Jul,5428(P),5143(P),285(P),5.3(P)
Reeves County,2012-Jan,5150,4759,391,7.6
Reeves County,2012-Feb,5171,4798,373,7.2
Reeves County,2012-Mar,5210,4867,343,6.6
Reeves County,2012-Apr,5189,4862,327,6.3
Reeves County,2012-May,5242,4902,340,6.5
Reeves County,2012-Jun,5350,4953,397,7.4
Reeves County,2012-Jul,5452,5050,402,7.4
Reeves County,2012-Aug,5453,5081,372,6.8
Reeves County,2012-Sep,5432,5091,341,6.3
Reeves County,2012-Oct,5439,5100,339,6.2
Reeves County,2012-Nov,5432,5113,319,5.9
Reeves County,2012-Dec,5441,5112,329,6
Reeves County,2013-Jan,5483,5129,354,6.5
Reeves County,2013-Feb,5518,5184,334,6.1
Reeves County,2013-Mar,5524,5204,320,5.8
Reeves County,2013-Apr,5568,5257,311,5.6
Reeves County,2013-May,5583,5256,327,5.9
Reeves County,2013-Jun,5695,5319,376,6.6
Reeves County,2013-Jul,5733,5365,368,6.4
Reeves County,2013-Aug,5714,5367,347,6.1
Reeves County,2013-Sep,5646,5321,325,5.8
Reeves County,2013-Oct,5620,5322,298,5.3
Reeves County,2013-Nov,5613,5334,279,5
Reeves County,2013-Dec,5717,5448,269,4.7
Reeves County,2014-Jan,5664,5395,269,4.7
Reeves County,2014-Feb,5718,5448,270,4.7
Reeves County,2014-Mar,5711,5458,253,4.4
Reeves County,2014-Apr,5749,5533,216,3.8
Reeves County,2014-May,5779,5542,237,4.1
Reeves County,2014-Jun,5840,5580,260,4.5
Reeves County,2014-Jul,5821,5555,266,4.6
Reeves County,2014-Aug,5779,5539,240,4.2
Reeves County,2014-Sep,5741,5521,220,3.8
Reeves County,2014-Oct,5765,5564,201,3.5
Reeves County,2014-Nov,5731,5531,200,3.5
Reeves County,2014-Dec,5707,5524,183,3.2
Reeves County,2015-Jan,5779,5555,224,3.9
Reeves County,2015-Feb,5729,5499,230,4
Reeves County,2015-Mar,5541,5310,231,4.2
Reeves County,2015-Apr,5605,5368,237,4.2
Reeves County,2015-May,5644,5377,267,4.7
Reeves County,2015-Jun,5655,5357,298,5.3
Reeves County,2015-Jul,5702,5395,307,5.4
Reeves County,2015-Aug,5582,5289,293,5.2
Reeves County,2015-Sep,5661,5358,303,5.4
Reeves County,2015-Oct,5732,5417,315,5.5
Reeves County,2015-Nov,5729,5422,307,5.4
Reeves County,2015-Dec,5806,5528,278,4.8
Reeves County,2016-Jan,5942,5654,288,4.8
Reeves County,2016-Feb,5992,5686,306,5.1
Reeves County,2016-Mar,6053,5711,342,5.7
Reeves County,2016-Apr,6004,5646,358,6
Reeves County,2016-May,5935,5600,335,5.6
Reeves County,2016-Jun,6050,5698,352,5.8
Reeves County,2016-Jul,6104,5751,353,5.8
Reeves County,2016-Aug,6058,5724,334,5.5
Reeves County,2016-Sep,6088,5762,326,5.4
Reeves County,2016-Oct,6079,5781,298,4.9
Reeves County,2016-Nov,6032,5746,286,4.7
Reeves County,2016-Dec,6089,5815,274,4.5
Reeves County,2017-Jan,6203,5901,302,4.9
Reeves County,2017-Feb,6204,5909,295,4.8
Reeves County,2017-Mar,6378,6124,254,4
Reeves County,2017-Apr,6506,6270,236,3.6
Reeves County,2017-May,6658,6421,237,3.6
Reeves County,2017-Jun,6897,6660,237,3.4
Reeves County,2017-Jul,6979,6746,233,3.3
Reeves County,2017-Aug,7260,6955,305,4.2
Reeves County,2017-Sep,7351,7099,252,3.4
Reeves County,2017-Oct,7615,7397,218,2.9
Reeves County,2017-Nov,7647,7429,218,2.9
Reeves County,2017-Dec,7607,7395,212,2.8
Reeves County,2018-Jan,8552,8325,227,2.7
Reeves County,2018-Feb,8650,8428,222,2.6
Reeves County,2018-Mar,8699,8485,214,2.5
Reeves County,2018-Apr,8852,8664,188,2.1
Reeves County,2018-May,9053,8868,185,2
Reeves County,2018-Jun,9304,9093,211,2.3
Reeves County,2018-Jul,9323,9116,207,2.2
Reeves County,2018-Aug,9304,9109,195,2.1
Reeves County,2018-Sep,9216,9035,181,2
Reeves County,2018-Oct,10318,10152,166,1.6
Reeves County,2018-Nov,10311,10142,169,1.6
Reeves County,2018-Dec,10229,10058,171,1.7
Reeves County,2019-Jan,10710,10518,192,1.8
Reeves County,2019-Feb,10992,10806,186,1.7
Reeves County,2019-Mar,10910,10726,184,1.7
Reeves County,2019-Apr,10798,10634,164,1.5
Reeves County,2019-May,11157,10992,165,1.5
Reeves County,2019-Jun,11442,11230,212,1.9
Reeves County,2019-Jul,11086,10870,216,1.9
Reeves County,2019-Aug,11216,11010,206,1.8
Reeves County,2019-Sep,11064,10851,213,1.9
Reeves County,2019-Oct,11297,11108,189,1.7
Reeves County,2019-Nov,10998,10790,208,1.9
Reeves County,2019-Dec,10692,10491,201,1.9
Reeves County,2020-Jan,10555,10310,245,2.3
Reeves County,2020-Feb,10286,10052,234,2.3
Reeves County,2020-Mar,9970,9574,396,4
Reeves County,2020-Apr,8509,7935,574,6.7
Reeves County,2020-May,8427,7586,841,10
Reeves County,2020-Jun,8307,7421,886,10.7
Reeves County,2020-Jul,8223,7381,842,10.2
Reeves County,2020-Aug,8127,7399,728,9
Reeves County,2020-Sep,8071,7343,728,9
Reeves County,2020-Oct,8155,7464,691,8.5
Reeves County,2020-Nov,8154,7458,696,8.5
Reeves County,2020-Dec,8101,7423,678,8.4
Reeves County,2021-Jan,8448,7805,643,7.6
Reeves County,2021-Feb,8612,7999,613,7.1
Reeves County,2021-Mar,8600,8032,568,6.6
Reeves County,2021-Apr,8615,8059,556,6.5
Reeves County,2021-May,8527,8016,511,6
Reeves County,2021-Jun,8541,7981,560,6.6
Reeves County,2021-Jul,8635,8136,499,5.8
Reeves County,2021-Aug,8547,8076,471,5.5
Reeves County,2021-Sep,8594,8154,440,5.1
Reeves County,2021-Oct,8752,8322,430,4.9
Reeves County,2021-Nov,8769,8372,397,4.5
Reeves County,2021-Dec,8663,8286,377,4.4
Reeves County,2022-Jan,8979,8563,416,4.6
Reeves County,2022-Feb,9115,8712,403,4.4
Reeves County,2022-Mar,9114,8794,320,3.5
Reeves County,2022-Apr,9242,8964,278,3
Reeves County,2022-May,9188,8913,275,3
Reeves County,2022-Jun,9166,8863,303,3.3
Reeves County,2022-Jul,9420(P),9080(P),340(P),3.6(P)
Refugio County,2012-Jan,3424,3197,227,6.6
Refugio County,2012-Feb,3439,3208,231,6.7
Refugio County,2012-Mar,3458,3254,204,5.9
Refugio County,2012-Apr,3473,3274,199,5.7
Refugio County,2012-May,3510,3306,204,5.8
Refugio County,2012-Jun,3536,3312,224,6.3
Refugio County,2012-Jul,3596,3362,234,6.5
Refugio County,2012-Aug,3520,3303,217,6.2
Refugio County,2012-Sep,3557,3359,198,5.6
Refugio County,2012-Oct,3504,3315,189,5.4
Refugio County,2012-Nov,3496,3311,185,5.3
Refugio County,2012-Dec,3490,3288,202,5.8
Refugio County,2013-Jan,3528,3310,218,6.2
Refugio County,2013-Feb,3526,3315,211,6
Refugio County,2013-Mar,3512,3314,198,5.6
Refugio County,2013-Apr,3562,3376,186,5.2
Refugio County,2013-May,3585,3390,195,5.4
Refugio County,2013-Jun,3644,3418,226,6.2
Refugio County,2013-Jul,3632,3420,212,5.8
Refugio County,2013-Aug,3554,3366,188,5.3
Refugio County,2013-Sep,3554,3363,191,5.4
Refugio County,2013-Oct,3550,3375,175,4.9
Refugio County,2013-Nov,3506,3345,161,4.6
Refugio County,2013-Dec,3512,3357,155,4.4
Refugio County,2014-Jan,3570,3405,165,4.6
Refugio County,2014-Feb,3603,3445,158,4.4
Refugio County,2014-Mar,3658,3499,159,4.3
Refugio County,2014-Apr,3632,3484,148,4.1
Refugio County,2014-May,3646,3492,154,4.2
Refugio County,2014-Jun,3637,3471,166,4.6
Refugio County,2014-Jul,3635,3466,169,4.6
Refugio County,2014-Aug,3559,3399,160,4.5
Refugio County,2014-Sep,3569,3414,155,4.3
Refugio County,2014-Oct,3576,3427,149,4.2
Refugio County,2014-Nov,3544,3395,149,4.2
Refugio County,2014-Dec,3513,3380,133,3.8
Refugio County,2015-Jan,3415,3268,147,4.3
Refugio County,2015-Feb,3406,3236,170,5
Refugio County,2015-Mar,3432,3262,170,5
Refugio County,2015-Apr,3384,3209,175,5.2
Refugio County,2015-May,3392,3213,179,5.3
Refugio County,2015-Jun,3358,3166,192,5.7
Refugio County,2015-Jul,3269,3076,193,5.9
Refugio County,2015-Aug,3220,3028,192,6
Refugio County,2015-Sep,3277,3092,185,5.6
Refugio County,2015-Oct,3197,3023,174,5.4
Refugio County,2015-Nov,3200,3020,180,5.6
Refugio County,2015-Dec,3145,2975,170,5.4
Refugio County,2016-Jan,3124,2937,187,6
Refugio County,2016-Feb,3172,2985,187,5.9
Refugio County,2016-Mar,3193,3000,193,6
Refugio County,2016-Apr,3160,2957,203,6.4
Refugio County,2016-May,3155,2953,202,6.4
Refugio County,2016-Jun,3165,2940,225,7.1
Refugio County,2016-Jul,3116,2886,230,7.4
Refugio County,2016-Aug,3117,2896,221,7.1
Refugio County,2016-Sep,3124,2894,230,7.4
Refugio County,2016-Oct,3115,2900,215,6.9
Refugio County,2016-Nov,3096,2895,201,6.5
Refugio County,2016-Dec,3111,2910,201,6.5
Refugio County,2017-Jan,3090,2883,207,6.7
Refugio County,2017-Feb,3163,2970,193,6.1
Refugio County,2017-Mar,3179,3012,167,5.3
Refugio County,2017-Apr,3276,3122,154,4.7
Refugio County,2017-May,3338,3189,149,4.5
Refugio County,2017-Jun,3312,3146,166,5
Refugio County,2017-Jul,3292,3132,160,4.9
Refugio County,2017-Aug,3241,3077,164,5.1
Refugio County,2017-Sep,3221,2986,235,7.3
Refugio County,2017-Oct,3199,2999,200,6.3
Refugio County,2017-Nov,3176,2977,199,6.3
Refugio County,2017-Dec,3132,2951,181,5.8
Refugio County,2018-Jan,3112,2930,182,5.8
Refugio County,2018-Feb,3117,2948,169,5.4
Refugio County,2018-Mar,3154,2997,157,5
Refugio County,2018-Apr,3113,2963,150,4.8
Refugio County,2018-May,3135,2994,141,4.5
Refugio County,2018-Jun,3110,2949,161,5.2
Refugio County,2018-Jul,3115,2964,151,4.8
Refugio County,2018-Aug,3084,2951,133,4.3
Refugio County,2018-Sep,3103,2975,128,4.1
Refugio County,2018-Oct,3097,2978,119,3.8
Refugio County,2018-Nov,3066,2949,117,3.8
Refugio County,2018-Dec,3076,2956,120,3.9
Refugio County,2019-Jan,3081,2938,143,4.6
Refugio County,2019-Feb,3094,2968,126,4.1
Refugio County,2019-Mar,3114,3002,112,3.6
Refugio County,2019-Apr,3101,3005,96,3.1
Refugio County,2019-May,3143,3041,102,3.2
Refugio County,2019-Jun,3126,3005,121,3.9
Refugio County,2019-Jul,3102,2981,121,3.9
Refugio County,2019-Aug,3132,3014,118,3.8
Refugio County,2019-Sep,3102,2986,116,3.7
Refugio County,2019-Oct,3133,3014,119,3.8
Refugio County,2019-Nov,3095,2984,111,3.6
Refugio County,2019-Dec,3099,2999,100,3.2
Refugio County,2020-Jan,3089,2967,122,3.9
Refugio County,2020-Feb,3100,2991,109,3.5
Refugio County,2020-Mar,3058,2886,172,5.6
Refugio County,2020-Apr,2905,2612,293,10.1
Refugio County,2020-May,2977,2634,343,11.5
Refugio County,2020-Jun,3054,2715,339,11.1
Refugio County,2020-Jul,3035,2702,333,11
Refugio County,2020-Aug,3054,2781,273,8.9
Refugio County,2020-Sep,3033,2768,265,8.7
Refugio County,2020-Oct,3013,2767,246,8.2
Refugio County,2020-Nov,2980,2736,244,8.2
Refugio County,2020-Dec,2974,2722,252,8.5
Refugio County,2021-Jan,3008,2744,264,8.8
Refugio County,2021-Feb,3064,2813,251,8.2
Refugio County,2021-Mar,3073,2834,239,7.8
Refugio County,2021-Apr,3063,2860,203,6.6
Refugio County,2021-May,3026,2832,194,6.4
Refugio County,2021-Jun,3027,2815,212,7
Refugio County,2021-Jul,3035,2838,197,6.5
Refugio County,2021-Aug,3055,2862,193,6.3
Refugio County,2021-Sep,3064,2880,184,6
Refugio County,2021-Oct,3029,2850,179,5.9
Refugio County,2021-Nov,3007,2836,171,5.7
Refugio County,2021-Dec,2986,2829,157,5.3
Refugio County,2022-Jan,3010,2823,187,6.2
Refugio County,2022-Feb,3084,2904,180,5.8
Refugio County,2022-Mar,3102,2955,147,4.7
Refugio County,2022-Apr,3052,2914,138,4.5
Refugio County,2022-May,3035,2884,151,5
Refugio County,2022-Jun,3051,2880,171,5.6
Refugio County,2022-Jul,3067(P),2903(P),164(P),5.3(P)
Roberts County,2012-Jan,463,441,22,4.8
Roberts County,2012-Feb,465,442,23,4.9
Roberts County,2012-Mar,468,443,25,5.3
Roberts County,2012-Apr,476,452,24,5
Roberts County,2012-May,472,446,26,5.5
Roberts County,2012-Jun,492,466,26,5.3
Roberts County,2012-Jul,488,464,24,4.9
Roberts County,2012-Aug,473,450,23,4.9
Roberts County,2012-Sep,467,444,23,4.9
Roberts County,2012-Oct,460,441,19,4.1
Roberts County,2012-Nov,457,436,21,4.6
Roberts County,2012-Dec,459,435,24,5.2
Roberts County,2013-Jan,443,418,25,5.6
Roberts County,2013-Feb,444,423,21,4.7
Roberts County,2013-Mar,443,423,20,4.5
Roberts County,2013-Apr,451,433,18,4
Roberts County,2013-May,459,440,19,4.1
Roberts County,2013-Jun,473,451,22,4.7
Roberts County,2013-Jul,464,444,20,4.3
Roberts County,2013-Aug,458,437,21,4.6
Roberts County,2013-Sep,452,433,19,4.2
Roberts County,2013-Oct,440,422,18,4.1
Roberts County,2013-Nov,434,415,19,4.4
Roberts County,2013-Dec,429,414,15,3.5
Roberts County,2014-Jan,451,433,18,4
Roberts County,2014-Feb,454,435,19,4.2
Roberts County,2014-Mar,453,435,18,4
Roberts County,2014-Apr,448,432,16,3.6
Roberts County,2014-May,451,436,15,3.3
Roberts County,2014-Jun,462,444,18,3.9
Roberts County,2014-Jul,460,442,18,3.9
Roberts County,2014-Aug,447,430,17,3.8
Roberts County,2014-Sep,455,440,15,3.3
Roberts County,2014-Oct,445,430,15,3.4
Roberts County,2014-Nov,441,426,15,3.4
Roberts County,2014-Dec,428,414,14,3.3
Roberts County,2015-Jan,440,423,17,3.9
Roberts County,2015-Feb,450,432,18,4
Roberts County,2015-Mar,459,441,18,3.9
Roberts County,2015-Apr,459,442,17,3.7
Roberts County,2015-May,478,457,21,4.4
Roberts County,2015-Jun,486,464,22,4.5
Roberts County,2015-Jul,461,442,19,4.1
Roberts County,2015-Aug,457,437,20,4.4
Roberts County,2015-Sep,448,429,19,4.2
Roberts County,2015-Oct,457,439,18,3.9
Roberts County,2015-Nov,436,422,14,3.2
Roberts County,2015-Dec,437,422,15,3.4
Roberts County,2016-Jan,429,413,16,3.7
Roberts County,2016-Feb,444,428,16,3.6
Roberts County,2016-Mar,445,428,17,3.8
Roberts County,2016-Apr,436,421,15,3.4
Roberts County,2016-May,452,432,20,4.4
Roberts County,2016-Jun,458,431,27,5.9
Roberts County,2016-Jul,453,430,23,5.1
Roberts County,2016-Aug,454,431,23,5.1
Roberts County,2016-Sep,437,416,21,4.8
Roberts County,2016-Oct,436,416,20,4.6
Roberts County,2016-Nov,432,412,20,4.6
Roberts County,2016-Dec,426,407,19,4.5
Roberts County,2017-Jan,437,414,23,5.3
Roberts County,2017-Feb,430,406,24,5.6
Roberts County,2017-Mar,447,427,20,4.5
Roberts County,2017-Apr,441,425,16,3.6
Roberts County,2017-May,448,431,17,3.8
Roberts County,2017-Jun,457,440,17,3.7
Roberts County,2017-Jul,435,419,16,3.7
Roberts County,2017-Aug,435,418,17,3.9
Roberts County,2017-Sep,434,420,14,3.2
Roberts County,2017-Oct,432,419,13,3
Roberts County,2017-Nov,434,420,14,3.2
Roberts County,2017-Dec,424,412,12,2.8
Roberts County,2018-Jan,425,413,12,2.8
Roberts County,2018-Feb,429,417,12,2.8
Roberts County,2018-Mar,443,431,12,2.7
Roberts County,2018-Apr,425,414,11,2.6
Roberts County,2018-May,428,417,11,2.6
Roberts County,2018-Jun,440,424,16,3.6
Roberts County,2018-Jul,428,414,14,3.3
Roberts County,2018-Aug,429,416,13,3
Roberts County,2018-Sep,418,406,12,2.9
Roberts County,2018-Oct,413,402,11,2.7
Roberts County,2018-Nov,414,403,11,2.7
Roberts County,2018-Dec,402,389,13,3.2
Roberts County,2019-Jan,386,372,14,3.6
Roberts County,2019-Feb,394,381,13,3.3
Roberts County,2019-Mar,402,389,13,3.2
Roberts County,2019-Apr,397,384,13,3.3
Roberts County,2019-May,406,393,13,3.2
Roberts County,2019-Jun,422,407,15,3.6
Roberts County,2019-Jul,421,407,14,3.3
Roberts County,2019-Aug,430,417,13,3
Roberts County,2019-Sep,418,407,11,2.6
Roberts County,2019-Oct,425,415,10,2.4
Roberts County,2019-Nov,423,413,10,2.4
Roberts County,2019-Dec,422,412,10,2.4
Roberts County,2020-Jan,404,394,10,2.5
Roberts County,2020-Feb,411,398,13,3.2
Roberts County,2020-Mar,413,392,21,5.1
Roberts County,2020-Apr,383,364,19,5
Roberts County,2020-May,388,365,23,5.9
Roberts County,2020-Jun,393,374,19,4.8
Roberts County,2020-Jul,402,381,21,5.2
Roberts County,2020-Aug,414,395,19,4.6
Roberts County,2020-Sep,401,380,21,5.2
Roberts County,2020-Oct,404,386,18,4.5
Roberts County,2020-Nov,389,374,15,3.9
Roberts County,2020-Dec,389,372,17,4.4
Roberts County,2021-Jan,396,378,18,4.5
Roberts County,2021-Feb,403,383,20,5
Roberts County,2021-Mar,407,389,18,4.4
Roberts County,2021-Apr,405,389,16,4
Roberts County,2021-May,396,381,15,3.8
Roberts County,2021-Jun,410,392,18,4.4
Roberts County,2021-Jul,402,386,16,4
Roberts County,2021-Aug,402,386,16,4
Roberts County,2021-Sep,395,380,15,3.8
Roberts County,2021-Oct,395,377,18,4.6
Roberts County,2021-Nov,390,371,19,4.9
Roberts County,2021-Dec,384,367,17,4.4
Roberts County,2022-Jan,382,366,16,4.2
Roberts County,2022-Feb,399,380,19,4.8
Roberts County,2022-Mar,407,392,15,3.7
Roberts County,2022-Apr,401,388,13,3.2
Roberts County,2022-May,396,382,14,3.5
Roberts County,2022-Jun,405,389,16,4
Roberts County,2022-Jul,412(P),397(P),15(P),3.6(P)
Robertson County,2012-Jan,7003,6376,627,9
Robertson County,2012-Feb,7229,6610,619,8.6
Robertson County,2012-Mar,7218,6631,587,8.1
Robertson County,2012-Apr,7327,6777,550,7.5
Robertson County,2012-May,7390,6815,575,7.8
Robertson County,2012-Jun,7272,6646,626,8.6
Robertson County,2012-Jul,7185,6564,621,8.6
Robertson County,2012-Aug,7075,6494,581,8.2
Robertson County,2012-Sep,7361,6807,554,7.5
Robertson County,2012-Oct,7414,6869,545,7.4
Robertson County,2012-Nov,7422,6892,530,7.1
Robertson County,2012-Dec,7359,6808,551,7.5
Robertson County,2013-Jan,7067,6473,594,8.4
Robertson County,2013-Feb,7280,6710,570,7.8
Robertson County,2013-Mar,7240,6711,529,7.3
Robertson County,2013-Apr,7255,6752,503,6.9
Robertson County,2013-May,7327,6811,516,7
Robertson County,2013-Jun,7189,6617,572,8
Robertson County,2013-Jul,7095,6552,543,7.7
Robertson County,2013-Aug,7119,6620,499,7
Robertson County,2013-Sep,7438,6952,486,6.5
Robertson County,2013-Oct,7458,6994,464,6.2
Robertson County,2013-Nov,7451,6992,459,6.2
Robertson County,2013-Dec,7368,6945,423,5.7
Robertson County,2014-Jan,6952,6509,443,6.4
Robertson County,2014-Feb,7203,6766,437,6.1
Robertson County,2014-Mar,7195,6784,411,5.7
Robertson County,2014-Apr,7190,6839,351,4.9
Robertson County,2014-May,7246,6862,384,5.3
Robertson County,2014-Jun,7058,6641,417,5.9
Robertson County,2014-Jul,7023,6592,431,6.1
Robertson County,2014-Aug,6983,6568,415,5.9
Robertson County,2014-Sep,7203,6822,381,5.3
Robertson County,2014-Oct,7243,6900,343,4.7
Robertson County,2014-Nov,7241,6901,340,4.7
Robertson County,2014-Dec,7120,6807,313,4.4
Robertson County,2015-Jan,7253,6892,361,5
Robertson County,2015-Feb,7372,7033,339,4.6
Robertson County,2015-Mar,7386,7072,314,4.3
Robertson County,2015-Apr,7254,6934,320,4.4
Robertson County,2015-May,7337,7000,337,4.6
Robertson County,2015-Jun,7109,6731,378,5.3
Robertson County,2015-Jul,7025,6635,390,5.6
Robertson County,2015-Aug,7023,6658,365,5.2
Robertson County,2015-Sep,7288,6932,356,4.9
Robertson County,2015-Oct,7361,7021,340,4.6
Robertson County,2015-Nov,7344,6998,346,4.7
Robertson County,2015-Dec,7258,6926,332,4.6
Robertson County,2016-Jan,7106,6760,346,4.9
Robertson County,2016-Feb,7332,6986,346,4.7
Robertson County,2016-Mar,7367,7010,357,4.8
Robertson County,2016-Apr,7319,6975,344,4.7
Robertson County,2016-May,7405,7060,345,4.7
Robertson County,2016-Jun,7134,6728,406,5.7
Robertson County,2016-Jul,7072,6653,419,5.9
Robertson County,2016-Aug,7024,6631,393,5.6
Robertson County,2016-Sep,7312,6931,381,5.2
Robertson County,2016-Oct,7349,6992,357,4.9
Robertson County,2016-Nov,7376,7017,359,4.9
Robertson County,2016-Dec,7305,6941,364,5
Robertson County,2017-Jan,7262,6836,426,5.9
Robertson County,2017-Feb,7462,7068,394,5.3
Robertson County,2017-Mar,7567,7197,370,4.9
Robertson County,2017-Apr,7493,7165,328,4.4
Robertson County,2017-May,7445,7107,338,4.5
Robertson County,2017-Jun,7172,6790,382,5.3
Robertson County,2017-Jul,7165,6797,368,5.1
Robertson County,2017-Aug,7140,6766,374,5.2
Robertson County,2017-Sep,7420,7105,315,4.2
Robertson County,2017-Oct,7526,7235,291,3.9
Robertson County,2017-Nov,7564,7241,323,4.3
Robertson County,2017-Dec,7487,7172,315,4.2
Robertson County,2018-Jan,7301,6954,347,4.8
Robertson County,2018-Feb,7512,7186,326,4.3
Robertson County,2018-Mar,7595,7284,311,4.1
Robertson County,2018-Apr,7519,7229,290,3.9
Robertson County,2018-May,7519,7224,295,3.9
Robertson County,2018-Jun,7267,6917,350,4.8
Robertson County,2018-Jul,7255,6915,340,4.7
Robertson County,2018-Aug,7263,6933,330,4.5
Robertson County,2018-Sep,7551,7243,308,4.1
Robertson County,2018-Oct,7620,7319,301,4
Robertson County,2018-Nov,7665,7380,285,3.7
Robertson County,2018-Dec,7491,7211,280,3.7
Robertson County,2019-Jan,7210,6888,322,4.5
Robertson County,2019-Feb,7480,7178,302,4
Robertson County,2019-Mar,7520,7247,273,3.6
Robertson County,2019-Apr,7374,7143,231,3.1
Robertson County,2019-May,7366,7126,240,3.3
Robertson County,2019-Jun,7128,6846,282,4
Robertson County,2019-Jul,7125,6843,282,4
Robertson County,2019-Aug,7194,6918,276,3.8
Robertson County,2019-Sep,7453,7193,260,3.5
Robertson County,2019-Oct,7597,7347,250,3.3
Robertson County,2019-Nov,7622,7372,250,3.3
Robertson County,2019-Dec,7483,7244,239,3.2
Robertson County,2020-Jan,7358,7082,276,3.8
Robertson County,2020-Feb,7586,7319,267,3.5
Robertson County,2020-Mar,7451,7040,411,5.5
Robertson County,2020-Apr,6675,6118,557,8.3
Robertson County,2020-May,6988,6401,587,8.4
Robertson County,2020-Jun,6936,6333,603,8.7
Robertson County,2020-Jul,6997,6422,575,8.2
Robertson County,2020-Aug,7071,6620,451,6.4
Robertson County,2020-Sep,7354,6883,471,6.4
Robertson County,2020-Oct,7551,7117,434,5.7
Robertson County,2020-Nov,7579,7101,478,6.3
Robertson County,2020-Dec,7544,7060,484,6.4
Robertson County,2021-Jan,7424,6943,481,6.5
Robertson County,2021-Feb,7617,7143,474,6.2
Robertson County,2021-Mar,7682,7237,445,5.8
Robertson County,2021-Apr,7723,7324,399,5.2
Robertson County,2021-May,7562,7174,388,5.1
Robertson County,2021-Jun,7412,6957,455,6.1
Robertson County,2021-Jul,7430,7001,429,5.8
Robertson County,2021-Aug,7401,7007,394,5.3
Robertson County,2021-Sep,7558,7201,357,4.7
Robertson County,2021-Oct,7638,7297,341,4.5
Robertson County,2021-Nov,7659,7339,320,4.2
Robertson County,2021-Dec,7580,7282,298,3.9
Robertson County,2022-Jan,7546,7208,338,4.5
Robertson County,2022-Feb,7842,7491,351,4.5
Robertson County,2022-Mar,7905,7627,278,3.5
Robertson County,2022-Apr,7753,7487,266,3.4
Robertson County,2022-May,7671,7378,293,3.8
Robertson County,2022-Jun,7525,7180,345,4.6
Robertson County,2022-Jul,7579(P),7236(P),343(P),4.5(P)
Rockwall County,2012-Jan,40622,37944,2678,6.6
Rockwall County,2012-Feb,40856,38199,2657,6.5
Rockwall County,2012-Mar,40820,38327,2493,6.1
Rockwall County,2012-Apr,40884,38533,2351,5.8
Rockwall County,2012-May,41033,38544,2489,6.1
Rockwall County,2012-Jun,41304,38498,2806,6.8
Rockwall County,2012-Jul,41298,38525,2773,6.7
Rockwall County,2012-Aug,41095,38498,2597,6.3
Rockwall County,2012-Sep,41208,38801,2407,5.8
Rockwall County,2012-Oct,41322,38959,2363,5.7
Rockwall County,2012-Nov,41373,39055,2318,5.6
Rockwall County,2012-Dec,41330,38979,2351,5.7
Rockwall County,2013-Jan,41615,38957,2658,6.4
Rockwall County,2013-Feb,41663,39126,2537,6.1
Rockwall County,2013-Mar,41696,39216,2480,5.9
Rockwall County,2013-Apr,41869,39546,2323,5.5
Rockwall County,2013-May,42025,39595,2430,5.8
Rockwall County,2013-Jun,42366,39637,2729,6.4
Rockwall County,2013-Jul,42496,39868,2628,6.2
Rockwall County,2013-Aug,42478,39956,2522,5.9
Rockwall County,2013-Sep,42525,40083,2442,5.7
Rockwall County,2013-Oct,42302,39970,2332,5.5
Rockwall County,2013-Nov,42693,40488,2205,5.2
Rockwall County,2013-Dec,42542,40475,2067,4.9
Rockwall County,2014-Jan,42711,40568,2143,5
Rockwall County,2014-Feb,42922,40727,2195,5.1
Rockwall County,2014-Mar,43079,40940,2139,5
Rockwall County,2014-Apr,43028,41222,1806,4.2
Rockwall County,2014-May,43122,41187,1935,4.5
Rockwall County,2014-Jun,43428,41279,2149,4.9
Rockwall County,2014-Jul,43655,41447,2208,5.1
Rockwall County,2014-Aug,43582,41459,2123,4.9
Rockwall County,2014-Sep,43555,41621,1934,4.4
Rockwall County,2014-Oct,43653,41856,1797,4.1
Rockwall County,2014-Nov,43818,42060,1758,4
Rockwall County,2014-Dec,43634,42030,1604,3.7
Rockwall County,2015-Jan,44209,42357,1852,4.2
Rockwall County,2015-Feb,44287,42525,1762,4
Rockwall County,2015-Mar,44255,42527,1728,3.9
Rockwall County,2015-Apr,44609,43069,1540,3.5
Rockwall County,2015-May,44743,43127,1616,3.6
Rockwall County,2015-Jun,45002,43164,1838,4.1
Rockwall County,2015-Jul,45209,43360,1849,4.1
Rockwall County,2015-Aug,45137,43442,1695,3.8
Rockwall County,2015-Sep,45057,43379,1678,3.7
Rockwall County,2015-Oct,45302,43655,1647,3.6
Rockwall County,2015-Nov,45586,43940,1646,3.6
Rockwall County,2015-Dec,45583,44050,1533,3.4
Rockwall County,2016-Jan,46367,44756,1611,3.5
Rockwall County,2016-Feb,46775,45172,1603,3.4
Rockwall County,2016-Mar,46878,45216,1662,3.5
Rockwall County,2016-Apr,46938,45486,1452,3.1
Rockwall County,2016-May,46968,45505,1463,3.1
Rockwall County,2016-Jun,47396,45568,1828,3.9
Rockwall County,2016-Jul,47707,45835,1872,3.9
Rockwall County,2016-Aug,47698,45887,1811,3.8
Rockwall County,2016-Sep,47713,45977,1736,3.6
Rockwall County,2016-Oct,47833,46171,1662,3.5
Rockwall County,2016-Nov,48060,46454,1606,3.3
Rockwall County,2016-Dec,48064,46418,1646,3.4
Rockwall County,2017-Jan,47928,46138,1790,3.7
Rockwall County,2017-Feb,48285,46430,1855,3.8
Rockwall County,2017-Mar,48223,46500,1723,3.6
Rockwall County,2017-Apr,48403,46857,1546,3.2
Rockwall County,2017-May,48245,46679,1566,3.2
Rockwall County,2017-Jun,48542,46811,1731,3.6
Rockwall County,2017-Jul,48820,47092,1728,3.5
Rockwall County,2017-Aug,48763,47054,1709,3.5
Rockwall County,2017-Sep,49002,47421,1581,3.2
Rockwall County,2017-Oct,48818,47354,1464,3
Rockwall County,2017-Nov,49193,47638,1555,3.2
Rockwall County,2017-Dec,49058,47548,1510,3.1
Rockwall County,2018-Jan,49851,48152,1699,3.4
Rockwall County,2018-Feb,50301,48547,1754,3.5
Rockwall County,2018-Mar,50115,48423,1692,3.4
Rockwall County,2018-Apr,50201,48675,1526,3
Rockwall County,2018-May,50153,48621,1532,3.1
Rockwall County,2018-Jun,50499,48724,1775,3.5
Rockwall County,2018-Jul,50688,48972,1716,3.4
Rockwall County,2018-Aug,50374,48680,1694,3.4
Rockwall County,2018-Sep,50460,48830,1630,3.2
Rockwall County,2018-Oct,50679,49136,1543,3
Rockwall County,2018-Nov,50919,49375,1544,3
Rockwall County,2018-Dec,50969,49380,1589,3.1
Rockwall County,2019-Jan,52186,50336,1850,3.5
Rockwall County,2019-Feb,52388,50667,1721,3.3
Rockwall County,2019-Mar,52241,50611,1630,3.1
Rockwall County,2019-Apr,52248,50847,1401,2.7
Rockwall County,2019-May,52271,50809,1462,2.8
Rockwall County,2019-Jun,52740,50994,1746,3.3
Rockwall County,2019-Jul,53077,51309,1768,3.3
Rockwall County,2019-Aug,53050,51329,1721,3.2
Rockwall County,2019-Sep,53216,51585,1631,3.1
Rockwall County,2019-Oct,53516,51963,1553,2.9
Rockwall County,2019-Nov,53735,52193,1542,2.9
Rockwall County,2019-Dec,53634,52194,1440,2.7
Rockwall County,2020-Jan,55031,53370,1661,3
Rockwall County,2020-Feb,55337,53771,1566,2.8
Rockwall County,2020-Mar,54112,51716,2396,4.4
Rockwall County,2020-Apr,51023,45682,5341,10.5
Rockwall County,2020-May,52563,47506,5057,9.6
Rockwall County,2020-Jun,53492,49027,4465,8.3
Rockwall County,2020-Jul,53880,49957,3923,7.3
Rockwall County,2020-Aug,54475,51387,3088,5.7
Rockwall County,2020-Sep,54669,51687,2982,5.5
Rockwall County,2020-Oct,55271,52680,2591,4.7
Rockwall County,2020-Nov,55599,52872,2727,4.9
Rockwall County,2020-Dec,55695,52947,2748,4.9
Rockwall County,2021-Jan,55565,52632,2933,5.3
Rockwall County,2021-Feb,55970,53030,2940,5.3
Rockwall County,2021-Mar,55913,53133,2780,5
Rockwall County,2021-Apr,56058,53597,2461,4.4
Rockwall County,2021-May,56125,53731,2394,4.3
Rockwall County,2021-Jun,56439,53679,2760,4.9
Rockwall County,2021-Jul,56771,54297,2474,4.4
Rockwall County,2021-Aug,56900,54557,2343,4.1
Rockwall County,2021-Sep,57033,54817,2216,3.9
Rockwall County,2021-Oct,57398,55282,2116,3.7
Rockwall County,2021-Nov,58059,56050,2009,3.5
Rockwall County,2021-Dec,57899,56074,1825,3.2
Rockwall County,2022-Jan,58074,55970,2104,3.6
Rockwall County,2022-Feb,58688,56560,2128,3.6
Rockwall County,2022-Mar,58820,57072,1748,3
Rockwall County,2022-Apr,58876,57240,1636,2.8
Rockwall County,2022-May,59289,57563,1726,2.9
Rockwall County,2022-Jun,59535,57480,2055,3.5
Rockwall County,2022-Jul,59522(P),57509(P),2013(P),3.4(P)
Runnels County,2012-Jan,4969,4659,310,6.2
Runnels County,2012-Feb,4947,4648,299,6
Runnels County,2012-Mar,4969,4695,274,5.5
Runnels County,2012-Apr,5088,4830,258,5.1
Runnels County,2012-May,5174,4903,271,5.2
Runnels County,2012-Jun,5132,4839,293,5.7
Runnels County,2012-Jul,5052,4763,289,5.7
Runnels County,2012-Aug,4945,4616,329,6.7
Runnels County,2012-Sep,5042,4744,298,5.9
Runnels County,2012-Oct,5112,4872,240,4.7
Runnels County,2012-Nov,5088,4856,232,4.6
Runnels County,2012-Dec,5063,4827,236,4.7
Runnels County,2013-Jan,4935,4666,269,5.5
Runnels County,2013-Feb,4958,4692,266,5.4
Runnels County,2013-Mar,4923,4669,254,5.2
Runnels County,2013-Apr,4969,4725,244,4.9
Runnels County,2013-May,5007,4740,267,5.3
Runnels County,2013-Jun,5114,4814,300,5.9
Runnels County,2013-Jul,5029,4742,287,5.7
Runnels County,2013-Aug,4933,4624,309,6.3
Runnels County,2013-Sep,4961,4662,299,6
Runnels County,2013-Oct,4975,4737,238,4.8
Runnels County,2013-Nov,4897,4674,223,4.6
Runnels County,2013-Dec,4928,4720,208,4.2
Runnels County,2014-Jan,4923,4702,221,4.5
Runnels County,2014-Feb,4994,4769,225,4.5
Runnels County,2014-Mar,5013,4799,214,4.3
Runnels County,2014-Apr,5044,4856,188,3.7
Runnels County,2014-May,5151,4945,206,4
Runnels County,2014-Jun,5205,4957,248,4.8
Runnels County,2014-Jul,5058,4807,251,5
Runnels County,2014-Aug,4882,4642,240,4.9
Runnels County,2014-Sep,4913,4691,222,4.5
Runnels County,2014-Oct,4835,4642,193,4
Runnels County,2014-Nov,4797,4612,185,3.9
Runnels County,2014-Dec,4757,4592,165,3.5
Runnels County,2015-Jan,4688,4492,196,4.2
Runnels County,2015-Feb,4752,4573,179,3.8
Runnels County,2015-Mar,4759,4585,174,3.7
Runnels County,2015-Apr,4751,4585,166,3.5
Runnels County,2015-May,4832,4651,181,3.7
Runnels County,2015-Jun,4804,4609,195,4.1
Runnels County,2015-Jul,4708,4522,186,4
Runnels County,2015-Aug,4625,4452,173,3.7
Runnels County,2015-Sep,4623,4454,169,3.7
Runnels County,2015-Oct,4549,4387,162,3.6
Runnels County,2015-Nov,4470,4307,163,3.6
Runnels County,2015-Dec,4507,4355,152,3.4
Runnels County,2016-Jan,4578,4407,171,3.7
Runnels County,2016-Feb,4727,4555,172,3.6
Runnels County,2016-Mar,4728,4548,180,3.8
Runnels County,2016-Apr,4740,4579,161,3.4
Runnels County,2016-May,4779,4617,162,3.4
Runnels County,2016-Jun,4742,4545,197,4.2
Runnels County,2016-Jul,4692,4473,219,4.7
Runnels County,2016-Aug,4684,4481,203,4.3
Runnels County,2016-Sep,4600,4395,205,4.5
Runnels County,2016-Oct,4544,4353,191,4.2
Runnels County,2016-Nov,4507,4331,176,3.9
Runnels County,2016-Dec,4475,4301,174,3.9
Runnels County,2017-Jan,4445,4254,191,4.3
Runnels County,2017-Feb,4481,4296,185,4.1
Runnels County,2017-Mar,4669,4493,176,3.8
Runnels County,2017-Apr,4615,4455,160,3.5
Runnels County,2017-May,4652,4474,178,3.8
Runnels County,2017-Jun,4616,4425,191,4.1
Runnels County,2017-Jul,4476,4291,185,4.1
Runnels County,2017-Aug,4487,4311,176,3.9
Runnels County,2017-Sep,4470,4318,152,3.4
Runnels County,2017-Oct,4574,4430,144,3.1
Runnels County,2017-Nov,4505,4354,151,3.4
Runnels County,2017-Dec,4560,4418,142,3.1
Runnels County,2018-Jan,4490,4332,158,3.5
Runnels County,2018-Feb,4514,4350,164,3.6
Runnels County,2018-Mar,4600,4443,157,3.4
Runnels County,2018-Apr,4580,4438,142,3.1
Runnels County,2018-May,4636,4497,139,3
Runnels County,2018-Jun,4612,4450,162,3.5
Runnels County,2018-Jul,4562,4412,150,3.3
Runnels County,2018-Aug,4537,4397,140,3.1
Runnels County,2018-Sep,4513,4380,133,2.9
Runnels County,2018-Oct,4475,4351,124,2.8
Runnels County,2018-Nov,4467,4340,127,2.8
Runnels County,2018-Dec,4409,4280,129,2.9
Runnels County,2019-Jan,4408,4258,150,3.4
Runnels County,2019-Feb,4455,4316,139,3.1
Runnels County,2019-Mar,4506,4374,132,2.9
Runnels County,2019-Apr,4524,4418,106,2.3
Runnels County,2019-May,4577,4471,106,2.3
Runnels County,2019-Jun,4602,4465,137,3
Runnels County,2019-Jul,4584,4452,132,2.9
Runnels County,2019-Aug,4599,4467,132,2.9
Runnels County,2019-Sep,4570,4447,123,2.7
Runnels County,2019-Oct,4613,4489,124,2.7
Runnels County,2019-Nov,4538,4413,125,2.8
Runnels County,2019-Dec,4541,4426,115,2.5
Runnels County,2020-Jan,4518,4382,136,3
Runnels County,2020-Feb,4567,4431,136,3
Runnels County,2020-Mar,4535,4322,213,4.7
Runnels County,2020-Apr,4261,3976,285,6.7
Runnels County,2020-May,4424,4108,316,7.1
Runnels County,2020-Jun,4499,4197,302,6.7
Runnels County,2020-Jul,4483,4214,269,6
Runnels County,2020-Aug,4522,4313,209,4.6
Runnels County,2020-Sep,4492,4286,206,4.6
Runnels County,2020-Oct,4568,4380,188,4.1
Runnels County,2020-Nov,4525,4332,193,4.3
Runnels County,2020-Dec,4553,4351,202,4.4
Runnels County,2021-Jan,4607,4383,224,4.9
Runnels County,2021-Feb,4677,4460,217,4.6
Runnels County,2021-Mar,4740,4528,212,4.5
Runnels County,2021-Apr,4690,4520,170,3.6
Runnels County,2021-May,4634,4448,186,4
Runnels County,2021-Jun,4662,4441,221,4.7
Runnels County,2021-Jul,4616,4417,199,4.3
Runnels County,2021-Aug,4618,4432,186,4
Runnels County,2021-Sep,4581,4401,180,3.9
Runnels County,2021-Oct,4560,4393,167,3.7
Runnels County,2021-Nov,4525,4367,158,3.5
Runnels County,2021-Dec,4512,4371,141,3.1
Runnels County,2022-Jan,4539,4372,167,3.7
Runnels County,2022-Feb,4684,4519,165,3.5
Runnels County,2022-Mar,4764,4631,133,2.8
Runnels County,2022-Apr,4673,4557,116,2.5
Runnels County,2022-May,4654,4517,137,2.9
Runnels County,2022-Jun,4670,4505,165,3.5
Runnels County,2022-Jul,4719(P),4564(P),155(P),3.3(P)
Rusk County,2012-Jan,24384,22818,1566,6.4
Rusk County,2012-Feb,24482,22943,1539,6.3
Rusk County,2012-Mar,24638,23178,1460,5.9
Rusk County,2012-Apr,24719,23337,1382,5.6
Rusk County,2012-May,24619,23122,1497,6.1
Rusk County,2012-Jun,24665,22964,1701,6.9
Rusk County,2012-Jul,24634,22912,1722,7
Rusk County,2012-Aug,24420,22807,1613,6.6
Rusk County,2012-Sep,24500,22961,1539,6.3
Rusk County,2012-Oct,24531,23063,1468,6
Rusk County,2012-Nov,24495,23068,1427,5.8
Rusk County,2012-Dec,24299,22825,1474,6.1
Rusk County,2013-Jan,24278,22605,1673,6.9
Rusk County,2013-Feb,24387,22834,1553,6.4
Rusk County,2013-Mar,24397,22892,1505,6.2
Rusk County,2013-Apr,24387,22977,1410,5.8
Rusk County,2013-May,24280,22799,1481,6.1
Rusk County,2013-Jun,24412,22765,1647,6.7
Rusk County,2013-Jul,24429,22765,1664,6.8
Rusk County,2013-Aug,24237,22644,1593,6.6
Rusk County,2013-Sep,24248,22683,1565,6.5
Rusk County,2013-Oct,24007,22546,1461,6.1
Rusk County,2013-Nov,24068,22703,1365,5.7
Rusk County,2013-Dec,24025,22712,1313,5.5
Rusk County,2014-Jan,23882,22516,1366,5.7
Rusk County,2014-Feb,24053,22679,1374,5.7
Rusk County,2014-Mar,24054,22742,1312,5.5
Rusk County,2014-Apr,24137,23006,1131,4.7
Rusk County,2014-May,24191,22985,1206,5
Rusk County,2014-Jun,24358,23050,1308,5.4
Rusk County,2014-Jul,24338,23011,1327,5.5
Rusk County,2014-Aug,24255,22994,1261,5.2
Rusk County,2014-Sep,24319,23170,1149,4.7
Rusk County,2014-Oct,24241,23197,1044,4.3
Rusk County,2014-Nov,24245,23190,1055,4.4
Rusk County,2014-Dec,23992,23043,949,4
Rusk County,2015-Jan,23247,22199,1048,4.5
Rusk County,2015-Feb,23157,22146,1011,4.4
Rusk County,2015-Mar,22975,21991,984,4.3
Rusk County,2015-Apr,22887,21941,946,4.1
Rusk County,2015-May,22892,21818,1074,4.7
Rusk County,2015-Jun,22818,21624,1194,5.2
Rusk County,2015-Jul,22807,21565,1242,5.4
Rusk County,2015-Aug,22715,21554,1161,5.1
Rusk County,2015-Sep,22623,21482,1141,5
Rusk County,2015-Oct,22682,21563,1119,4.9
Rusk County,2015-Nov,22801,21681,1120,4.9
Rusk County,2015-Dec,22630,21531,1099,4.9
Rusk County,2016-Jan,22293,21140,1153,5.2
Rusk County,2016-Feb,22536,21343,1193,5.3
Rusk County,2016-Mar,22614,21405,1209,5.3
Rusk County,2016-Apr,22437,21265,1172,5.2
Rusk County,2016-May,22366,21173,1193,5.3
Rusk County,2016-Jun,22468,21020,1448,6.4
Rusk County,2016-Jul,22382,20915,1467,6.6
Rusk County,2016-Aug,22413,20925,1488,6.6
Rusk County,2016-Sep,22381,20920,1461,6.5
Rusk County,2016-Oct,22314,21007,1307,5.9
Rusk County,2016-Nov,22252,20958,1294,5.8
Rusk County,2016-Dec,22130,20841,1289,5.8
Rusk County,2017-Jan,21985,20578,1407,6.4
Rusk County,2017-Feb,22085,20726,1359,6.2
Rusk County,2017-Mar,22134,20903,1231,5.6
Rusk County,2017-Apr,22041,20922,1119,5.1
Rusk County,2017-May,21841,20784,1057,4.8
Rusk County,2017-Jun,22022,20860,1162,5.3
Rusk County,2017-Jul,21968,20829,1139,5.2
Rusk County,2017-Aug,21940,20824,1116,5.1
Rusk County,2017-Sep,21969,20928,1041,4.7
Rusk County,2017-Oct,21840,20889,951,4.4
Rusk County,2017-Nov,21832,20871,961,4.4
Rusk County,2017-Dec,21885,20938,947,4.3
Rusk County,2018-Jan,22311,21240,1071,4.8
Rusk County,2018-Feb,22512,21477,1035,4.6
Rusk County,2018-Mar,22669,21712,957,4.2
Rusk County,2018-Apr,22651,21782,869,3.8
Rusk County,2018-May,22595,21757,838,3.7
Rusk County,2018-Jun,22677,21662,1015,4.5
Rusk County,2018-Jul,22606,21659,947,4.2
Rusk County,2018-Aug,22520,21592,928,4.1
Rusk County,2018-Sep,22547,21642,905,4
Rusk County,2018-Oct,22531,21683,848,3.8
Rusk County,2018-Nov,22496,21663,833,3.7
Rusk County,2018-Dec,22478,21615,863,3.8
Rusk County,2019-Jan,22499,21544,955,4.2
Rusk County,2019-Feb,22602,21752,850,3.8
Rusk County,2019-Mar,22586,21813,773,3.4
Rusk County,2019-Apr,22583,21919,664,2.9
Rusk County,2019-May,22565,21859,706,3.1
Rusk County,2019-Jun,22595,21736,859,3.8
Rusk County,2019-Jul,22679,21790,889,3.9
Rusk County,2019-Aug,22722,21877,845,3.7
Rusk County,2019-Sep,22717,21900,817,3.6
Rusk County,2019-Oct,22695,21909,786,3.5
Rusk County,2019-Nov,22670,21861,809,3.6
Rusk County,2019-Dec,22583,21807,776,3.4
Rusk County,2020-Jan,22424,21496,928,4.1
Rusk County,2020-Feb,22470,21613,857,3.8
Rusk County,2020-Mar,22201,20917,1284,5.8
Rusk County,2020-Apr,20571,18636,1935,9.4
Rusk County,2020-May,21152,19102,2050,9.7
Rusk County,2020-Jun,21440,19397,2043,9.5
Rusk County,2020-Jul,21532,19589,1943,9
Rusk County,2020-Aug,21811,20115,1696,7.8
Rusk County,2020-Sep,21799,20135,1664,7.6
Rusk County,2020-Oct,22042,20480,1562,7.1
Rusk County,2020-Nov,22108,20484,1624,7.3
Rusk County,2020-Dec,22049,20422,1627,7.4
Rusk County,2021-Jan,21926,20233,1693,7.7
Rusk County,2021-Feb,22072,20455,1617,7.3
Rusk County,2021-Mar,22092,20588,1504,6.8
Rusk County,2021-Apr,22019,20634,1385,6.3
Rusk County,2021-May,21929,20605,1324,6
Rusk County,2021-Jun,22013,20509,1504,6.8
Rusk County,2021-Jul,22030,20712,1318,6
Rusk County,2021-Aug,22103,20861,1242,5.6
Rusk County,2021-Sep,22186,21026,1160,5.2
Rusk County,2021-Oct,22114,21009,1105,5
Rusk County,2021-Nov,22112,21031,1081,4.9
Rusk County,2021-Dec,21969,20991,978,4.5
Rusk County,2022-Jan,22168,21011,1157,5.2
Rusk County,2022-Feb,22375,21254,1121,5
Rusk County,2022-Mar,22333,21414,919,4.1
Rusk County,2022-Apr,22091,21243,848,3.8
Rusk County,2022-May,22120,21231,889,4
Rusk County,2022-Jun,22310,21272,1038,4.7
Rusk County,2022-Jul,22406(P),21366(P),1040(P),4.6(P)
Sabine County,2012-Jan,3347,2821,526,15.7
Sabine County,2012-Feb,3316,2810,506,15.3
Sabine County,2012-Mar,3265,2794,471,14.4
Sabine County,2012-Apr,3293,2835,458,13.9
Sabine County,2012-May,3316,2833,483,14.6
Sabine County,2012-Jun,3394,2865,529,15.6
Sabine County,2012-Jul,3415,2874,541,15.8
Sabine County,2012-Aug,3384,2899,485,14.3
Sabine County,2012-Sep,3434,2963,471,13.7
Sabine County,2012-Oct,3433,2987,446,13
Sabine County,2012-Nov,3437,2989,448,13
Sabine County,2012-Dec,3500,3005,495,14.1
Sabine County,2013-Jan,3548,3031,517,14.6
Sabine County,2013-Feb,3553,3060,493,13.9
Sabine County,2013-Mar,3500,3049,451,12.9
Sabine County,2013-Apr,3607,3165,442,12.3
Sabine County,2013-May,3619,3148,471,13
Sabine County,2013-Jun,3604,3110,494,13.7
Sabine County,2013-Jul,3609,3151,458,12.7
Sabine County,2013-Aug,3588,3128,460,12.8
Sabine County,2013-Sep,3565,3112,453,12.7
Sabine County,2013-Oct,3472,3044,428,12.3
Sabine County,2013-Nov,3502,3052,450,12.8
Sabine County,2013-Dec,3506,3071,435,12.4
Sabine County,2014-Jan,3566,3130,436,12.2
Sabine County,2014-Feb,3578,3149,429,12
Sabine County,2014-Mar,3551,3152,399,11.2
Sabine County,2014-Apr,3534,3173,361,10.2
Sabine County,2014-May,3562,3179,383,10.8
Sabine County,2014-Jun,3575,3195,380,10.6
Sabine County,2014-Jul,3616,3231,385,10.6
Sabine County,2014-Aug,3549,3160,389,11
Sabine County,2014-Sep,3557,3206,351,9.9
Sabine County,2014-Oct,3495,3170,325,9.3
Sabine County,2014-Nov,3456,3103,353,10.2
Sabine County,2014-Dec,3439,3083,356,10.4
Sabine County,2015-Jan,3555,3190,365,10.3
Sabine County,2015-Feb,3502,3176,326,9.3
Sabine County,2015-Mar,3486,3173,313,9
Sabine County,2015-Apr,3519,3217,302,8.6
Sabine County,2015-May,3472,3148,324,9.3
Sabine County,2015-Jun,3509,3168,341,9.7
Sabine County,2015-Jul,3504,3169,335,9.6
Sabine County,2015-Aug,3549,3224,325,9.2
Sabine County,2015-Sep,3494,3179,315,9
Sabine County,2015-Oct,3473,3156,317,9.1
Sabine County,2015-Nov,3498,3155,343,9.8
Sabine County,2015-Dec,3494,3157,337,9.6
Sabine County,2016-Jan,3436,3118,318,9.3
Sabine County,2016-Feb,3476,3171,305,8.8
Sabine County,2016-Mar,3484,3172,312,9
Sabine County,2016-Apr,3496,3211,285,8.2
Sabine County,2016-May,3489,3193,296,8.5
Sabine County,2016-Jun,3486,3160,326,9.4
Sabine County,2016-Jul,3489,3131,358,10.3
Sabine County,2016-Aug,3457,3111,346,10
Sabine County,2016-Sep,3494,3146,348,10
Sabine County,2016-Oct,3442,3142,300,8.7
Sabine County,2016-Nov,3571,3224,347,9.7
Sabine County,2016-Dec,3494,3110,384,11
Sabine County,2017-Jan,3508,3106,402,11.5
Sabine County,2017-Feb,3514,3140,374,10.6
Sabine County,2017-Mar,3503,3173,330,9.4
Sabine County,2017-Apr,3518,3204,314,8.9
Sabine County,2017-May,3547,3265,282,8
Sabine County,2017-Jun,3572,3268,304,8.5
Sabine County,2017-Jul,3565,3264,301,8.4
Sabine County,2017-Aug,3536,3239,297,8.4
Sabine County,2017-Sep,3534,3268,266,7.5
Sabine County,2017-Oct,3605,3367,238,6.6
Sabine County,2017-Nov,3580,3309,271,7.6
Sabine County,2017-Dec,3597,3291,306,8.5
Sabine County,2018-Jan,3583,3236,347,9.7
Sabine County,2018-Feb,3552,3247,305,8.6
Sabine County,2018-Mar,3575,3285,290,8.1
Sabine County,2018-Apr,3521,3251,270,7.7
Sabine County,2018-May,3516,3257,259,7.4
Sabine County,2018-Jun,3581,3276,305,8.5
Sabine County,2018-Jul,3537,3255,282,8
Sabine County,2018-Aug,3503,3222,281,8
Sabine County,2018-Sep,3450,3191,259,7.5
Sabine County,2018-Oct,3454,3225,229,6.6
Sabine County,2018-Nov,3433,3196,237,6.9
Sabine County,2018-Dec,3434,3140,294,8.6
Sabine County,2019-Jan,3694,3370,324,8.8
Sabine County,2019-Feb,3704,3435,269,7.3
Sabine County,2019-Mar,3682,3443,239,6.5
Sabine County,2019-Apr,3673,3477,196,5.3
Sabine County,2019-May,3706,3500,206,5.6
Sabine County,2019-Jun,3769,3499,270,7.2
Sabine County,2019-Jul,3808,3532,276,7.2
Sabine County,2019-Aug,3744,3502,242,6.5
Sabine County,2019-Sep,3674,3446,228,6.2
Sabine County,2019-Oct,3700,3485,215,5.8
Sabine County,2019-Nov,3680,3448,232,6.3
Sabine County,2019-Dec,3701,3470,231,6.2
Sabine County,2020-Jan,3802,3526,276,7.3
Sabine County,2020-Feb,3741,3499,242,6.5
Sabine County,2020-Mar,3775,3407,368,9.7
Sabine County,2020-Apr,3730,3205,525,14.1
Sabine County,2020-May,3917,3359,558,14.2
Sabine County,2020-Jun,3923,3405,518,13.2
Sabine County,2020-Jul,3945,3436,509,12.9
Sabine County,2020-Aug,3975,3546,429,10.8
Sabine County,2020-Sep,4009,3589,420,10.5
Sabine County,2020-Oct,3871,3517,354,9.1
Sabine County,2020-Nov,3871,3479,392,10.1
Sabine County,2020-Dec,3890,3453,437,11.2
Sabine County,2021-Jan,3972,3501,471,11.9
Sabine County,2021-Feb,3930,3488,442,11.2
Sabine County,2021-Mar,4041,3634,407,10.1
Sabine County,2021-Apr,3976,3604,372,9.4
Sabine County,2021-May,3942,3571,371,9.4
Sabine County,2021-Jun,4010,3595,415,10.3
Sabine County,2021-Jul,4111,3723,388,9.4
Sabine County,2021-Aug,3998,3623,375,9.4
Sabine County,2021-Sep,3962,3634,328,8.3
Sabine County,2021-Oct,3879,3573,306,7.9
Sabine County,2021-Nov,3885,3559,326,8.4
Sabine County,2021-Dec,3874,3544,330,8.5
Sabine County,2022-Jan,3997,3627,370,9.3
Sabine County,2022-Feb,4006,3650,356,8.9
Sabine County,2022-Mar,4076,3792,284,7
Sabine County,2022-Apr,3959,3695,264,6.7
Sabine County,2022-May,3995,3712,283,7.1
Sabine County,2022-Jun,4052,3711,341,8.4
Sabine County,2022-Jul,4116(P),3805(P),311(P),7.6(P)
San Augustine County,2012-Jan,3074,2676,398,12.9
San Augustine County,2012-Feb,3027,2644,383,12.7
San Augustine County,2012-Mar,3065,2694,371,12.1
San Augustine County,2012-Apr,3001,2654,347,11.6
San Augustine County,2012-May,3023,2664,359,11.9
San Augustine County,2012-Jun,3046,2666,380,12.5
San Augustine County,2012-Jul,3062,2679,383,12.5
San Augustine County,2012-Aug,3055,2688,367,12
San Augustine County,2012-Sep,2980,2630,350,11.7
San Augustine County,2012-Oct,2972,2635,337,11.3
San Augustine County,2012-Nov,2965,2634,331,11.2
San Augustine County,2012-Dec,2941,2588,353,12
San Augustine County,2013-Jan,2922,2544,378,12.9
San Augustine County,2013-Feb,2904,2552,352,12.1
San Augustine County,2013-Mar,2905,2555,350,12
San Augustine County,2013-Apr,2943,2607,336,11.4
San Augustine County,2013-May,2985,2658,327,11
San Augustine County,2013-Jun,3005,2642,363,12.1
San Augustine County,2013-Jul,3023,2663,360,11.9
San Augustine County,2013-Aug,2971,2629,342,11.5
San Augustine County,2013-Sep,2942,2591,351,11.9
San Augustine County,2013-Oct,2875,2539,336,11.7
San Augustine County,2013-Nov,2847,2529,318,11.2
San Augustine County,2013-Dec,2858,2551,307,10.7
San Augustine County,2014-Jan,2826,2517,309,10.9
San Augustine County,2014-Feb,2851,2532,319,11.2
San Augustine County,2014-Mar,2823,2536,287,10.2
San Augustine County,2014-Apr,2818,2564,254,9
San Augustine County,2014-May,2820,2558,262,9.3
San Augustine County,2014-Jun,2832,2567,265,9.4
San Augustine County,2014-Jul,2895,2618,277,9.6
San Augustine County,2014-Aug,2848,2568,280,9.8
San Augustine County,2014-Sep,2836,2555,281,9.9
San Augustine County,2014-Oct,2796,2550,246,8.8
San Augustine County,2014-Nov,2792,2537,255,9.1
San Augustine County,2014-Dec,2745,2503,242,8.8
San Augustine County,2015-Jan,2785,2529,256,9.2
San Augustine County,2015-Feb,2804,2561,243,8.7
San Augustine County,2015-Mar,2803,2558,245,8.7
San Augustine County,2015-Apr,2820,2572,248,8.8
San Augustine County,2015-May,2822,2574,248,8.8
San Augustine County,2015-Jun,2877,2604,273,9.5
San Augustine County,2015-Jul,2851,2579,272,9.5
San Augustine County,2015-Aug,2808,2539,269,9.6
San Augustine County,2015-Sep,2747,2483,264,9.6
San Augustine County,2015-Oct,2776,2527,249,9
San Augustine County,2015-Nov,2760,2506,254,9.2
San Augustine County,2015-Dec,2756,2511,245,8.9
San Augustine County,2016-Jan,2771,2518,253,9.1
San Augustine County,2016-Feb,2829,2585,244,8.6
San Augustine County,2016-Mar,2818,2570,248,8.8
San Augustine County,2016-Apr,2849,2613,236,8.3
San Augustine County,2016-May,2844,2611,233,8.2
San Augustine County,2016-Jun,2821,2562,259,9.2
San Augustine County,2016-Jul,2828,2565,263,9.3
San Augustine County,2016-Aug,2812,2547,265,9.4
San Augustine County,2016-Sep,2813,2545,268,9.5
San Augustine County,2016-Oct,2756,2511,245,8.9
San Augustine County,2016-Nov,2745,2497,248,9
San Augustine County,2016-Dec,2772,2524,248,8.9
San Augustine County,2017-Jan,2802,2521,281,10
San Augustine County,2017-Feb,2821,2571,250,8.9
San Augustine County,2017-Mar,2854,2621,233,8.2
San Augustine County,2017-Apr,2829,2621,208,7.4
San Augustine County,2017-May,2849,2645,204,7.2
San Augustine County,2017-Jun,2855,2643,212,7.4
San Augustine County,2017-Jul,2839,2622,217,7.6
San Augustine County,2017-Aug,2803,2588,215,7.7
San Augustine County,2017-Sep,2909,2714,195,6.7
San Augustine County,2017-Oct,2872,2702,170,5.9
San Augustine County,2017-Nov,2855,2667,188,6.6
San Augustine County,2017-Dec,2888,2680,208,7.2
San Augustine County,2018-Jan,2927,2695,232,7.9
San Augustine County,2018-Feb,2914,2705,209,7.2
San Augustine County,2018-Mar,2937,2740,197,6.7
San Augustine County,2018-Apr,2958,2765,193,6.5
San Augustine County,2018-May,2947,2758,189,6.4
San Augustine County,2018-Jun,2988,2776,212,7.1
San Augustine County,2018-Jul,2979,2775,204,6.8
San Augustine County,2018-Aug,2942,2760,182,6.2
San Augustine County,2018-Sep,2980,2797,183,6.1
San Augustine County,2018-Oct,2959,2797,162,5.5
San Augustine County,2018-Nov,3070,2901,169,5.5
San Augustine County,2018-Dec,3129,2940,189,6
San Augustine County,2019-Jan,3322,3121,201,6.1
San Augustine County,2019-Feb,3417,3257,160,4.7
San Augustine County,2019-Mar,3411,3262,149,4.4
San Augustine County,2019-Apr,3348,3223,125,3.7
San Augustine County,2019-May,3268,3136,132,4
San Augustine County,2019-Jun,3299,3143,156,4.7
San Augustine County,2019-Jul,3299,3135,164,5
San Augustine County,2019-Aug,3414,3256,158,4.6
San Augustine County,2019-Sep,3354,3197,157,4.7
San Augustine County,2019-Oct,3351,3196,155,4.6
San Augustine County,2019-Nov,3265,3096,169,5.2
San Augustine County,2019-Dec,3253,3076,177,5.4
San Augustine County,2020-Jan,3034,2850,184,6.1
San Augustine County,2020-Feb,2986,2821,165,5.5
San Augustine County,2020-Mar,3018,2764,254,8.4
San Augustine County,2020-Apr,2888,2573,315,10.9
San Augustine County,2020-May,2992,2628,364,12.2
San Augustine County,2020-Jun,3010,2655,355,11.8
San Augustine County,2020-Jul,3021,2686,335,11.1
San Augustine County,2020-Aug,3026,2727,299,9.9
San Augustine County,2020-Sep,2968,2661,307,10.3
San Augustine County,2020-Oct,3023,2755,268,8.9
San Augustine County,2020-Nov,3013,2710,303,10.1
San Augustine County,2020-Dec,3004,2702,302,10.1
San Augustine County,2021-Jan,3032,2730,302,10
San Augustine County,2021-Feb,3052,2761,291,9.5
San Augustine County,2021-Mar,3020,2764,256,8.5
San Augustine County,2021-Apr,2992,2736,256,8.6
San Augustine County,2021-May,2940,2688,252,8.6
San Augustine County,2021-Jun,2959,2686,273,9.2
San Augustine County,2021-Jul,2960,2718,242,8.2
San Augustine County,2021-Aug,2966,2724,242,8.2
San Augustine County,2021-Sep,2966,2742,224,7.6
San Augustine County,2021-Oct,2983,2771,212,7.1
San Augustine County,2021-Nov,2935,2737,198,6.7
San Augustine County,2021-Dec,2943,2749,194,6.6
San Augustine County,2022-Jan,2959,2732,227,7.7
San Augustine County,2022-Feb,3027,2807,220,7.3
San Augustine County,2022-Mar,3041,2865,176,5.8
San Augustine County,2022-Apr,3008,2824,184,6.1
San Augustine County,2022-May,2963,2771,192,6.5
San Augustine County,2022-Jun,2971,2765,206,6.9
San Augustine County,2022-Jul,3015(P),2808(P),207(P),6.9(P)
San Jacinto County,2012-Jan,11402,10372,1030,9
San Jacinto County,2012-Feb,11401,10411,990,8.7
San Jacinto County,2012-Mar,11366,10443,923,8.1
San Jacinto County,2012-Apr,11364,10491,873,7.7
San Jacinto County,2012-May,11388,10481,907,8
San Jacinto County,2012-Jun,11628,10609,1019,8.8
San Jacinto County,2012-Jul,11541,10518,1023,8.9
San Jacinto County,2012-Aug,11406,10444,962,8.4
San Jacinto County,2012-Sep,11446,10548,898,7.8
San Jacinto County,2012-Oct,11476,10615,861,7.5
San Jacinto County,2012-Nov,11472,10628,844,7.4
San Jacinto County,2012-Dec,11438,10534,904,7.9
San Jacinto County,2013-Jan,11423,10446,977,8.6
San Jacinto County,2013-Feb,11377,10476,901,7.9
San Jacinto County,2013-Mar,11324,10444,880,7.8
San Jacinto County,2013-Apr,11448,10599,849,7.4
San Jacinto County,2013-May,11491,10604,887,7.7
San Jacinto County,2013-Jun,11583,10606,977,8.4
San Jacinto County,2013-Jul,11604,10661,943,8.1
San Jacinto County,2013-Aug,11358,10473,885,7.8
San Jacinto County,2013-Sep,11430,10556,874,7.6
San Jacinto County,2013-Oct,11361,10576,785,6.9
San Jacinto County,2013-Nov,11395,10637,758,6.7
San Jacinto County,2013-Dec,11383,10654,729,6.4
San Jacinto County,2014-Jan,11400,10652,748,6.6
San Jacinto County,2014-Feb,11459,10724,735,6.4
San Jacinto County,2014-Mar,11457,10750,707,6.2
San Jacinto County,2014-Apr,11405,10797,608,5.3
San Jacinto County,2014-May,11423,10748,675,5.9
San Jacinto County,2014-Jun,11457,10742,715,6.2
San Jacinto County,2014-Jul,11455,10723,732,6.4
San Jacinto County,2014-Aug,11316,10616,700,6.2
San Jacinto County,2014-Sep,11352,10707,645,5.7
San Jacinto County,2014-Oct,11394,10802,592,5.2
San Jacinto County,2014-Nov,11390,10804,586,5.1
San Jacinto County,2014-Dec,11263,10721,542,4.8
San Jacinto County,2015-Jan,11249,10622,627,5.6
San Jacinto County,2015-Feb,11282,10679,603,5.3
San Jacinto County,2015-Mar,11312,10735,577,5.1
San Jacinto County,2015-Apr,11321,10768,553,4.9
San Jacinto County,2015-May,11383,10780,603,5.3
San Jacinto County,2015-Jun,11400,10731,669,5.9
San Jacinto County,2015-Jul,11347,10661,686,6
San Jacinto County,2015-Aug,11148,10481,667,6
San Jacinto County,2015-Sep,11177,10503,674,6
San Jacinto County,2015-Oct,11296,10640,656,5.8
San Jacinto County,2015-Nov,11333,10654,679,6
San Jacinto County,2015-Dec,11301,10634,667,5.9
San Jacinto County,2016-Jan,11327,10654,673,5.9
San Jacinto County,2016-Feb,11449,10770,679,5.9
San Jacinto County,2016-Mar,11524,10839,685,5.9
San Jacinto County,2016-Apr,11481,10820,661,5.8
San Jacinto County,2016-May,11473,10812,661,5.8
San Jacinto County,2016-Jun,11511,10728,783,6.8
San Jacinto County,2016-Jul,11506,10708,798,6.9
San Jacinto County,2016-Aug,11385,10614,771,6.8
San Jacinto County,2016-Sep,11371,10627,744,6.5
San Jacinto County,2016-Oct,11352,10650,702,6.2
San Jacinto County,2016-Nov,11383,10670,713,6.3
San Jacinto County,2016-Dec,11416,10667,749,6.6
San Jacinto County,2017-Jan,11315,10520,795,7
San Jacinto County,2017-Feb,11350,10591,759,6.7
San Jacinto County,2017-Mar,11401,10709,692,6.1
San Jacinto County,2017-Apr,11420,10805,615,5.4
San Jacinto County,2017-May,11394,10775,619,5.4
San Jacinto County,2017-Jun,11470,10806,664,5.8
San Jacinto County,2017-Jul,11387,10724,663,5.8
San Jacinto County,2017-Aug,11358,10687,671,5.9
San Jacinto County,2017-Sep,11352,10721,631,5.6
San Jacinto County,2017-Oct,11332,10769,563,5
San Jacinto County,2017-Nov,11389,10792,597,5.2
San Jacinto County,2017-Dec,11376,10775,601,5.3
San Jacinto County,2018-Jan,11318,10647,671,5.9
San Jacinto County,2018-Feb,11343,10725,618,5.4
San Jacinto County,2018-Mar,11453,10870,583,5.1
San Jacinto County,2018-Apr,11430,10903,527,4.6
San Jacinto County,2018-May,11465,10934,531,4.6
San Jacinto County,2018-Jun,11513,10895,618,5.4
San Jacinto County,2018-Jul,11393,10819,574,5
San Jacinto County,2018-Aug,11318,10728,590,5.2
San Jacinto County,2018-Sep,11360,10804,556,4.9
San Jacinto County,2018-Oct,11397,10878,519,4.6
San Jacinto County,2018-Nov,11449,10922,527,4.6
San Jacinto County,2018-Dec,11465,10916,549,4.8
San Jacinto County,2019-Jan,11498,10870,628,5.5
San Jacinto County,2019-Feb,11622,11051,571,4.9
San Jacinto County,2019-Mar,11571,11066,505,4.4
San Jacinto County,2019-Apr,11524,11087,437,3.8
San Jacinto County,2019-May,11576,11114,462,4
San Jacinto County,2019-Jun,11638,11083,555,4.8
San Jacinto County,2019-Jul,11583,11014,569,4.9
San Jacinto County,2019-Aug,11566,11002,564,4.9
San Jacinto County,2019-Sep,11658,11129,529,4.5
San Jacinto County,2019-Oct,11653,11147,506,4.3
San Jacinto County,2019-Nov,11668,11142,526,4.5
San Jacinto County,2019-Dec,11708,11176,532,4.5
San Jacinto County,2020-Jan,11674,11098,576,4.9
San Jacinto County,2020-Feb,11765,11242,523,4.4
San Jacinto County,2020-Mar,11631,10860,771,6.6
San Jacinto County,2020-Apr,10829,9744,1085,10
San Jacinto County,2020-May,11166,9999,1167,10.5
San Jacinto County,2020-Jun,11419,10234,1185,10.4
San Jacinto County,2020-Jul,11556,10374,1182,10.2
San Jacinto County,2020-Aug,11605,10626,979,8.4
San Jacinto County,2020-Sep,11692,10727,965,8.3
San Jacinto County,2020-Oct,11618,10766,852,7.3
San Jacinto County,2020-Nov,11658,10722,936,8
San Jacinto County,2020-Dec,11724,10730,994,8.5
San Jacinto County,2021-Jan,11766,10703,1063,9
San Jacinto County,2021-Feb,11872,10829,1043,8.8
San Jacinto County,2021-Mar,11934,10959,975,8.2
San Jacinto County,2021-Apr,11861,10959,902,7.6
San Jacinto County,2021-May,11827,10965,862,7.3
San Jacinto County,2021-Jun,11897,10912,985,8.3
San Jacinto County,2021-Jul,11960,11037,923,7.7
San Jacinto County,2021-Aug,11923,11057,866,7.3
San Jacinto County,2021-Sep,11917,11122,795,6.7
San Jacinto County,2021-Oct,11822,11089,733,6.2
San Jacinto County,2021-Nov,11841,11132,709,6
San Jacinto County,2021-Dec,11837,11169,668,5.6
San Jacinto County,2022-Jan,11830,11073,757,6.4
San Jacinto County,2022-Feb,12021,11275,746,6.2
San Jacinto County,2022-Mar,12058,11446,612,5.1
San Jacinto County,2022-Apr,11911,11345,566,4.8
San Jacinto County,2022-May,11933,11339,594,5
San Jacinto County,2022-Jun,12008,11330,678,5.6
San Jacinto County,2022-Jul,12090(P),11412(P),678(P),5.6(P)
San Patricio County,2012-Jan,29976,27375,2601,8.7
San Patricio County,2012-Feb,30227,27757,2470,8.2
San Patricio County,2012-Mar,30221,27941,2280,7.5
San Patricio County,2012-Apr,30418,28261,2157,7.1
San Patricio County,2012-May,30607,28354,2253,7.4
San Patricio County,2012-Jun,30627,28153,2474,8.1
San Patricio County,2012-Jul,30590,28117,2473,8.1
San Patricio County,2012-Aug,30383,28078,2305,7.6
San Patricio County,2012-Sep,30352,28196,2156,7.1
San Patricio County,2012-Oct,30447,28351,2096,6.9
San Patricio County,2012-Nov,30314,28267,2047,6.8
San Patricio County,2012-Dec,30178,28024,2154,7.1
San Patricio County,2013-Jan,30195,27832,2363,7.8
San Patricio County,2013-Feb,30473,28248,2225,7.3
San Patricio County,2013-Mar,30605,28404,2201,7.2
San Patricio County,2013-Apr,30601,28484,2117,6.9
San Patricio County,2013-May,30678,28498,2180,7.1
San Patricio County,2013-Jun,30875,28488,2387,7.7
San Patricio County,2013-Jul,30778,28397,2381,7.7
San Patricio County,2013-Aug,30683,28403,2280,7.4
San Patricio County,2013-Sep,30711,28465,2246,7.3
San Patricio County,2013-Oct,30529,28385,2144,7
San Patricio County,2013-Nov,30607,28536,2071,6.8
San Patricio County,2013-Dec,30534,28543,1991,6.5
San Patricio County,2014-Jan,30323,28254,2069,6.8
San Patricio County,2014-Feb,30667,28615,2052,6.7
San Patricio County,2014-Mar,30792,28837,1955,6.3
San Patricio County,2014-Apr,30594,28809,1785,5.8
San Patricio County,2014-May,30700,28843,1857,6
San Patricio County,2014-Jun,30780,28743,2037,6.6
San Patricio County,2014-Jul,30751,28693,2058,6.7
San Patricio County,2014-Aug,30616,28634,1982,6.5
San Patricio County,2014-Sep,30583,28808,1775,5.8
San Patricio County,2014-Oct,30748,28843,1905,6.2
San Patricio County,2014-Nov,30669,28732,1937,6.3
San Patricio County,2014-Dec,30537,28688,1849,6.1
San Patricio County,2015-Jan,30161,28133,2028,6.7
San Patricio County,2015-Feb,30266,28312,1954,6.5
San Patricio County,2015-Mar,30340,28431,1909,6.3
San Patricio County,2015-Apr,30332,28465,1867,6.2
San Patricio County,2015-May,30393,28447,1946,6.4
San Patricio County,2015-Jun,30396,28364,2032,6.7
San Patricio County,2015-Jul,30214,28166,2048,6.8
San Patricio County,2015-Aug,30282,28259,2023,6.7
San Patricio County,2015-Sep,30112,28179,1933,6.4
San Patricio County,2015-Oct,30137,28178,1959,6.5
San Patricio County,2015-Nov,30215,28128,2087,6.9
San Patricio County,2015-Dec,30147,28101,2046,6.8
San Patricio County,2016-Jan,30116,27979,2137,7.1
San Patricio County,2016-Feb,30520,28416,2104,6.9
San Patricio County,2016-Mar,30691,28482,2209,7.2
San Patricio County,2016-Apr,30568,28403,2165,7.1
San Patricio County,2016-May,30589,28447,2142,7
San Patricio County,2016-Jun,30747,28343,2404,7.8
San Patricio County,2016-Jul,30748,28384,2364,7.7
San Patricio County,2016-Aug,30750,28392,2358,7.7
San Patricio County,2016-Sep,30719,28288,2431,7.9
San Patricio County,2016-Oct,30614,28262,2352,7.7
San Patricio County,2016-Nov,30763,28419,2344,7.6
San Patricio County,2016-Dec,30653,28206,2447,8
San Patricio County,2017-Jan,30326,27631,2695,8.9
San Patricio County,2017-Feb,30522,27975,2547,8.3
San Patricio County,2017-Mar,30887,28445,2442,7.9
San Patricio County,2017-Apr,30728,28400,2328,7.6
San Patricio County,2017-May,30460,28319,2141,7
San Patricio County,2017-Jun,30444,28192,2252,7.4
San Patricio County,2017-Jul,30119,27965,2154,7.2
San Patricio County,2017-Aug,30047,27822,2225,7.4
San Patricio County,2017-Sep,30322,27702,2620,8.6
San Patricio County,2017-Oct,30077,27813,2264,7.5
San Patricio County,2017-Nov,30086,27793,2293,7.6
San Patricio County,2017-Dec,30122,27907,2215,7.4
San Patricio County,2018-Jan,29946,27526,2420,8.1
San Patricio County,2018-Feb,30226,27973,2253,7.5
San Patricio County,2018-Mar,30139,28069,2070,6.9
San Patricio County,2018-Apr,30022,28115,1907,6.4
San Patricio County,2018-May,29940,28145,1795,6
San Patricio County,2018-Jun,30087,28016,2071,6.9
San Patricio County,2018-Jul,29872,27934,1938,6.5
San Patricio County,2018-Aug,29604,27786,1818,6.1
San Patricio County,2018-Sep,29381,27615,1766,6
San Patricio County,2018-Oct,29430,27866,1564,5.3
San Patricio County,2018-Nov,29453,27889,1564,5.3
San Patricio County,2018-Dec,29491,27834,1657,5.6
San Patricio County,2019-Jan,29380,27516,1864,6.3
San Patricio County,2019-Feb,29534,27739,1795,6.1
San Patricio County,2019-Mar,29433,27816,1617,5.5
San Patricio County,2019-Apr,29288,27959,1329,4.5
San Patricio County,2019-May,29321,27892,1429,4.9
San Patricio County,2019-Jun,29523,27818,1705,5.8
San Patricio County,2019-Jul,29525,27799,1726,5.8
San Patricio County,2019-Aug,29547,27847,1700,5.8
San Patricio County,2019-Sep,29311,27724,1587,5.4
San Patricio County,2019-Oct,29388,27891,1497,5.1
San Patricio County,2019-Nov,29316,27814,1502,5.1
San Patricio County,2019-Dec,29389,27799,1590,5.4
San Patricio County,2020-Jan,29342,27575,1767,6
San Patricio County,2020-Feb,29454,27899,1555,5.3
San Patricio County,2020-Mar,29380,27040,2340,8
San Patricio County,2020-Apr,27964,23834,4130,14.8
San Patricio County,2020-May,28842,24766,4076,14.1
San Patricio County,2020-Jun,29438,25679,3759,12.8
San Patricio County,2020-Jul,29313,25618,3695,12.6
San Patricio County,2020-Aug,29245,26183,3062,10.5
San Patricio County,2020-Sep,29168,26194,2974,10.2
San Patricio County,2020-Oct,29368,26687,2681,9.1
San Patricio County,2020-Nov,29446,26621,2825,9.6
San Patricio County,2020-Dec,29486,26573,2913,9.9
San Patricio County,2021-Jan,29320,26253,3067,10.5
San Patricio County,2021-Feb,29612,26615,2997,10.1
San Patricio County,2021-Mar,29704,26918,2786,9.4
San Patricio County,2021-Apr,29579,26872,2707,9.2
San Patricio County,2021-May,29372,26814,2558,8.7
San Patricio County,2021-Jun,29596,26731,2865,9.7
San Patricio County,2021-Jul,29499,26802,2697,9.1
San Patricio County,2021-Aug,29324,26797,2527,8.6
San Patricio County,2021-Sep,29214,26870,2344,8
San Patricio County,2021-Oct,29214,27011,2203,7.5
San Patricio County,2021-Nov,29325,27106,2219,7.6
San Patricio County,2021-Dec,29379,27168,2211,7.5
San Patricio County,2022-Jan,29472,26954,2518,8.5
San Patricio County,2022-Feb,29838,27443,2395,8
San Patricio County,2022-Mar,29782,27723,2059,6.9
San Patricio County,2022-Apr,29442,27505,1937,6.6
San Patricio County,2022-May,29391,27492,1899,6.5
San Patricio County,2022-Jun,29575,27423,2152,7.3
San Patricio County,2022-Jul,29607(P),27476(P),2131(P),7.2(P)
San Saba County,2012-Jan,2325,2168,157,6.8
San Saba County,2012-Feb,2312,2151,161,7
San Saba County,2012-Mar,2312,2160,152,6.6
San Saba County,2012-Apr,2295,2157,138,6
San Saba County,2012-May,2281,2143,138,6
San Saba County,2012-Jun,2299,2147,152,6.6
San Saba County,2012-Jul,2274,2121,153,6.7
San Saba County,2012-Aug,2253,2108,145,6.4
San Saba County,2012-Sep,2281,2148,133,5.8
San Saba County,2012-Oct,2287,2156,131,5.7
San Saba County,2012-Nov,2282,2162,120,5.3
San Saba County,2012-Dec,2273,2151,122,5.4
San Saba County,2013-Jan,2268,2122,146,6.4
San Saba County,2013-Feb,2263,2129,134,5.9
San Saba County,2013-Mar,2243,2113,130,5.8
San Saba County,2013-Apr,2273,2148,125,5.5
San Saba County,2013-May,2285,2148,137,6
San Saba County,2013-Jun,2333,2178,155,6.6
San Saba County,2013-Jul,2304,2157,147,6.4
San Saba County,2013-Aug,2281,2144,137,6
San Saba County,2013-Sep,2265,2136,129,5.7
San Saba County,2013-Oct,2237,2121,116,5.2
San Saba County,2013-Nov,2231,2120,111,5
San Saba County,2013-Dec,2239,2138,101,4.5
San Saba County,2014-Jan,2192,2091,101,4.6
San Saba County,2014-Feb,2218,2112,106,4.8
San Saba County,2014-Mar,2214,2114,100,4.5
San Saba County,2014-Apr,2192,2108,84,3.8
San Saba County,2014-May,2229,2133,96,4.3
San Saba County,2014-Jun,2238,2134,104,4.6
San Saba County,2014-Jul,2268,2154,114,5
San Saba County,2014-Aug,2244,2143,101,4.5
San Saba County,2014-Sep,2214,2127,87,3.9
San Saba County,2014-Oct,2257,2170,87,3.9
San Saba County,2014-Nov,2237,2158,79,3.5
San Saba County,2014-Dec,2231,2160,71,3.2
San Saba County,2015-Jan,2216,2130,86,3.9
San Saba County,2015-Feb,2216,2137,79,3.6
San Saba County,2015-Mar,2222,2145,77,3.5
San Saba County,2015-Apr,2219,2146,73,3.3
San Saba County,2015-May,2228,2149,79,3.5
San Saba County,2015-Jun,2258,2165,93,4.1
San Saba County,2015-Jul,2280,2189,91,4
San Saba County,2015-Aug,2281,2200,81,3.6
San Saba County,2015-Sep,2273,2184,89,3.9
San Saba County,2015-Oct,2259,2175,84,3.7
San Saba County,2015-Nov,2239,2156,83,3.7
San Saba County,2015-Dec,2261,2185,76,3.4
San Saba County,2016-Jan,2189,2110,79,3.6
San Saba County,2016-Feb,2297,2218,79,3.4
San Saba County,2016-Mar,2418,2342,76,3.1
San Saba County,2016-Apr,2422,2354,68,2.8
San Saba County,2016-May,2458,2389,69,2.8
San Saba County,2016-Jun,2501,2415,86,3.4
San Saba County,2016-Jul,2471,2379,92,3.7
San Saba County,2016-Aug,2531,2445,86,3.4
San Saba County,2016-Sep,2532,2438,94,3.7
San Saba County,2016-Oct,2511,2419,92,3.7
San Saba County,2016-Nov,2517,2427,90,3.6
San Saba County,2016-Dec,2532,2446,86,3.4
San Saba County,2017-Jan,2439,2344,95,3.9
San Saba County,2017-Feb,2468,2372,96,3.9
San Saba County,2017-Mar,2471,2392,79,3.2
San Saba County,2017-Apr,2406,2334,72,3
San Saba County,2017-May,2391,2320,71,3
San Saba County,2017-Jun,2377,2297,80,3.4
San Saba County,2017-Jul,2359,2277,82,3.5
San Saba County,2017-Aug,2377,2301,76,3.2
San Saba County,2017-Sep,2343,2272,71,3
San Saba County,2017-Oct,2354,2283,71,3
San Saba County,2017-Nov,2384,2309,75,3.1
San Saba County,2017-Dec,2426,2356,70,2.9
San Saba County,2018-Jan,2423,2339,84,3.5
San Saba County,2018-Feb,2497,2415,82,3.3
San Saba County,2018-Mar,2515,2434,81,3.2
San Saba County,2018-Apr,2435,2362,73,3
San Saba County,2018-May,2459,2389,70,2.8
San Saba County,2018-Jun,2452,2364,88,3.6
San Saba County,2018-Jul,2466,2383,83,3.4
San Saba County,2018-Aug,2467,2389,78,3.2
San Saba County,2018-Sep,2528,2453,75,3
San Saba County,2018-Oct,2608,2538,70,2.7
San Saba County,2018-Nov,2642,2573,69,2.6
San Saba County,2018-Dec,2668,2595,73,2.7
San Saba County,2019-Jan,2613,2538,75,2.9
San Saba County,2019-Feb,2628,2549,79,3
San Saba County,2019-Mar,2572,2497,75,2.9
San Saba County,2019-Apr,2534,2468,66,2.6
San Saba County,2019-May,2468,2398,70,2.8
San Saba County,2019-Jun,2485,2406,79,3.2
San Saba County,2019-Jul,2462,2386,76,3.1
San Saba County,2019-Aug,2490,2415,75,3
San Saba County,2019-Sep,2498,2426,72,2.9
San Saba County,2019-Oct,2454,2380,74,3
San Saba County,2019-Nov,2425,2357,68,2.8
San Saba County,2019-Dec,2409,2335,74,3.1
San Saba County,2020-Jan,2410,2321,89,3.7
San Saba County,2020-Feb,2401,2315,86,3.6
San Saba County,2020-Mar,2364,2233,131,5.5
San Saba County,2020-Apr,1975,1849,126,6.4
San Saba County,2020-May,2040,1908,132,6.5
San Saba County,2020-Jun,2064,1926,138,6.7
San Saba County,2020-Jul,2086,1957,129,6.2
San Saba County,2020-Aug,2126,2019,107,5
San Saba County,2020-Sep,2116,2013,103,4.9
San Saba County,2020-Oct,2161,2067,94,4.3
San Saba County,2020-Nov,2165,2061,104,4.8
San Saba County,2020-Dec,2187,2077,110,5
San Saba County,2021-Jan,2208,2083,125,5.7
San Saba County,2021-Feb,2239,2107,132,5.9
San Saba County,2021-Mar,2277,2150,127,5.6
San Saba County,2021-Apr,2259,2155,104,4.6
San Saba County,2021-May,2212,2110,102,4.6
San Saba County,2021-Jun,2199,2084,115,5.2
San Saba County,2021-Jul,2191,2085,106,4.8
San Saba County,2021-Aug,2142,2044,98,4.6
San Saba County,2021-Sep,2177,2089,88,4
San Saba County,2021-Oct,2172,2087,85,3.9
San Saba County,2021-Nov,2181,2101,80,3.7
San Saba County,2021-Dec,2180,2107,73,3.3
San Saba County,2022-Jan,2189,2101,88,4
San Saba County,2022-Feb,2229,2138,91,4.1
San Saba County,2022-Mar,2262,2188,74,3.3
San Saba County,2022-Apr,2158,2090,68,3.2
San Saba County,2022-May,2135,2062,73,3.4
San Saba County,2022-Jun,2118,2034,84,4
San Saba County,2022-Jul,2151(P),2064(P),87(P),4.0(P)
Schleicher County,2012-Jan,1753,1679,74,4.2
Schleicher County,2012-Feb,1742,1667,75,4.3
Schleicher County,2012-Mar,1736,1669,67,3.9
Schleicher County,2012-Apr,1781,1715,66,3.7
Schleicher County,2012-May,1791,1720,71,4
Schleicher County,2012-Jun,1841,1758,83,4.5
Schleicher County,2012-Jul,1791,1709,82,4.6
Schleicher County,2012-Aug,1792,1716,76,4.2
Schleicher County,2012-Sep,1782,1717,65,3.6
Schleicher County,2012-Oct,1767,1702,65,3.7
Schleicher County,2012-Nov,1764,1701,63,3.6
Schleicher County,2012-Dec,1782,1721,61,3.4
Schleicher County,2013-Jan,1769,1702,67,3.8
Schleicher County,2013-Feb,1762,1702,60,3.4
Schleicher County,2013-Mar,1759,1703,56,3.2
Schleicher County,2013-Apr,1774,1717,57,3.2
Schleicher County,2013-May,1796,1728,68,3.8
Schleicher County,2013-Jun,1875,1799,76,4.1
Schleicher County,2013-Jul,1897,1825,72,3.8
Schleicher County,2013-Aug,1833,1765,68,3.7
Schleicher County,2013-Sep,1816,1747,69,3.8
Schleicher County,2013-Oct,1770,1709,61,3.4
Schleicher County,2013-Nov,1759,1703,56,3.2
Schleicher County,2013-Dec,1776,1717,59,3.3
Schleicher County,2014-Jan,1765,1710,55,3.1
Schleicher County,2014-Feb,1776,1715,61,3.4
Schleicher County,2014-Mar,1779,1727,52,2.9
Schleicher County,2014-Apr,1781,1735,46,2.6
Schleicher County,2014-May,1810,1754,56,3.1
Schleicher County,2014-Jun,1806,1750,56,3.1
Schleicher County,2014-Jul,1781,1723,58,3.3
Schleicher County,2014-Aug,1746,1685,61,3.5
Schleicher County,2014-Sep,1792,1738,54,3
Schleicher County,2014-Oct,1773,1719,54,3
Schleicher County,2014-Nov,1759,1707,52,3
Schleicher County,2014-Dec,1744,1698,46,2.6
Schleicher County,2015-Jan,1732,1673,59,3.4
Schleicher County,2015-Feb,1567,1493,74,4.7
Schleicher County,2015-Mar,1597,1515,82,5.1
Schleicher County,2015-Apr,1538,1457,81,5.3
Schleicher County,2015-May,1543,1461,82,5.3
Schleicher County,2015-Jun,1559,1470,89,5.7
Schleicher County,2015-Jul,1476,1388,88,6
Schleicher County,2015-Aug,1446,1364,82,5.7
Schleicher County,2015-Sep,1400,1318,82,5.9
Schleicher County,2015-Oct,1398,1315,83,5.9
Schleicher County,2015-Nov,1390,1312,78,5.6
Schleicher County,2015-Dec,1370,1295,75,5.5
Schleicher County,2016-Jan,1524,1455,69,4.5
Schleicher County,2016-Feb,1570,1494,76,4.8
Schleicher County,2016-Mar,1574,1499,75,4.8
Schleicher County,2016-Apr,1412,1341,71,5
Schleicher County,2016-May,1420,1346,74,5.2
Schleicher County,2016-Jun,1425,1345,80,5.6
Schleicher County,2016-Jul,1382,1301,81,5.9
Schleicher County,2016-Aug,1391,1305,86,6.2
Schleicher County,2016-Sep,1336,1256,80,6
Schleicher County,2016-Oct,1342,1274,68,5.1
Schleicher County,2016-Nov,1339,1272,67,5
Schleicher County,2016-Dec,1336,1272,64,4.8
Schleicher County,2017-Jan,1327,1261,66,5
Schleicher County,2017-Feb,1340,1279,61,4.6
Schleicher County,2017-Mar,1350,1296,54,4
Schleicher County,2017-Apr,1389,1341,48,3.5
Schleicher County,2017-May,1391,1343,48,3.5
Schleicher County,2017-Jun,1379,1326,53,3.8
Schleicher County,2017-Jul,1336,1286,50,3.7
Schleicher County,2017-Aug,1305,1255,50,3.8
Schleicher County,2017-Sep,1275,1226,49,3.8
Schleicher County,2017-Oct,1270,1230,40,3.1
Schleicher County,2017-Nov,1257,1217,40,3.2
Schleicher County,2017-Dec,1270,1233,37,2.9
Schleicher County,2018-Jan,1272,1235,37,2.9
Schleicher County,2018-Feb,1284,1243,41,3.2
Schleicher County,2018-Mar,1323,1279,44,3.3
Schleicher County,2018-Apr,1308,1270,38,2.9
Schleicher County,2018-May,1349,1312,37,2.7
Schleicher County,2018-Jun,1385,1342,43,3.1
Schleicher County,2018-Jul,1395,1353,42,3
Schleicher County,2018-Aug,1384,1345,39,2.8
Schleicher County,2018-Sep,1378,1341,37,2.7
Schleicher County,2018-Oct,1375,1341,34,2.5
Schleicher County,2018-Nov,1410,1374,36,2.6
Schleicher County,2018-Dec,1416,1379,37,2.6
Schleicher County,2019-Jan,1338,1301,37,2.8
Schleicher County,2019-Feb,1343,1306,37,2.8
Schleicher County,2019-Mar,1337,1304,33,2.5
Schleicher County,2019-Apr,1288,1261,27,2.1
Schleicher County,2019-May,1297,1265,32,2.5
Schleicher County,2019-Jun,1304,1267,37,2.8
Schleicher County,2019-Jul,1274,1230,44,3.5
Schleicher County,2019-Aug,1288,1248,40,3.1
Schleicher County,2019-Sep,1272,1234,38,3
Schleicher County,2019-Oct,1268,1230,38,3
Schleicher County,2019-Nov,1263,1223,40,3.2
Schleicher County,2019-Dec,1254,1217,37,3
Schleicher County,2020-Jan,1234,1197,37,3
Schleicher County,2020-Feb,1228,1193,35,2.9
Schleicher County,2020-Mar,1213,1153,60,4.9
Schleicher County,2020-Apr,1178,1097,81,6.9
Schleicher County,2020-May,1192,1080,112,9.4
Schleicher County,2020-Jun,1217,1098,119,9.8
Schleicher County,2020-Jul,1167,1061,106,9.1
Schleicher County,2020-Aug,1184,1090,94,7.9
Schleicher County,2020-Sep,1171,1079,92,7.9
Schleicher County,2020-Oct,1218,1135,83,6.8
Schleicher County,2020-Nov,1198,1109,89,7.4
Schleicher County,2020-Dec,1210,1120,90,7.4
Schleicher County,2021-Jan,1190,1107,83,7
Schleicher County,2021-Feb,1195,1114,81,6.8
Schleicher County,2021-Mar,1209,1135,74,6.1
Schleicher County,2021-Apr,1214,1151,63,5.2
Schleicher County,2021-May,1209,1141,68,5.6
Schleicher County,2021-Jun,1208,1130,78,6.5
Schleicher County,2021-Jul,1171,1106,65,5.6
Schleicher County,2021-Aug,1173,1111,62,5.3
Schleicher County,2021-Sep,1177,1119,58,4.9
Schleicher County,2021-Oct,1193,1134,59,4.9
Schleicher County,2021-Nov,1181,1126,55,4.7
Schleicher County,2021-Dec,1185,1134,51,4.3
Schleicher County,2022-Jan,1168,1113,55,4.7
Schleicher County,2022-Feb,1182,1128,54,4.6
Schleicher County,2022-Mar,1201,1156,45,3.7
Schleicher County,2022-Apr,1189,1149,40,3.4
Schleicher County,2022-May,1164,1122,42,3.6
Schleicher County,2022-Jun,1162,1113,49,4.2
Schleicher County,2022-Jul,1154(P),1106(P),48(P),4.2(P)
Scurry County,2012-Jan,7716,7333,383,5
Scurry County,2012-Feb,7791,7412,379,4.9
Scurry County,2012-Mar,7824,7466,358,4.6
Scurry County,2012-Apr,7929,7600,329,4.1
Scurry County,2012-May,8080,7730,350,4.3
Scurry County,2012-Jun,8045,7619,426,5.3
Scurry County,2012-Jul,8135,7703,432,5.3
Scurry County,2012-Aug,8097,7723,374,4.6
Scurry County,2012-Sep,8244,7913,331,4
Scurry County,2012-Oct,8424,8102,322,3.8
Scurry County,2012-Nov,8449,8134,315,3.7
Scurry County,2012-Dec,8459,8139,320,3.8
Scurry County,2013-Jan,8464,8097,367,4.3
Scurry County,2013-Feb,8515,8157,358,4.2
Scurry County,2013-Mar,8469,8129,340,4
Scurry County,2013-Apr,8531,8213,318,3.7
Scurry County,2013-May,8545,8188,357,4.2
Scurry County,2013-Jun,8650,8215,435,5
Scurry County,2013-Jul,8687,8257,430,4.9
Scurry County,2013-Aug,8644,8255,389,4.5
Scurry County,2013-Sep,8664,8312,352,4.1
Scurry County,2013-Oct,8514,8178,336,3.9
Scurry County,2013-Nov,8461,8146,315,3.7
Scurry County,2013-Dec,8421,8122,299,3.6
Scurry County,2014-Jan,8395,8086,309,3.7
Scurry County,2014-Feb,8455,8135,320,3.8
Scurry County,2014-Mar,8447,8142,305,3.6
Scurry County,2014-Apr,8572,8321,251,2.9
Scurry County,2014-May,8627,8349,278,3.2
Scurry County,2014-Jun,8640,8309,331,3.8
Scurry County,2014-Jul,8742,8389,353,4
Scurry County,2014-Aug,8684,8359,325,3.7
Scurry County,2014-Sep,8649,8370,279,3.2
Scurry County,2014-Oct,8691,8434,257,3
Scurry County,2014-Nov,8672,8429,243,2.8
Scurry County,2014-Dec,8590,8367,223,2.6
Scurry County,2015-Jan,8393,8124,269,3.2
Scurry County,2015-Feb,8359,8068,291,3.5
Scurry County,2015-Mar,8320,7980,340,4.1
Scurry County,2015-Apr,8269,7966,303,3.7
Scurry County,2015-May,8320,7996,324,3.9
Scurry County,2015-Jun,8316,7928,388,4.7
Scurry County,2015-Jul,8268,7867,401,4.9
Scurry County,2015-Aug,8146,7780,366,4.5
Scurry County,2015-Sep,8016,7667,349,4.4
Scurry County,2015-Oct,7915,7553,362,4.6
Scurry County,2015-Nov,7904,7551,353,4.5
Scurry County,2015-Dec,7812,7471,341,4.4
Scurry County,2016-Jan,7770,7360,410,5.3
Scurry County,2016-Feb,7778,7345,433,5.6
Scurry County,2016-Mar,7719,7252,467,6.1
Scurry County,2016-Apr,7533,7089,444,5.9
Scurry County,2016-May,7471,7041,430,5.8
Scurry County,2016-Jun,7531,7009,522,6.9
Scurry County,2016-Jul,7365,6864,501,6.8
Scurry County,2016-Aug,7336,6865,471,6.4
Scurry County,2016-Sep,7153,6713,440,6.2
Scurry County,2016-Oct,7086,6699,387,5.5
Scurry County,2016-Nov,7076,6705,371,5.2
Scurry County,2016-Dec,7105,6739,366,5.2
Scurry County,2017-Jan,7011,6627,384,5.5
Scurry County,2017-Feb,7050,6675,375,5.3
Scurry County,2017-Mar,7037,6674,363,5.2
Scurry County,2017-Apr,7065,6757,308,4.4
Scurry County,2017-May,7041,6736,305,4.3
Scurry County,2017-Jun,7048,6720,328,4.7
Scurry County,2017-Jul,7035,6711,324,4.6
Scurry County,2017-Aug,6951,6647,304,4.4
Scurry County,2017-Sep,6751,6499,252,3.7
Scurry County,2017-Oct,6713,6490,223,3.3
Scurry County,2017-Nov,6766,6529,237,3.5
Scurry County,2017-Dec,6762,6532,230,3.4
Scurry County,2018-Jan,6861,6601,260,3.8
Scurry County,2018-Feb,6906,6656,250,3.6
Scurry County,2018-Mar,6985,6717,268,3.8
Scurry County,2018-Apr,6967,6746,221,3.2
Scurry County,2018-May,6930,6714,216,3.1
Scurry County,2018-Jun,6986,6703,283,4.1
Scurry County,2018-Jul,6874,6619,255,3.7
Scurry County,2018-Aug,6800,6568,232,3.4
Scurry County,2018-Sep,6778,6557,221,3.3
Scurry County,2018-Oct,6788,6589,199,2.9
Scurry County,2018-Nov,6739,6538,201,3
Scurry County,2018-Dec,6716,6513,203,3
Scurry County,2019-Jan,6571,6336,235,3.6
Scurry County,2019-Feb,6571,6363,208,3.2
Scurry County,2019-Mar,6582,6371,211,3.2
Scurry County,2019-Apr,6572,6396,176,2.7
Scurry County,2019-May,6697,6505,192,2.9
Scurry County,2019-Jun,6746,6491,255,3.8
Scurry County,2019-Jul,6672,6414,258,3.9
Scurry County,2019-Aug,6622,6408,214,3.2
Scurry County,2019-Sep,6593,6392,201,3
Scurry County,2019-Oct,6481,6277,204,3.1
Scurry County,2019-Nov,6440,6235,205,3.2
Scurry County,2019-Dec,6411,6213,198,3.1
Scurry County,2020-Jan,6325,6086,239,3.8
Scurry County,2020-Feb,6360,6121,239,3.8
Scurry County,2020-Mar,6275,5913,362,5.8
Scurry County,2020-Apr,5937,5363,574,9.7
Scurry County,2020-May,6125,5407,718,11.7
Scurry County,2020-Jun,6153,5432,721,11.7
Scurry County,2020-Jul,6151,5479,672,10.9
Scurry County,2020-Aug,6182,5626,556,9
Scurry County,2020-Sep,6137,5620,517,8.4
Scurry County,2020-Oct,6170,5690,480,7.8
Scurry County,2020-Nov,6116,5608,508,8.3
Scurry County,2020-Dec,6093,5582,511,8.4
Scurry County,2021-Jan,6082,5563,519,8.5
Scurry County,2021-Feb,6153,5664,489,7.9
Scurry County,2021-Mar,6168,5700,468,7.6
Scurry County,2021-Apr,6128,5707,421,6.9
Scurry County,2021-May,6056,5663,393,6.5
Scurry County,2021-Jun,6104,5659,445,7.3
Scurry County,2021-Jul,6164,5745,419,6.8
Scurry County,2021-Aug,6118,5728,390,6.4
Scurry County,2021-Sep,6095,5724,371,6.1
Scurry County,2021-Oct,6040,5694,346,5.7
Scurry County,2021-Nov,5983,5659,324,5.4
Scurry County,2021-Dec,5942,5632,310,5.2
Scurry County,2022-Jan,5890,5548,342,5.8
Scurry County,2022-Feb,5964,5626,338,5.7
Scurry County,2022-Mar,5976,5711,265,4.4
Scurry County,2022-Apr,5807,5562,245,4.2
Scurry County,2022-May,5803,5545,258,4.4
Scurry County,2022-Jun,5838,5535,303,5.2
Scurry County,2022-Jul,5895(P),5588(P),307(P),5.2(P)
Shackelford County,2012-Jan,2117,2035,82,3.9
Shackelford County,2012-Feb,2135,2056,79,3.7
Shackelford County,2012-Mar,2133,2061,72,3.4
Shackelford County,2012-Apr,2185,2111,74,3.4
Shackelford County,2012-May,2218,2138,80,3.6
Shackelford County,2012-Jun,2293,2202,91,4
Shackelford County,2012-Jul,2270,2181,89,3.9
Shackelford County,2012-Aug,2268,2191,77,3.4
Shackelford County,2012-Sep,2238,2166,72,3.2
Shackelford County,2012-Oct,2219,2147,72,3.2
Shackelford County,2012-Nov,2216,2148,68,3.1
Shackelford County,2012-Dec,2204,2138,66,3
Shackelford County,2013-Jan,2207,2122,85,3.9
Shackelford County,2013-Feb,2195,2119,76,3.5
Shackelford County,2013-Mar,2199,2127,72,3.3
Shackelford County,2013-Apr,2218,2146,72,3.2
Shackelford County,2013-May,2222,2148,74,3.3
Shackelford County,2013-Jun,2310,2223,87,3.8
Shackelford County,2013-Jul,2383,2297,86,3.6
Shackelford County,2013-Aug,2364,2284,80,3.4
Shackelford County,2013-Sep,2325,2244,81,3.5
Shackelford County,2013-Oct,2379,2307,72,3
Shackelford County,2013-Nov,2346,2282,64,2.7
Shackelford County,2013-Dec,2361,2294,67,2.8
Shackelford County,2014-Jan,2342,2266,76,3.2
Shackelford County,2014-Feb,2408,2330,78,3.2
Shackelford County,2014-Mar,2397,2325,72,3
Shackelford County,2014-Apr,2395,2335,60,2.5
Shackelford County,2014-May,2401,2332,69,2.9
Shackelford County,2014-Jun,2418,2344,74,3.1
Shackelford County,2014-Jul,2486,2413,73,2.9
Shackelford County,2014-Aug,2337,2272,65,2.8
Shackelford County,2014-Sep,2349,2289,60,2.6
Shackelford County,2014-Oct,2312,2254,58,2.5
Shackelford County,2014-Nov,2306,2249,57,2.5
Shackelford County,2014-Dec,2287,2233,54,2.4
Shackelford County,2015-Jan,2248,2187,61,2.7
Shackelford County,2015-Feb,2227,2172,55,2.5
Shackelford County,2015-Mar,2187,2130,57,2.6
Shackelford County,2015-Apr,2109,2057,52,2.5
Shackelford County,2015-May,2103,2044,59,2.8
Shackelford County,2015-Jun,2122,2058,64,3
Shackelford County,2015-Jul,2105,2038,67,3.2
Shackelford County,2015-Aug,2043,1982,61,3
Shackelford County,2015-Sep,2023,1964,59,2.9
Shackelford County,2015-Oct,1968,1906,62,3.2
Shackelford County,2015-Nov,1932,1870,62,3.2
Shackelford County,2015-Dec,1927,1869,58,3
Shackelford County,2016-Jan,1871,1810,61,3.3
Shackelford County,2016-Feb,1899,1828,71,3.7
Shackelford County,2016-Mar,1921,1835,86,4.5
Shackelford County,2016-Apr,1905,1831,74,3.9
Shackelford County,2016-May,1930,1854,76,3.9
Shackelford County,2016-Jun,1951,1868,83,4.3
Shackelford County,2016-Jul,1917,1845,72,3.8
Shackelford County,2016-Aug,1875,1803,72,3.8
Shackelford County,2016-Sep,1823,1750,73,4
Shackelford County,2016-Oct,1808,1744,64,3.5
Shackelford County,2016-Nov,1795,1730,65,3.6
Shackelford County,2016-Dec,1833,1769,64,3.5
Shackelford County,2017-Jan,1827,1758,69,3.8
Shackelford County,2017-Feb,1851,1783,68,3.7
Shackelford County,2017-Mar,1910,1849,61,3.2
Shackelford County,2017-Apr,1880,1830,50,2.7
Shackelford County,2017-May,1908,1856,52,2.7
Shackelford County,2017-Jun,1944,1887,57,2.9
Shackelford County,2017-Jul,1859,1796,63,3.4
Shackelford County,2017-Aug,1899,1843,56,2.9
Shackelford County,2017-Sep,1835,1784,51,2.8
Shackelford County,2017-Oct,1845,1799,46,2.5
Shackelford County,2017-Nov,1854,1808,46,2.5
Shackelford County,2017-Dec,1876,1828,48,2.6
Shackelford County,2018-Jan,1887,1840,47,2.5
Shackelford County,2018-Feb,1925,1875,50,2.6
Shackelford County,2018-Mar,1948,1903,45,2.3
Shackelford County,2018-Apr,1951,1912,39,2
Shackelford County,2018-May,1980,1940,40,2
Shackelford County,2018-Jun,1973,1925,48,2.4
Shackelford County,2018-Jul,1948,1902,46,2.4
Shackelford County,2018-Aug,1962,1914,48,2.4
Shackelford County,2018-Sep,1931,1884,47,2.4
Shackelford County,2018-Oct,1876,1835,41,2.2
Shackelford County,2018-Nov,1860,1819,41,2.2
Shackelford County,2018-Dec,1849,1806,43,2.3
Shackelford County,2019-Jan,1857,1808,49,2.6
Shackelford County,2019-Feb,1857,1815,42,2.3
Shackelford County,2019-Mar,1877,1831,46,2.5
Shackelford County,2019-Apr,1879,1846,33,1.8
Shackelford County,2019-May,1877,1839,38,2
Shackelford County,2019-Jun,1915,1871,44,2.3
Shackelford County,2019-Jul,1914,1871,43,2.2
Shackelford County,2019-Aug,1975,1930,45,2.3
Shackelford County,2019-Sep,1866,1826,40,2.1
Shackelford County,2019-Oct,1882,1844,38,2
Shackelford County,2019-Nov,1839,1799,40,2.2
Shackelford County,2019-Dec,1845,1808,37,2
Shackelford County,2020-Jan,1784,1736,48,2.7
Shackelford County,2020-Feb,1832,1789,43,2.3
Shackelford County,2020-Mar,1848,1775,73,4
Shackelford County,2020-Apr,1713,1610,103,6
Shackelford County,2020-May,1686,1558,128,7.6
Shackelford County,2020-Jun,1720,1591,129,7.5
Shackelford County,2020-Jul,1832,1709,123,6.7
Shackelford County,2020-Aug,1759,1658,101,5.7
Shackelford County,2020-Sep,1747,1652,95,5.4
Shackelford County,2020-Oct,1763,1673,90,5.1
Shackelford County,2020-Nov,1725,1632,93,5.4
Shackelford County,2020-Dec,1755,1662,93,5.3
Shackelford County,2021-Jan,1789,1695,94,5.3
Shackelford County,2021-Feb,1849,1759,90,4.9
Shackelford County,2021-Mar,1889,1813,76,4
Shackelford County,2021-Apr,1850,1781,69,3.7
Shackelford County,2021-May,1830,1760,70,3.8
Shackelford County,2021-Jun,1861,1775,86,4.6
Shackelford County,2021-Jul,1875,1797,78,4.2
Shackelford County,2021-Aug,1908,1833,75,3.9
Shackelford County,2021-Sep,1853,1784,69,3.7
Shackelford County,2021-Oct,1832,1768,64,3.5
Shackelford County,2021-Nov,1793,1732,61,3.4
Shackelford County,2021-Dec,1807,1751,56,3.1
Shackelford County,2022-Jan,1804,1739,65,3.6
Shackelford County,2022-Feb,1884,1827,57,3
Shackelford County,2022-Mar,1943,1895,48,2.5
Shackelford County,2022-Apr,1878,1835,43,2.3
Shackelford County,2022-May,1839,1792,47,2.6
Shackelford County,2022-Jun,1861,1806,55,3
Shackelford County,2022-Jul,1927(P),1875(P),52(P),2.7(P)
Shelby County,2012-Jan,12100,11240,860,7.1
Shelby County,2012-Feb,12036,11193,843,7
Shelby County,2012-Mar,12124,11320,804,6.6
Shelby County,2012-Apr,12189,11407,782,6.4
Shelby County,2012-May,12262,11394,868,7.1
Shelby County,2012-Jun,12355,11358,997,8.1
Shelby County,2012-Jul,12271,11275,996,8.1
Shelby County,2012-Aug,12027,11086,941,7.8
Shelby County,2012-Sep,12002,11155,847,7.1
Shelby County,2012-Oct,11980,11143,837,7
Shelby County,2012-Nov,11976,11151,825,6.9
Shelby County,2012-Dec,11843,10962,881,7.4
Shelby County,2013-Jan,11615,10668,947,8.2
Shelby County,2013-Feb,11573,10669,904,7.8
Shelby County,2013-Mar,11442,10611,831,7.3
Shelby County,2013-Apr,11652,10856,796,6.8
Shelby County,2013-May,11808,10974,834,7.1
Shelby County,2013-Jun,11902,10971,931,7.8
Shelby County,2013-Jul,11949,11028,921,7.7
Shelby County,2013-Aug,11700,10778,922,7.9
Shelby County,2013-Sep,11712,10799,913,7.8
Shelby County,2013-Oct,11397,10550,847,7.4
Shelby County,2013-Nov,11308,10503,805,7.1
Shelby County,2013-Dec,11254,10480,774,6.9
Shelby County,2014-Jan,11480,10693,787,6.9
Shelby County,2014-Feb,11621,10837,784,6.7
Shelby County,2014-Mar,11654,10905,749,6.4
Shelby County,2014-Apr,11681,11020,661,5.7
Shelby County,2014-May,11705,11024,681,5.8
Shelby County,2014-Jun,11706,10980,726,6.2
Shelby County,2014-Jul,11724,10963,761,6.5
Shelby County,2014-Aug,11539,10817,722,6.3
Shelby County,2014-Sep,11649,10987,662,5.7
Shelby County,2014-Oct,11564,10980,584,5.1
Shelby County,2014-Nov,11472,10885,587,5.1
Shelby County,2014-Dec,11380,10837,543,4.8
Shelby County,2015-Jan,11498,10909,589,5.1
Shelby County,2015-Feb,11489,10913,576,5
Shelby County,2015-Mar,11467,10912,555,4.8
Shelby County,2015-Apr,11432,10900,532,4.7
Shelby County,2015-May,11510,10917,593,5.2
Shelby County,2015-Jun,11532,10867,665,5.8
Shelby County,2015-Jul,11545,10863,682,5.9
Shelby County,2015-Aug,11319,10668,651,5.8
Shelby County,2015-Sep,11401,10793,608,5.3
Shelby County,2015-Oct,11234,10635,599,5.3
Shelby County,2015-Nov,11086,10491,595,5.4
Shelby County,2015-Dec,11085,10489,596,5.4
Shelby County,2016-Jan,10952,10307,645,5.9
Shelby County,2016-Feb,11181,10555,626,5.6
Shelby County,2016-Mar,11187,10538,649,5.8
Shelby County,2016-Apr,11099,10471,628,5.7
Shelby County,2016-May,11126,10485,641,5.8
Shelby County,2016-Jun,11170,10420,750,6.7
Shelby County,2016-Jul,10970,10237,733,6.7
Shelby County,2016-Aug,10885,10167,718,6.6
Shelby County,2016-Sep,10817,10139,678,6.3
Shelby County,2016-Oct,10752,10148,604,5.6
Shelby County,2016-Nov,10729,10119,610,5.7
Shelby County,2016-Dec,10642,10016,626,5.9
Shelby County,2017-Jan,10592,9915,677,6.4
Shelby County,2017-Feb,10684,10031,653,6.1
Shelby County,2017-Mar,10824,10221,603,5.6
Shelby County,2017-Apr,10785,10244,541,5
Shelby County,2017-May,10720,10181,539,5
Shelby County,2017-Jun,10848,10268,580,5.3
Shelby County,2017-Jul,10719,10131,588,5.5
Shelby County,2017-Aug,10746,10179,567,5.3
Shelby County,2017-Sep,10678,10179,499,4.7
Shelby County,2017-Oct,10588,10127,461,4.4
Shelby County,2017-Nov,10606,10127,479,4.5
Shelby County,2017-Dec,10603,10109,494,4.7
Shelby County,2018-Jan,10670,10137,533,5
Shelby County,2018-Feb,10813,10315,498,4.6
Shelby County,2018-Mar,10936,10447,489,4.5
Shelby County,2018-Apr,10864,10431,433,4
Shelby County,2018-May,10877,10448,429,3.9
Shelby County,2018-Jun,11013,10493,520,4.7
Shelby County,2018-Jul,11071,10566,505,4.6
Shelby County,2018-Aug,11146,10666,480,4.3
Shelby County,2018-Sep,11034,10584,450,4.1
Shelby County,2018-Oct,10934,10486,448,4.1
Shelby County,2018-Nov,10855,10420,435,4
Shelby County,2018-Dec,10790,10331,459,4.3
Shelby County,2019-Jan,10763,10235,528,4.9
Shelby County,2019-Feb,10883,10433,450,4.1
Shelby County,2019-Mar,10885,10455,430,4
Shelby County,2019-Apr,10832,10478,354,3.3
Shelby County,2019-May,10997,10629,368,3.3
Shelby County,2019-Jun,11138,10684,454,4.1
Shelby County,2019-Jul,11114,10629,485,4.4
Shelby County,2019-Aug,11163,10707,456,4.1
Shelby County,2019-Sep,11135,10714,421,3.8
Shelby County,2019-Oct,11130,10725,405,3.6
Shelby County,2019-Nov,11086,10661,425,3.8
Shelby County,2019-Dec,11063,10643,420,3.8
Shelby County,2020-Jan,11099,10622,477,4.3
Shelby County,2020-Feb,11142,10701,441,4
Shelby County,2020-Mar,11034,10375,659,6
Shelby County,2020-Apr,10496,9666,830,7.9
Shelby County,2020-May,10856,9884,972,9
Shelby County,2020-Jun,11075,10050,1025,9.3
Shelby County,2020-Jul,11316,10341,975,8.6
Shelby County,2020-Aug,11403,10599,804,7.1
Shelby County,2020-Sep,11292,10505,787,7
Shelby County,2020-Oct,11493,10792,701,6.1
Shelby County,2020-Nov,11254,10519,735,6.5
Shelby County,2020-Dec,11188,10465,723,6.5
Shelby County,2021-Jan,11285,10511,774,6.9
Shelby County,2021-Feb,11432,10674,758,6.6
Shelby County,2021-Mar,11560,10864,696,6
Shelby County,2021-Apr,11484,10843,641,5.6
Shelby County,2021-May,11344,10737,607,5.4
Shelby County,2021-Jun,11434,10739,695,6.1
Shelby County,2021-Jul,11675,11046,629,5.4
Shelby County,2021-Aug,11712,11119,593,5.1
Shelby County,2021-Sep,11570,11011,559,4.8
Shelby County,2021-Oct,11580,11057,523,4.5
Shelby County,2021-Nov,11403,10897,506,4.4
Shelby County,2021-Dec,11322,10844,478,4.2
Shelby County,2022-Jan,11412,10848,564,4.9
Shelby County,2022-Feb,11628,11075,553,4.8
Shelby County,2022-Mar,11785,11345,440,3.7
Shelby County,2022-Apr,11777,11356,421,3.6
Shelby County,2022-May,11670,11233,437,3.7
Shelby County,2022-Jun,11744,11236,508,4.3
Shelby County,2022-Jul,11916(P),11399(P),517(P),4.3(P)
Sherman County,2012-Jan,1511,1448,63,4.2
Sherman County,2012-Feb,1468,1406,62,4.2
Sherman County,2012-Mar,1474,1419,55,3.7
Sherman County,2012-Apr,1504,1449,55,3.7
Sherman County,2012-May,1514,1454,60,4
Sherman County,2012-Jun,1549,1476,73,4.7
Sherman County,2012-Jul,1559,1489,70,4.5
Sherman County,2012-Aug,1527,1456,71,4.6
Sherman County,2012-Sep,1507,1447,60,4
Sherman County,2012-Oct,1478,1416,62,4.2
Sherman County,2012-Nov,1463,1405,58,4
Sherman County,2012-Dec,1452,1392,60,4.1
Sherman County,2013-Jan,1418,1350,68,4.8
Sherman County,2013-Feb,1409,1347,62,4.4
Sherman County,2013-Mar,1399,1341,58,4.1
Sherman County,2013-Apr,1456,1402,54,3.7
Sherman County,2013-May,1505,1445,60,4
Sherman County,2013-Jun,1528,1459,69,4.5
Sherman County,2013-Jul,1559,1490,69,4.4
Sherman County,2013-Aug,1502,1441,61,4.1
Sherman County,2013-Sep,1528,1467,61,4
Sherman County,2013-Oct,1503,1448,55,3.7
Sherman County,2013-Nov,1443,1387,56,3.9
Sherman County,2013-Dec,1476,1424,52,3.5
Sherman County,2014-Jan,1469,1418,51,3.5
Sherman County,2014-Feb,1503,1450,53,3.5
Sherman County,2014-Mar,1491,1443,48,3.2
Sherman County,2014-Apr,1526,1486,40,2.6
Sherman County,2014-May,1559,1514,45,2.9
Sherman County,2014-Jun,1549,1497,52,3.4
Sherman County,2014-Jul,1546,1486,60,3.9
Sherman County,2014-Aug,1489,1438,51,3.4
Sherman County,2014-Sep,1486,1436,50,3.4
Sherman County,2014-Oct,1505,1461,44,2.9
Sherman County,2014-Nov,1473,1430,43,2.9
Sherman County,2014-Dec,1440,1403,37,2.6
Sherman County,2015-Jan,1444,1403,41,2.8
Sherman County,2015-Feb,1514,1476,38,2.5
Sherman County,2015-Mar,1481,1445,36,2.4
Sherman County,2015-Apr,1437,1404,33,2.3
Sherman County,2015-May,1466,1427,39,2.7
Sherman County,2015-Jun,1470,1426,44,3
Sherman County,2015-Jul,1414,1368,46,3.3
Sherman County,2015-Aug,1350,1310,40,3
Sherman County,2015-Sep,1396,1357,39,2.8
Sherman County,2015-Oct,1383,1344,39,2.8
Sherman County,2015-Nov,1350,1311,39,2.9
Sherman County,2015-Dec,1345,1307,38,2.8
Sherman County,2016-Jan,1294,1252,42,3.2
Sherman County,2016-Feb,1396,1355,41,2.9
Sherman County,2016-Mar,1417,1376,41,2.9
Sherman County,2016-Apr,1409,1376,33,2.3
Sherman County,2016-May,1456,1423,33,2.3
Sherman County,2016-Jun,1420,1380,40,2.8
Sherman County,2016-Jul,1337,1293,44,3.3
Sherman County,2016-Aug,1339,1297,42,3.1
Sherman County,2016-Sep,1316,1274,42,3.2
Sherman County,2016-Oct,1289,1249,40,3.1
Sherman County,2016-Nov,1269,1231,38,3
Sherman County,2016-Dec,1266,1228,38,3
Sherman County,2017-Jan,1229,1187,42,3.4
Sherman County,2017-Feb,1245,1204,41,3.3
Sherman County,2017-Mar,1333,1293,40,3
Sherman County,2017-Apr,1296,1261,35,2.7
Sherman County,2017-May,1324,1284,40,3
Sherman County,2017-Jun,1305,1258,47,3.6
Sherman County,2017-Jul,1247,1202,45,3.6
Sherman County,2017-Aug,1272,1230,42,3.3
Sherman County,2017-Sep,1263,1227,36,2.9
Sherman County,2017-Oct,1320,1286,34,2.6
Sherman County,2017-Nov,1252,1215,37,3
Sherman County,2017-Dec,1266,1230,36,2.8
Sherman County,2018-Jan,1233,1198,35,2.8
Sherman County,2018-Feb,1245,1208,37,3
Sherman County,2018-Mar,1321,1285,36,2.7
Sherman County,2018-Apr,1304,1274,30,2.3
Sherman County,2018-May,1365,1333,32,2.3
Sherman County,2018-Jun,1354,1314,40,3
Sherman County,2018-Jul,1364,1327,37,2.7
Sherman County,2018-Aug,1381,1345,36,2.6
Sherman County,2018-Sep,1343,1309,34,2.5
Sherman County,2018-Oct,1327,1291,36,2.7
Sherman County,2018-Nov,1313,1280,33,2.5
Sherman County,2018-Dec,1254,1220,34,2.7
Sherman County,2019-Jan,1280,1243,37,2.9
Sherman County,2019-Feb,1373,1339,34,2.5
Sherman County,2019-Mar,1383,1350,33,2.4
Sherman County,2019-Apr,1341,1314,27,2
Sherman County,2019-May,1351,1323,28,2.1
Sherman County,2019-Jun,1370,1334,36,2.6
Sherman County,2019-Jul,1343,1306,37,2.8
Sherman County,2019-Aug,1378,1345,33,2.4
Sherman County,2019-Sep,1359,1328,31,2.3
Sherman County,2019-Oct,1378,1349,29,2.1
Sherman County,2019-Nov,1312,1282,30,2.3
Sherman County,2019-Dec,1349,1324,25,1.9
Sherman County,2020-Jan,1328,1294,34,2.6
Sherman County,2020-Feb,1343,1312,31,2.3
Sherman County,2020-Mar,1326,1276,50,3.8
Sherman County,2020-Apr,1250,1221,29,2.3
Sherman County,2020-May,1210,1174,36,3
Sherman County,2020-Jun,1239,1191,48,3.9
Sherman County,2020-Jul,1266,1220,46,3.6
Sherman County,2020-Aug,1294,1261,33,2.6
Sherman County,2020-Sep,1292,1255,37,2.9
Sherman County,2020-Oct,1375,1333,42,3.1
Sherman County,2020-Nov,1299,1255,44,3.4
Sherman County,2020-Dec,1310,1263,47,3.6
Sherman County,2021-Jan,1343,1293,50,3.7
Sherman County,2021-Feb,1394,1346,48,3.4
Sherman County,2021-Mar,1440,1393,47,3.3
Sherman County,2021-Apr,1466,1428,38,2.6
Sherman County,2021-May,1457,1418,39,2.7
Sherman County,2021-Jun,1440,1391,49,3.4
Sherman County,2021-Jul,1419,1377,42,3
Sherman County,2021-Aug,1399,1360,39,2.8
Sherman County,2021-Sep,1410,1370,40,2.8
Sherman County,2021-Oct,1414,1375,39,2.8
Sherman County,2021-Nov,1352,1316,36,2.7
Sherman County,2021-Dec,1362,1328,34,2.5
Sherman County,2022-Jan,1373,1333,40,2.9
Sherman County,2022-Feb,1487,1446,41,2.8
Sherman County,2022-Mar,1548,1514,34,2.2
Sherman County,2022-Apr,1562,1533,29,1.9
Sherman County,2022-May,1511,1478,33,2.2
Sherman County,2022-Jun,1492,1454,38,2.5
Sherman County,2022-Jul,1554(P),1517(P),37(P),2.4(P)
Smith County,2012-Jan,100742,92993,7749,7.7
Smith County,2012-Feb,101231,93743,7488,7.4
Smith County,2012-Mar,101033,94137,6896,6.8
Smith County,2012-Apr,100947,94488,6459,6.4
Smith County,2012-May,101742,94882,6860,6.7
Smith County,2012-Jun,102553,94968,7585,7.4
Smith County,2012-Jul,102819,95276,7543,7.3
Smith County,2012-Aug,101868,94478,7390,7.3
Smith County,2012-Sep,101005,94141,6864,6.8
Smith County,2012-Oct,101368,94495,6873,6.8
Smith County,2012-Nov,101542,94844,6698,6.6
Smith County,2012-Dec,101386,94653,6733,6.6
Smith County,2013-Jan,100591,93142,7449,7.4
Smith County,2013-Feb,100480,93633,6847,6.8
Smith County,2013-Mar,100810,94315,6495,6.4
Smith County,2013-Apr,101686,95496,6190,6.1
Smith County,2013-May,101821,95346,6475,6.4
Smith County,2013-Jun,102258,95138,7120,7
Smith County,2013-Jul,101986,95042,6944,6.8
Smith County,2013-Aug,102100,94991,7109,7
Smith County,2013-Sep,101837,94840,6997,6.9
Smith County,2013-Oct,100885,94350,6535,6.5
Smith County,2013-Nov,101639,95347,6292,6.2
Smith County,2013-Dec,101266,95456,5810,5.7
Smith County,2014-Jan,101342,95075,6267,6.2
Smith County,2014-Feb,101399,95225,6174,6.1
Smith County,2014-Mar,101484,95738,5746,5.7
Smith County,2014-Apr,101397,96405,4992,4.9
Smith County,2014-May,102438,97169,5269,5.1
Smith County,2014-Jun,102241,96603,5638,5.5
Smith County,2014-Jul,102662,96918,5744,5.6
Smith County,2014-Aug,102414,96966,5448,5.3
Smith County,2014-Sep,101952,96655,5297,5.2
Smith County,2014-Oct,102701,97754,4947,4.8
Smith County,2014-Nov,102930,98116,4814,4.7
Smith County,2014-Dec,102383,98048,4335,4.2
Smith County,2015-Jan,102947,97985,4962,4.8
Smith County,2015-Feb,102723,98089,4634,4.5
Smith County,2015-Mar,102619,98094,4525,4.4
Smith County,2015-Apr,103193,98958,4235,4.1
Smith County,2015-May,103235,98687,4548,4.4
Smith County,2015-Jun,103808,98946,4862,4.7
Smith County,2015-Jul,104581,99447,5134,4.9
Smith County,2015-Aug,104375,99574,4801,4.6
Smith County,2015-Sep,103828,99126,4702,4.5
Smith County,2015-Oct,104140,99548,4592,4.4
Smith County,2015-Nov,104595,99998,4597,4.4
Smith County,2015-Dec,105281,100744,4537,4.3
Smith County,2016-Jan,103443,98987,4456,4.3
Smith County,2016-Feb,104233,99786,4447,4.3
Smith County,2016-Mar,104547,99978,4569,4.4
Smith County,2016-Apr,105090,100768,4322,4.1
Smith County,2016-May,105769,101413,4356,4.1
Smith County,2016-Jun,105972,100829,5143,4.9
Smith County,2016-Jul,106312,101101,5211,4.9
Smith County,2016-Aug,106607,101231,5376,5
Smith County,2016-Sep,106175,100939,5236,4.9
Smith County,2016-Oct,105818,100959,4859,4.6
Smith County,2016-Nov,105925,101252,4673,4.4
Smith County,2016-Dec,105924,101233,4691,4.4
Smith County,2017-Jan,103190,98162,5028,4.9
Smith County,2017-Feb,103900,98998,4902,4.7
Smith County,2017-Mar,104276,99700,4576,4.4
Smith County,2017-Apr,104643,100555,4088,3.9
Smith County,2017-May,105388,101275,4113,3.9
Smith County,2017-Jun,105033,100607,4426,4.2
Smith County,2017-Jul,105312,100952,4360,4.1
Smith County,2017-Aug,105270,100959,4311,4.1
Smith County,2017-Sep,105767,101641,4126,3.9
Smith County,2017-Oct,106883,102393,4490,4.2
Smith County,2017-Nov,106660,102725,3935,3.7
Smith County,2017-Dec,106676,102844,3832,3.6
Smith County,2018-Jan,104002,99838,4164,4
Smith County,2018-Feb,105116,101042,4074,3.9
Smith County,2018-Mar,104875,100975,3900,3.7
Smith County,2018-Apr,105657,102055,3602,3.4
Smith County,2018-May,106339,102740,3599,3.4
Smith County,2018-Jun,106160,101912,4248,4
Smith County,2018-Jul,106630,102589,4041,3.8
Smith County,2018-Aug,105963,101993,3970,3.7
Smith County,2018-Sep,105824,102037,3787,3.6
Smith County,2018-Oct,105986,102211,3775,3.6
Smith County,2018-Nov,106306,102562,3744,3.5
Smith County,2018-Dec,106663,102860,3803,3.6
Smith County,2019-Jan,105728,101554,4174,3.9
Smith County,2019-Feb,106521,102684,3837,3.6
Smith County,2019-Mar,106448,102873,3575,3.4
Smith County,2019-Apr,105947,102868,3079,2.9
Smith County,2019-May,106969,103827,3142,2.9
Smith County,2019-Jun,107124,103288,3836,3.6
Smith County,2019-Jul,107412,103509,3903,3.6
Smith County,2019-Aug,107361,103602,3759,3.5
Smith County,2019-Sep,107223,103715,3508,3.3
Smith County,2019-Oct,107660,104266,3394,3.2
Smith County,2019-Nov,107777,104369,3408,3.2
Smith County,2019-Dec,107925,104699,3226,3
Smith County,2020-Jan,107395,103663,3732,3.5
Smith County,2020-Feb,108103,104588,3515,3.3
Smith County,2020-Mar,106374,100980,5394,5.1
Smith County,2020-Apr,101388,90107,11281,11.1
Smith County,2020-May,105675,94670,11005,10.4
Smith County,2020-Jun,107386,97414,9972,9.3
Smith County,2020-Jul,107739,98752,8987,8.3
Smith County,2020-Aug,108405,101106,7299,6.7
Smith County,2020-Sep,108476,101448,7028,6.5
Smith County,2020-Oct,109255,102980,6275,5.7
Smith County,2020-Nov,109597,103097,6500,5.9
Smith County,2020-Dec,110237,103705,6532,5.9
Smith County,2021-Jan,108842,101853,6989,6.4
Smith County,2021-Feb,109951,103078,6873,6.3
Smith County,2021-Mar,109587,103141,6446,5.9
Smith County,2021-Apr,109368,103550,5818,5.3
Smith County,2021-May,110188,104647,5541,5
Smith County,2021-Jun,110192,103841,6351,5.8
Smith County,2021-Jul,110429,104648,5781,5.2
Smith County,2021-Aug,110228,104752,5476,5
Smith County,2021-Sep,109737,104663,5074,4.6
Smith County,2021-Oct,110633,105810,4823,4.4
Smith County,2021-Nov,110877,106335,4542,4.1
Smith County,2021-Dec,111105,106948,4157,3.7
Smith County,2022-Jan,110106,105311,4795,4.4
Smith County,2022-Feb,111842,107086,4756,4.3
Smith County,2022-Mar,111749,107887,3862,3.5
Smith County,2022-Apr,110380,106756,3624,3.3
Smith County,2022-May,110338,106462,3876,3.5
Smith County,2022-Jun,110526,106045,4481,4.1
Smith County,2022-Jul,110511(P),106160(P),4351(P),3.9(P)
Somervell County,2012-Jan,4088,3791,297,7.3
Somervell County,2012-Feb,4099,3815,284,6.9
Somervell County,2012-Mar,4098,3832,266,6.5
Somervell County,2012-Apr,4092,3852,240,5.9
Somervell County,2012-May,4121,3858,263,6.4
Somervell County,2012-Jun,4163,3863,300,7.2
Somervell County,2012-Jul,4166,3859,307,7.4
Somervell County,2012-Aug,4146,3860,286,6.9
Somervell County,2012-Sep,4154,3887,267,6.4
Somervell County,2012-Oct,4141,3898,243,5.9
Somervell County,2012-Nov,4163,3911,252,6.1
Somervell County,2012-Dec,4176,3912,264,6.3
Somervell County,2013-Jan,4113,3817,296,7.2
Somervell County,2013-Feb,4100,3842,258,6.3
Somervell County,2013-Mar,4090,3849,241,5.9
Somervell County,2013-Apr,4110,3884,226,5.5
Somervell County,2013-May,4157,3896,261,6.3
Somervell County,2013-Jun,4178,3891,287,6.9
Somervell County,2013-Jul,4183,3898,285,6.8
Somervell County,2013-Aug,4167,3900,267,6.4
Somervell County,2013-Sep,4163,3914,249,6
Somervell County,2013-Oct,4115,3889,226,5.5
Somervell County,2013-Nov,4144,3928,216,5.2
Somervell County,2013-Dec,4140,3933,207,5
Somervell County,2014-Jan,4062,3839,223,5.5
Somervell County,2014-Feb,4084,3869,215,5.3
Somervell County,2014-Mar,4089,3895,194,4.7
Somervell County,2014-Apr,4087,3915,172,4.2
Somervell County,2014-May,4137,3919,218,5.3
Somervell County,2014-Jun,4162,3924,238,5.7
Somervell County,2014-Jul,4164,3919,245,5.9
Somervell County,2014-Aug,4152,3911,241,5.8
Somervell County,2014-Sep,4140,3930,210,5.1
Somervell County,2014-Oct,4148,3949,199,4.8
Somervell County,2014-Nov,4175,3959,216,5.2
Somervell County,2014-Dec,4163,3960,203,4.9
Somervell County,2015-Jan,4077,3859,218,5.3
Somervell County,2015-Feb,4067,3869,198,4.9
Somervell County,2015-Mar,4047,3867,180,4.4
Somervell County,2015-Apr,4085,3907,178,4.4
Somervell County,2015-May,4122,3920,202,4.9
Somervell County,2015-Jun,4142,3904,238,5.7
Somervell County,2015-Jul,4135,3904,231,5.6
Somervell County,2015-Aug,4123,3907,216,5.2
Somervell County,2015-Sep,4109,3903,206,5
Somervell County,2015-Oct,4116,3919,197,4.8
Somervell County,2015-Nov,4151,3937,214,5.2
Somervell County,2015-Dec,4167,3952,215,5.2
Somervell County,2016-Jan,4069,3865,204,5
Somervell County,2016-Feb,4104,3903,201,4.9
Somervell County,2016-Mar,4107,3912,195,4.7
Somervell County,2016-Apr,4111,3933,178,4.3
Somervell County,2016-May,4117,3936,181,4.4
Somervell County,2016-Jun,4153,3930,223,5.4
Somervell County,2016-Jul,4165,3942,223,5.4
Somervell County,2016-Aug,4153,3942,211,5.1
Somervell County,2016-Sep,4147,3949,198,4.8
Somervell County,2016-Oct,4132,3950,182,4.4
Somervell County,2016-Nov,4161,3978,183,4.4
Somervell County,2016-Dec,4190,3977,213,5.1
Somervell County,2017-Jan,4121,3887,234,5.7
Somervell County,2017-Feb,4120,3910,210,5.1
Somervell County,2017-Mar,4114,3931,183,4.4
Somervell County,2017-Apr,4117,3954,163,4
Somervell County,2017-May,4125,3943,182,4.4
Somervell County,2017-Jun,4170,3955,215,5.2
Somervell County,2017-Jul,4189,3976,213,5.1
Somervell County,2017-Aug,4188,3979,209,5
Somervell County,2017-Sep,4192,4010,182,4.3
Somervell County,2017-Oct,4152,4001,151,3.6
Somervell County,2017-Nov,4203,4024,179,4.3
Somervell County,2017-Dec,4194,4022,172,4.1
Somervell County,2018-Jan,4208,4007,201,4.8
Somervell County,2018-Feb,4244,4047,197,4.6
Somervell County,2018-Mar,4222,4048,174,4.1
Somervell County,2018-Apr,4230,4070,160,3.8
Somervell County,2018-May,4244,4071,173,4.1
Somervell County,2018-Jun,4278,4073,205,4.8
Somervell County,2018-Jul,4290,4084,206,4.8
Somervell County,2018-Aug,4259,4066,193,4.5
Somervell County,2018-Sep,4251,4083,168,4
Somervell County,2018-Oct,4254,4103,151,3.5
Somervell County,2018-Nov,4265,4116,149,3.5
Somervell County,2018-Dec,4265,4122,143,3.4
Somervell County,2019-Jan,4273,4093,180,4.2
Somervell County,2019-Feb,4296,4126,170,4
Somervell County,2019-Mar,4283,4128,155,3.6
Somervell County,2019-Apr,4258,4129,129,3
Somervell County,2019-May,4262,4132,130,3.1
Somervell County,2019-Jun,4309,4142,167,3.9
Somervell County,2019-Jul,4325,4161,164,3.8
Somervell County,2019-Aug,4326,4166,160,3.7
Somervell County,2019-Sep,4345,4191,154,3.5
Somervell County,2019-Oct,4353,4209,144,3.3
Somervell County,2019-Nov,4383,4238,145,3.3
Somervell County,2019-Dec,4397,4241,156,3.5
Somervell County,2020-Jan,4324,4155,169,3.9
Somervell County,2020-Feb,4339,4186,153,3.5
Somervell County,2020-Mar,4260,4038,222,5.2
Somervell County,2020-Apr,3912,3540,372,9.5
Somervell County,2020-May,4080,3685,395,9.7
Somervell County,2020-Jun,4209,3820,389,9.2
Somervell County,2020-Jul,4234,3888,346,8.2
Somervell County,2020-Aug,4258,3978,280,6.6
Somervell County,2020-Sep,4266,3994,272,6.4
Somervell County,2020-Oct,4315,4087,228,5.3
Somervell County,2020-Nov,4336,4091,245,5.7
Somervell County,2020-Dec,4357,4099,258,5.9
Somervell County,2021-Jan,4337,4061,276,6.4
Somervell County,2021-Feb,4361,4084,277,6.4
Somervell County,2021-Mar,4378,4111,267,6.1
Somervell County,2021-Apr,4364,4126,238,5.5
Somervell County,2021-May,4362,4130,232,5.3
Somervell County,2021-Jun,4397,4135,262,6
Somervell County,2021-Jul,4400,4168,232,5.3
Somervell County,2021-Aug,4398,4185,213,4.8
Somervell County,2021-Sep,4403,4205,198,4.5
Somervell County,2021-Oct,4427,4239,188,4.2
Somervell County,2021-Nov,4474,4296,178,4
Somervell County,2021-Dec,4474,4303,171,3.8
Somervell County,2022-Jan,4450,4260,190,4.3
Somervell County,2022-Feb,4500,4316,184,4.1
Somervell County,2022-Mar,4516,4364,152,3.4
Somervell County,2022-Apr,4490,4349,141,3.1
Somervell County,2022-May,4515,4356,159,3.5
Somervell County,2022-Jun,4534,4345,189,4.2
Somervell County,2022-Jul,4561(P),4371(P),190(P),4.2(P)
Starr County,2012-Jan,26728,22391,4337,16.2
Starr County,2012-Feb,26492,22301,4191,15.8
Starr County,2012-Mar,26187,22345,3842,14.7
Starr County,2012-Apr,25701,22163,3538,13.8
Starr County,2012-May,25623,22039,3584,14
Starr County,2012-Jun,25917,21943,3974,15.3
Starr County,2012-Jul,25771,21858,3913,15.2
Starr County,2012-Aug,25322,21757,3565,14.1
Starr County,2012-Sep,25472,22198,3274,12.9
Starr County,2012-Oct,25797,22444,3353,13
Starr County,2012-Nov,26021,22566,3455,13.3
Starr County,2012-Dec,26457,22482,3975,15
Starr County,2013-Jan,26931,22474,4457,16.5
Starr County,2013-Feb,26902,22558,4344,16.1
Starr County,2013-Mar,26550,22490,4060,15.3
Starr County,2013-Apr,26615,22797,3818,14.3
Starr County,2013-May,26603,22602,4001,15
Starr County,2013-Jun,26540,22424,4116,15.5
Starr County,2013-Jul,26139,22198,3941,15.1
Starr County,2013-Aug,25819,22008,3811,14.8
Starr County,2013-Sep,25768,22150,3618,14
Starr County,2013-Oct,25613,22008,3605,14.1
Starr County,2013-Nov,26022,22182,3840,14.8
Starr County,2013-Dec,26232,22253,3979,15.2
Starr County,2014-Jan,26664,22394,4270,16
Starr County,2014-Feb,26709,22500,4209,15.8
Starr County,2014-Mar,26567,22572,3995,15
Starr County,2014-Apr,26450,22762,3688,13.9
Starr County,2014-May,26111,22689,3422,13.1
Starr County,2014-Jun,25930,22273,3657,14.1
Starr County,2014-Jul,25631,22015,3616,14.1
Starr County,2014-Aug,25475,21979,3496,13.7
Starr County,2014-Sep,25479,22390,3089,12.1
Starr County,2014-Oct,25393,22435,2958,11.6
Starr County,2014-Nov,25768,22444,3324,12.9
Starr County,2014-Dec,25699,22359,3340,13
Starr County,2015-Jan,26212,22383,3829,14.6
Starr County,2015-Feb,26158,22458,3700,14.1
Starr County,2015-Mar,26262,22581,3681,14
Starr County,2015-Apr,26146,22719,3427,13.1
Starr County,2015-May,26097,22700,3397,13
Starr County,2015-Jun,26032,22343,3689,14.2
Starr County,2015-Jul,25567,21970,3597,14.1
Starr County,2015-Aug,25365,21921,3444,13.6
Starr County,2015-Sep,25229,22032,3197,12.7
Starr County,2015-Oct,25639,22417,3222,12.6
Starr County,2015-Nov,26014,22525,3489,13.4
Starr County,2015-Dec,26202,22687,3515,13.4
Starr County,2016-Jan,26411,22721,3690,14
Starr County,2016-Feb,26817,23139,3678,13.7
Starr County,2016-Mar,26900,23119,3781,14.1
Starr County,2016-Apr,26704,23186,3518,13.2
Starr County,2016-May,26430,23227,3203,12.1
Starr County,2016-Jun,26544,22862,3682,13.9
Starr County,2016-Jul,26023,22371,3652,14
Starr County,2016-Aug,25946,22396,3550,13.7
Starr County,2016-Sep,25972,22518,3454,13.3
Starr County,2016-Oct,25736,22662,3074,11.9
Starr County,2016-Nov,26187,22847,3340,12.8
Starr County,2016-Dec,26710,22994,3716,13.9
Starr County,2017-Jan,27169,22868,4301,15.8
Starr County,2017-Feb,27007,22948,4059,15
Starr County,2017-Mar,26873,23223,3650,13.6
Starr County,2017-Apr,26704,23306,3398,12.7
Starr County,2017-May,26138,23249,2889,11.1
Starr County,2017-Jun,26108,22962,3146,12
Starr County,2017-Jul,25427,22528,2899,11.4
Starr County,2017-Aug,25072,22310,2762,11
Starr County,2017-Sep,24976,22505,2471,9.9
Starr County,2017-Oct,24964,22769,2195,8.8
Starr County,2017-Nov,25143,22694,2449,9.7
Starr County,2017-Dec,25573,22883,2690,10.5
Starr County,2018-Jan,26004,22727,3277,12.6
Starr County,2018-Feb,25827,22790,3037,11.8
Starr County,2018-Mar,25647,22884,2763,10.8
Starr County,2018-Apr,25596,22857,2739,10.7
Starr County,2018-May,25210,22799,2411,9.6
Starr County,2018-Jun,25162,22303,2859,11.4
Starr County,2018-Jul,24205,21588,2617,10.8
Starr County,2018-Aug,24063,21797,2266,9.4
Starr County,2018-Sep,24030,21893,2137,8.9
Starr County,2018-Oct,24361,22392,1969,8.1
Starr County,2018-Nov,24473,22438,2035,8.3
Starr County,2018-Dec,24835,22464,2371,9.5
Starr County,2019-Jan,25444,22709,2735,10.7
Starr County,2019-Feb,25397,22874,2523,9.9
Starr County,2019-Mar,25217,22998,2219,8.8
Starr County,2019-Apr,24894,22922,1972,7.9
Starr County,2019-May,24715,22758,1957,7.9
Starr County,2019-Jun,24531,22057,2474,10.1
Starr County,2019-Jul,24410,21749,2661,10.9
Starr County,2019-Aug,24517,22091,2426,9.9
Starr County,2019-Sep,24289,21896,2393,9.9
Starr County,2019-Oct,24779,22442,2337,9.4
Starr County,2019-Nov,24974,22267,2707,10.8
Starr County,2019-Dec,25054,21969,3085,12.3
Starr County,2020-Jan,25886,22377,3509,13.6
Starr County,2020-Feb,25980,22777,3203,12.3
Starr County,2020-Mar,26182,21447,4735,18.1
Starr County,2020-Apr,25838,20466,5372,20.8
Starr County,2020-May,26653,20995,5658,21.2
Starr County,2020-Jun,26022,20581,5441,20.9
Starr County,2020-Jul,26234,21026,5208,19.9
Starr County,2020-Aug,26162,21704,4458,17
Starr County,2020-Sep,25735,21433,4302,16.7
Starr County,2020-Oct,25142,21363,3779,15
Starr County,2020-Nov,25446,21243,4203,16.5
Starr County,2020-Dec,25662,21083,4579,17.8
Starr County,2021-Jan,26239,21317,4922,18.8
Starr County,2021-Feb,26291,21438,4853,18.5
Starr County,2021-Mar,26024,21611,4413,17
Starr County,2021-Apr,25942,21506,4436,17.1
Starr County,2021-May,25418,21260,4158,16.4
Starr County,2021-Jun,25475,20827,4648,18.2
Starr County,2021-Jul,25421,21135,4286,16.9
Starr County,2021-Aug,25122,21224,3898,15.5
Starr County,2021-Sep,24831,21280,3551,14.3
Starr County,2021-Oct,24603,21243,3360,13.7
Starr County,2021-Nov,24623,21246,3377,13.7
Starr County,2021-Dec,24582,21073,3509,14.3
Starr County,2022-Jan,25541,21308,4233,16.6
Starr County,2022-Feb,25631,21567,4064,15.9
Starr County,2022-Mar,25139,21774,3365,13.4
Starr County,2022-Apr,24633,21444,3189,12.9
Starr County,2022-May,24332,21284,3048,12.5
Starr County,2022-Jun,24159,20707,3452,14.3
Starr County,2022-Jul,24261(P),20961(P),3300(P),13.6(P)
Stephens County,2012-Jan,4388,4104,284,6.5
Stephens County,2012-Feb,4398,4116,282,6.4
Stephens County,2012-Mar,4433,4178,255,5.8
Stephens County,2012-Apr,4411,4176,235,5.3
Stephens County,2012-May,4419,4164,255,5.8
Stephens County,2012-Jun,4416,4130,286,6.5
Stephens County,2012-Jul,4380,4100,280,6.4
Stephens County,2012-Aug,4359,4095,264,6.1
Stephens County,2012-Sep,4424,4176,248,5.6
Stephens County,2012-Oct,4327,4080,247,5.7
Stephens County,2012-Nov,4269,4042,227,5.3
Stephens County,2012-Dec,4255,4029,226,5.3
Stephens County,2013-Jan,4225,3971,254,6
Stephens County,2013-Feb,4268,4025,243,5.7
Stephens County,2013-Mar,4197,3975,222,5.3
Stephens County,2013-Apr,4179,3964,215,5.1
Stephens County,2013-May,4200,3981,219,5.2
Stephens County,2013-Jun,4235,4002,233,5.5
Stephens County,2013-Jul,4215,3983,232,5.5
Stephens County,2013-Aug,4170,3950,220,5.3
Stephens County,2013-Sep,4183,3968,215,5.1
Stephens County,2013-Oct,4177,3975,202,4.8
Stephens County,2013-Nov,4145,3961,184,4.4
Stephens County,2013-Dec,4193,4008,185,4.4
Stephens County,2014-Jan,4252,4044,208,4.9
Stephens County,2014-Feb,4277,4074,203,4.7
Stephens County,2014-Mar,4321,4118,203,4.7
Stephens County,2014-Apr,4302,4121,181,4.2
Stephens County,2014-May,4282,4087,195,4.6
Stephens County,2014-Jun,4313,4110,203,4.7
Stephens County,2014-Jul,4291,4089,202,4.7
Stephens County,2014-Aug,4236,4034,202,4.8
Stephens County,2014-Sep,4289,4106,183,4.3
Stephens County,2014-Oct,4315,4146,169,3.9
Stephens County,2014-Nov,4285,4117,168,3.9
Stephens County,2014-Dec,4256,4097,159,3.7
Stephens County,2015-Jan,4221,4046,175,4.1
Stephens County,2015-Feb,4254,4092,162,3.8
Stephens County,2015-Mar,4228,4070,158,3.7
Stephens County,2015-Apr,4224,4070,154,3.6
Stephens County,2015-May,4184,4009,175,4.2
Stephens County,2015-Jun,4174,3997,177,4.2
Stephens County,2015-Jul,4074,3889,185,4.5
Stephens County,2015-Aug,4006,3832,174,4.3
Stephens County,2015-Sep,4003,3827,176,4.4
Stephens County,2015-Oct,3966,3793,173,4.4
Stephens County,2015-Nov,3966,3782,184,4.6
Stephens County,2015-Dec,3998,3814,184,4.6
Stephens County,2016-Jan,3998,3795,203,5.1
Stephens County,2016-Feb,4014,3809,205,5.1
Stephens County,2016-Mar,4077,3866,211,5.2
Stephens County,2016-Apr,4053,3850,203,5
Stephens County,2016-May,4065,3859,206,5.1
Stephens County,2016-Jun,4108,3861,247,6
Stephens County,2016-Jul,4014,3785,229,5.7
Stephens County,2016-Aug,3989,3761,228,5.7
Stephens County,2016-Sep,4011,3791,220,5.5
Stephens County,2016-Oct,3998,3800,198,5
Stephens County,2016-Nov,3953,3751,202,5.1
Stephens County,2016-Dec,3949,3754,195,4.9
Stephens County,2017-Jan,3874,3679,195,5
Stephens County,2017-Feb,3923,3732,191,4.9
Stephens County,2017-Mar,4020,3811,209,5.2
Stephens County,2017-Apr,4024,3829,195,4.8
Stephens County,2017-May,3967,3778,189,4.8
Stephens County,2017-Jun,4008,3799,209,5.2
Stephens County,2017-Jul,3957,3772,185,4.7
Stephens County,2017-Aug,3980,3794,186,4.7
Stephens County,2017-Sep,3986,3824,162,4.1
Stephens County,2017-Oct,4013,3858,155,3.9
Stephens County,2017-Nov,3993,3834,159,4
Stephens County,2017-Dec,3963,3812,151,3.8
Stephens County,2018-Jan,3935,3765,170,4.3
Stephens County,2018-Feb,3961,3797,164,4.1
Stephens County,2018-Mar,3988,3831,157,3.9
Stephens County,2018-Apr,3930,3791,139,3.5
Stephens County,2018-May,3998,3861,137,3.4
Stephens County,2018-Jun,3979,3817,162,4.1
Stephens County,2018-Jul,3941,3793,148,3.8
Stephens County,2018-Aug,3907,3766,141,3.6
Stephens County,2018-Sep,3883,3744,139,3.6
Stephens County,2018-Oct,3933,3805,128,3.3
Stephens County,2018-Nov,4004,3881,123,3.1
Stephens County,2018-Dec,4008,3884,124,3.1
Stephens County,2019-Jan,4094,3954,140,3.4
Stephens County,2019-Feb,4143,4011,132,3.2
Stephens County,2019-Mar,4141,4016,125,3
Stephens County,2019-Apr,4103,3996,107,2.6
Stephens County,2019-May,4050,3937,113,2.8
Stephens County,2019-Jun,4024,3891,133,3.3
Stephens County,2019-Jul,4029,3897,132,3.3
Stephens County,2019-Aug,3991,3859,132,3.3
Stephens County,2019-Sep,3995,3873,122,3.1
Stephens County,2019-Oct,4004,3888,116,2.9
Stephens County,2019-Nov,3981,3873,108,2.7
Stephens County,2019-Dec,3976,3873,103,2.6
Stephens County,2020-Jan,3988,3859,129,3.2
Stephens County,2020-Feb,4022,3899,123,3.1
Stephens County,2020-Mar,3977,3790,187,4.7
Stephens County,2020-Apr,3762,3556,206,5.5
Stephens County,2020-May,3882,3579,303,7.8
Stephens County,2020-Jun,3925,3607,318,8.1
Stephens County,2020-Jul,3926,3601,325,8.3
Stephens County,2020-Aug,3981,3704,277,7
Stephens County,2020-Sep,4027,3753,274,6.8
Stephens County,2020-Oct,4107,3837,270,6.6
Stephens County,2020-Nov,4116,3854,262,6.4
Stephens County,2020-Dec,4224,3979,245,5.8
Stephens County,2021-Jan,4292,4032,260,6.1
Stephens County,2021-Feb,4310,4058,252,5.8
Stephens County,2021-Mar,4292,4043,249,5.8
Stephens County,2021-Apr,4182,3972,210,5
Stephens County,2021-May,4150,3942,208,5
Stephens County,2021-Jun,4179,3952,227,5.4
Stephens County,2021-Jul,4060,3853,207,5.1
Stephens County,2021-Aug,4104,3916,188,4.6
Stephens County,2021-Sep,4134,3954,180,4.4
Stephens County,2021-Oct,4147,3975,172,4.1
Stephens County,2021-Nov,4176,4013,163,3.9
Stephens County,2021-Dec,4252,4099,153,3.6
Stephens County,2022-Jan,4306,4133,173,4
Stephens County,2022-Feb,4367,4196,171,3.9
Stephens County,2022-Mar,4381,4239,142,3.2
Stephens County,2022-Apr,4314,4181,133,3.1
Stephens County,2022-May,4282,4145,137,3.2
Stephens County,2022-Jun,4312,4148,164,3.8
Stephens County,2022-Jul,4227(P),4071(P),156(P),3.7(P)
Sterling County,2012-Jan,662,637,25,3.8
Sterling County,2012-Feb,668,642,26,3.9
Sterling County,2012-Mar,693,667,26,3.8
Sterling County,2012-Apr,719,696,23,3.2
Sterling County,2012-May,722,697,25,3.5
Sterling County,2012-Jun,743,715,28,3.8
Sterling County,2012-Jul,762,734,28,3.7
Sterling County,2012-Aug,740,716,24,3.2
Sterling County,2012-Sep,745,721,24,3.2
Sterling County,2012-Oct,733,710,23,3.1
Sterling County,2012-Nov,718,695,23,3.2
Sterling County,2012-Dec,710,685,25,3.5
Sterling County,2013-Jan,709,676,33,4.7
Sterling County,2013-Feb,704,674,30,4.3
Sterling County,2013-Mar,707,678,29,4.1
Sterling County,2013-Apr,709,678,31,4.4
Sterling County,2013-May,741,713,28,3.8
Sterling County,2013-Jun,786,751,35,4.5
Sterling County,2013-Jul,806,777,29,3.6
Sterling County,2013-Aug,773,745,28,3.6
Sterling County,2013-Sep,780,752,28,3.6
Sterling County,2013-Oct,782,753,29,3.7
Sterling County,2013-Nov,743,718,25,3.4
Sterling County,2013-Dec,759,735,24,3.2
Sterling County,2014-Jan,774,746,28,3.6
Sterling County,2014-Feb,804,775,29,3.6
Sterling County,2014-Mar,812,784,28,3.4
Sterling County,2014-Apr,831,807,24,2.9
Sterling County,2014-May,856,833,23,2.7
Sterling County,2014-Jun,848,824,24,2.8
Sterling County,2014-Jul,827,802,25,3
Sterling County,2014-Aug,795,772,23,2.9
Sterling County,2014-Sep,814,791,23,2.8
Sterling County,2014-Oct,813,791,22,2.7
Sterling County,2014-Nov,784,762,22,2.8
Sterling County,2014-Dec,770,752,18,2.3
Sterling County,2015-Jan,740,716,24,3.2
Sterling County,2015-Feb,761,735,26,3.4
Sterling County,2015-Mar,785,758,27,3.4
Sterling County,2015-Apr,773,742,31,4
Sterling County,2015-May,784,752,32,4.1
Sterling County,2015-Jun,775,745,30,3.9
Sterling County,2015-Jul,746,722,24,3.2
Sterling County,2015-Aug,727,706,21,2.9
Sterling County,2015-Sep,751,727,24,3.2
Sterling County,2015-Oct,728,706,22,3
Sterling County,2015-Nov,695,671,24,3.5
Sterling County,2015-Dec,697,676,21,3
Sterling County,2016-Jan,659,638,21,3.2
Sterling County,2016-Feb,712,684,28,3.9
Sterling County,2016-Mar,722,700,22,3
Sterling County,2016-Apr,709,686,23,3.2
Sterling County,2016-May,717,695,22,3.1
Sterling County,2016-Jun,691,668,23,3.3
Sterling County,2016-Jul,643,618,25,3.9
Sterling County,2016-Aug,660,634,26,3.9
Sterling County,2016-Sep,634,603,31,4.9
Sterling County,2016-Oct,635,606,29,4.6
Sterling County,2016-Nov,635,604,31,4.9
Sterling County,2016-Dec,623,590,33,5.3
Sterling County,2017-Jan,576,543,33,5.7
Sterling County,2017-Feb,597,565,32,5.4
Sterling County,2017-Mar,641,610,31,4.8
Sterling County,2017-Apr,615,596,19,3.1
Sterling County,2017-May,620,599,21,3.4
Sterling County,2017-Jun,612,593,19,3.1
Sterling County,2017-Jul,564,547,17,3
Sterling County,2017-Aug,582,565,17,2.9
Sterling County,2017-Sep,556,540,16,2.9
Sterling County,2017-Oct,579,562,17,2.9
Sterling County,2017-Nov,561,540,21,3.7
Sterling County,2017-Dec,560,543,17,3
Sterling County,2018-Jan,573,552,21,3.7
Sterling County,2018-Feb,576,556,20,3.5
Sterling County,2018-Mar,607,589,18,3
Sterling County,2018-Apr,578,560,18,3.1
Sterling County,2018-May,598,581,17,2.8
Sterling County,2018-Jun,596,575,21,3.5
Sterling County,2018-Jul,566,546,20,3.5
Sterling County,2018-Aug,588,566,22,3.7
Sterling County,2018-Sep,577,558,19,3.3
Sterling County,2018-Oct,567,549,18,3.2
Sterling County,2018-Nov,559,538,21,3.8
Sterling County,2018-Dec,527,508,19,3.6
Sterling County,2019-Jan,521,501,20,3.8
Sterling County,2019-Feb,558,539,19,3.4
Sterling County,2019-Mar,575,559,16,2.8
Sterling County,2019-Apr,565,547,18,3.2
Sterling County,2019-May,580,565,15,2.6
Sterling County,2019-Jun,581,562,19,3.3
Sterling County,2019-Jul,562,544,18,3.2
Sterling County,2019-Aug,606,587,19,3.1
Sterling County,2019-Sep,566,549,17,3
Sterling County,2019-Oct,585,568,17,2.9
Sterling County,2019-Nov,550,533,17,3.1
Sterling County,2019-Dec,561,545,16,2.9
Sterling County,2020-Jan,555,535,20,3.6
Sterling County,2020-Feb,561,543,18,3.2
Sterling County,2020-Mar,570,542,28,4.9
Sterling County,2020-Apr,530,493,37,7
Sterling County,2020-May,539,497,42,7.8
Sterling County,2020-Jun,560,509,51,9.1
Sterling County,2020-Jul,558,509,49,8.8
Sterling County,2020-Aug,571,534,37,6.5
Sterling County,2020-Sep,553,515,38,6.9
Sterling County,2020-Oct,561,527,34,6.1
Sterling County,2020-Nov,549,514,35,6.4
Sterling County,2020-Dec,549,508,41,7.5
Sterling County,2021-Jan,640,599,41,6.4
Sterling County,2021-Feb,655,618,37,5.6
Sterling County,2021-Mar,688,655,33,4.8
Sterling County,2021-Apr,627,594,33,5.3
Sterling County,2021-May,615,586,29,4.7
Sterling County,2021-Jun,585,554,31,5.3
Sterling County,2021-Jul,556,527,29,5.2
Sterling County,2021-Aug,555,529,26,4.7
Sterling County,2021-Sep,551,524,27,4.9
Sterling County,2021-Oct,539,510,29,5.4
Sterling County,2021-Nov,517,492,25,4.8
Sterling County,2021-Dec,510,487,23,4.5
Sterling County,2022-Jan,536,512,24,4.5
Sterling County,2022-Feb,600,574,26,4.3
Sterling County,2022-Mar,638,615,23,3.6
Sterling County,2022-Apr,611,591,20,3.3
Sterling County,2022-May,595,574,21,3.5
Sterling County,2022-Jun,571,551,20,3.5
Sterling County,2022-Jul,605(P),588(P),17(P),2.8(P)
Stonewall County,2012-Jan,733,697,36,4.9
Stonewall County,2012-Feb,722,689,33,4.6
Stonewall County,2012-Mar,728,695,33,4.5
Stonewall County,2012-Apr,736,706,30,4.1
Stonewall County,2012-May,738,707,31,4.2
Stonewall County,2012-Jun,774,739,35,4.5
Stonewall County,2012-Jul,780,743,37,4.7
Stonewall County,2012-Aug,775,740,35,4.5
Stonewall County,2012-Sep,759,726,33,4.3
Stonewall County,2012-Oct,731,700,31,4.2
Stonewall County,2012-Nov,734,708,26,3.5
Stonewall County,2012-Dec,743,716,27,3.6
Stonewall County,2013-Jan,696,666,30,4.3
Stonewall County,2013-Feb,700,668,32,4.6
Stonewall County,2013-Mar,684,651,33,4.8
Stonewall County,2013-Apr,722,688,34,4.7
Stonewall County,2013-May,734,699,35,4.8
Stonewall County,2013-Jun,739,701,38,5.1
Stonewall County,2013-Jul,741,703,38,5.1
Stonewall County,2013-Aug,725,692,33,4.6
Stonewall County,2013-Sep,702,666,36,5.1
Stonewall County,2013-Oct,686,652,34,5
Stonewall County,2013-Nov,662,631,31,4.7
Stonewall County,2013-Dec,683,655,28,4.1
Stonewall County,2014-Jan,662,633,29,4.4
Stonewall County,2014-Feb,692,660,32,4.6
Stonewall County,2014-Mar,698,668,30,4.3
Stonewall County,2014-Apr,711,687,24,3.4
Stonewall County,2014-May,719,692,27,3.8
Stonewall County,2014-Jun,725,699,26,3.6
Stonewall County,2014-Jul,720,693,27,3.8
Stonewall County,2014-Aug,700,672,28,4
Stonewall County,2014-Sep,699,673,26,3.7
Stonewall County,2014-Oct,686,660,26,3.8
Stonewall County,2014-Nov,670,646,24,3.6
Stonewall County,2014-Dec,666,641,25,3.8
Stonewall County,2015-Jan,657,627,30,4.6
Stonewall County,2015-Feb,654,625,29,4.4
Stonewall County,2015-Mar,668,633,35,5.2
Stonewall County,2015-Apr,670,639,31,4.6
Stonewall County,2015-May,697,667,30,4.3
Stonewall County,2015-Jun,701,675,26,3.7
Stonewall County,2015-Jul,687,660,27,3.9
Stonewall County,2015-Aug,670,646,24,3.6
Stonewall County,2015-Sep,657,629,28,4.3
Stonewall County,2015-Oct,648,616,32,4.9
Stonewall County,2015-Nov,623,593,30,4.8
Stonewall County,2015-Dec,620,593,27,4.4
Stonewall County,2016-Jan,605,575,30,5
Stonewall County,2016-Feb,633,604,29,4.6
Stonewall County,2016-Mar,643,613,30,4.7
Stonewall County,2016-Apr,649,624,25,3.9
Stonewall County,2016-May,670,645,25,3.7
Stonewall County,2016-Jun,665,637,28,4.2
Stonewall County,2016-Jul,659,630,29,4.4
Stonewall County,2016-Aug,666,636,30,4.5
Stonewall County,2016-Sep,641,609,32,5
Stonewall County,2016-Oct,622,594,28,4.5
Stonewall County,2016-Nov,613,588,25,4.1
Stonewall County,2016-Dec,616,592,24,3.9
Stonewall County,2017-Jan,604,578,26,4.3
Stonewall County,2017-Feb,613,591,22,3.6
Stonewall County,2017-Mar,622,601,21,3.4
Stonewall County,2017-Apr,611,592,19,3.1
Stonewall County,2017-May,631,608,23,3.6
Stonewall County,2017-Jun,632,610,22,3.5
Stonewall County,2017-Jul,621,596,25,4
Stonewall County,2017-Aug,630,607,23,3.7
Stonewall County,2017-Sep,606,585,21,3.5
Stonewall County,2017-Oct,586,568,18,3.1
Stonewall County,2017-Nov,572,553,19,3.3
Stonewall County,2017-Dec,584,565,19,3.3
Stonewall County,2018-Jan,565,544,21,3.7
Stonewall County,2018-Feb,570,548,22,3.9
Stonewall County,2018-Mar,600,581,19,3.2
Stonewall County,2018-Apr,575,557,18,3.1
Stonewall County,2018-May,595,579,16,2.7
Stonewall County,2018-Jun,604,581,23,3.8
Stonewall County,2018-Jul,609,587,22,3.6
Stonewall County,2018-Aug,612,589,23,3.8
Stonewall County,2018-Sep,594,573,21,3.5
Stonewall County,2018-Oct,576,556,20,3.5
Stonewall County,2018-Nov,559,541,18,3.2
Stonewall County,2018-Dec,553,536,17,3.1
Stonewall County,2019-Jan,549,529,20,3.6
Stonewall County,2019-Feb,561,542,19,3.4
Stonewall County,2019-Mar,564,548,16,2.8
Stonewall County,2019-Apr,569,555,14,2.5
Stonewall County,2019-May,590,576,14,2.4
Stonewall County,2019-Jun,603,586,17,2.8
Stonewall County,2019-Jul,604,585,19,3.1
Stonewall County,2019-Aug,613,594,19,3.1
Stonewall County,2019-Sep,584,567,17,2.9
Stonewall County,2019-Oct,569,554,15,2.6
Stonewall County,2019-Nov,551,535,16,2.9
Stonewall County,2019-Dec,560,544,16,2.9
Stonewall County,2020-Jan,557,540,17,3.1
Stonewall County,2020-Feb,557,539,18,3.2
Stonewall County,2020-Mar,552,526,26,4.7
Stonewall County,2020-Apr,523,499,24,4.6
Stonewall County,2020-May,558,521,37,6.6
Stonewall County,2020-Jun,572,533,39,6.8
Stonewall County,2020-Jul,596,560,36,6
Stonewall County,2020-Aug,606,576,30,5
Stonewall County,2020-Sep,584,553,31,5.3
Stonewall County,2020-Oct,576,548,28,4.9
Stonewall County,2020-Nov,560,530,30,5.4
Stonewall County,2020-Dec,571,538,33,5.8
Stonewall County,2021-Jan,582,548,34,5.8
Stonewall County,2021-Feb,588,555,33,5.6
Stonewall County,2021-Mar,601,573,28,4.7
Stonewall County,2021-Apr,592,569,23,3.9
Stonewall County,2021-May,589,568,21,3.6
Stonewall County,2021-Jun,593,568,25,4.2
Stonewall County,2021-Jul,597,572,25,4.2
Stonewall County,2021-Aug,607,585,22,3.6
Stonewall County,2021-Sep,597,577,20,3.4
Stonewall County,2021-Oct,574,554,20,3.5
Stonewall County,2021-Nov,562,540,22,3.9
Stonewall County,2021-Dec,565,546,19,3.4
Stonewall County,2022-Jan,563,543,20,3.6
Stonewall County,2022-Feb,588,565,23,3.9
Stonewall County,2022-Mar,610,590,20,3.3
Stonewall County,2022-Apr,599,583,16,2.7
Stonewall County,2022-May,600,583,17,2.8
Stonewall County,2022-Jun,604,585,19,3.1
Stonewall County,2022-Jul,628(P),610(P),18(P),2.9(P)
Sutton County,2012-Jan,1940,1834,106,5.5
Sutton County,2012-Feb,1954,1851,103,5.3
Sutton County,2012-Mar,1942,1848,94,4.8
Sutton County,2012-Apr,1987,1897,90,4.5
Sutton County,2012-May,1991,1893,98,4.9
Sutton County,2012-Jun,2020,1913,107,5.3
Sutton County,2012-Jul,2042,1935,107,5.2
Sutton County,2012-Aug,2064,1964,100,4.8
Sutton County,2012-Sep,2059,1970,89,4.3
Sutton County,2012-Oct,2045,1960,85,4.2
Sutton County,2012-Nov,2029,1940,89,4.4
Sutton County,2012-Dec,2041,1948,93,4.6
Sutton County,2013-Jan,2060,1956,104,5
Sutton County,2013-Feb,2068,1968,100,4.8
Sutton County,2013-Mar,2047,1950,97,4.7
Sutton County,2013-Apr,2069,1973,96,4.6
Sutton County,2013-May,2068,1970,98,4.7
Sutton County,2013-Jun,2084,1978,106,5.1
Sutton County,2013-Jul,2090,1986,104,5
Sutton County,2013-Aug,2077,1986,91,4.4
Sutton County,2013-Sep,2065,1971,94,4.6
Sutton County,2013-Oct,2036,1948,88,4.3
Sutton County,2013-Nov,2032,1949,83,4.1
Sutton County,2013-Dec,2038,1959,79,3.9
Sutton County,2014-Jan,2043,1959,84,4.1
Sutton County,2014-Feb,2024,1940,84,4.2
Sutton County,2014-Mar,2053,1976,77,3.8
Sutton County,2014-Apr,2060,1993,67,3.3
Sutton County,2014-May,2052,1980,72,3.5
Sutton County,2014-Jun,2064,1988,76,3.7
Sutton County,2014-Jul,2087,2010,77,3.7
Sutton County,2014-Aug,2028,1953,75,3.7
Sutton County,2014-Sep,1998,1929,69,3.5
Sutton County,2014-Oct,1978,1913,65,3.3
Sutton County,2014-Nov,1958,1893,65,3.3
Sutton County,2014-Dec,1870,1811,59,3.2
Sutton County,2015-Jan,1835,1756,79,4.3
Sutton County,2015-Feb,1812,1721,91,5
Sutton County,2015-Mar,1797,1708,89,5
Sutton County,2015-Apr,1743,1661,82,4.7
Sutton County,2015-May,1726,1633,93,5.4
Sutton County,2015-Jun,1734,1629,105,6.1
Sutton County,2015-Jul,1726,1616,110,6.4
Sutton County,2015-Aug,1706,1588,118,6.9
Sutton County,2015-Sep,1699,1579,120,7.1
Sutton County,2015-Oct,1643,1514,129,7.9
Sutton County,2015-Nov,1624,1498,126,7.8
Sutton County,2015-Dec,1589,1475,114,7.2
Sutton County,2016-Jan,1630,1499,131,8
Sutton County,2016-Feb,1637,1502,135,8.2
Sutton County,2016-Mar,1642,1497,145,8.8
Sutton County,2016-Apr,1630,1487,143,8.8
Sutton County,2016-May,1611,1476,135,8.4
Sutton County,2016-Jun,1607,1464,143,8.9
Sutton County,2016-Jul,1607,1473,134,8.3
Sutton County,2016-Aug,1599,1472,127,7.9
Sutton County,2016-Sep,1566,1440,126,8
Sutton County,2016-Oct,1538,1428,110,7.2
Sutton County,2016-Nov,1533,1434,99,6.5
Sutton County,2016-Dec,1504,1409,95,6.3
Sutton County,2017-Jan,1471,1370,101,6.9
Sutton County,2017-Feb,1487,1385,102,6.9
Sutton County,2017-Mar,1505,1413,92,6.1
Sutton County,2017-Apr,1500,1418,82,5.5
Sutton County,2017-May,1505,1430,75,5
Sutton County,2017-Jun,1509,1426,83,5.5
Sutton County,2017-Jul,1528,1456,72,4.7
Sutton County,2017-Aug,1515,1447,68,4.5
Sutton County,2017-Sep,1501,1439,62,4.1
Sutton County,2017-Oct,1486,1428,58,3.9
Sutton County,2017-Nov,1473,1411,62,4.2
Sutton County,2017-Dec,1472,1408,64,4.3
Sutton County,2018-Jan,1448,1382,66,4.6
Sutton County,2018-Feb,1432,1366,66,4.6
Sutton County,2018-Mar,1448,1388,60,4.1
Sutton County,2018-Apr,1437,1382,55,3.8
Sutton County,2018-May,1439,1390,49,3.4
Sutton County,2018-Jun,1456,1396,60,4.1
Sutton County,2018-Jul,1473,1415,58,3.9
Sutton County,2018-Aug,1459,1403,56,3.8
Sutton County,2018-Sep,1467,1412,55,3.7
Sutton County,2018-Oct,1414,1366,48,3.4
Sutton County,2018-Nov,1431,1381,50,3.5
Sutton County,2018-Dec,1424,1374,50,3.5
Sutton County,2019-Jan,1485,1428,57,3.8
Sutton County,2019-Feb,1498,1444,54,3.6
Sutton County,2019-Mar,1499,1448,51,3.4
Sutton County,2019-Apr,1490,1443,47,3.2
Sutton County,2019-May,1497,1451,46,3.1
Sutton County,2019-Jun,1514,1459,55,3.6
Sutton County,2019-Jul,1324,1270,54,4.1
Sutton County,2019-Aug,1342,1287,55,4.1
Sutton County,2019-Sep,1315,1263,52,4
Sutton County,2019-Oct,1280,1228,52,4.1
Sutton County,2019-Nov,1276,1221,55,4.3
Sutton County,2019-Dec,1282,1231,51,4
Sutton County,2020-Jan,1227,1169,58,4.7
Sutton County,2020-Feb,1234,1184,50,4.1
Sutton County,2020-Mar,1229,1152,77,6.3
Sutton County,2020-Apr,1180,1047,133,11.3
Sutton County,2020-May,1228,1064,164,13.4
Sutton County,2020-Jun,1221,1059,162,13.3
Sutton County,2020-Jul,1223,1080,143,11.7
Sutton County,2020-Aug,1234,1112,122,9.9
Sutton County,2020-Sep,1217,1089,128,10.5
Sutton County,2020-Oct,1170,1049,121,10.3
Sutton County,2020-Nov,1139,1005,134,11.8
Sutton County,2020-Dec,1145,1014,131,11.4
Sutton County,2021-Jan,1161,1041,120,10.3
Sutton County,2021-Feb,1162,1050,112,9.6
Sutton County,2021-Mar,1182,1073,109,9.2
Sutton County,2021-Apr,1168,1073,95,8.1
Sutton County,2021-May,1164,1072,92,7.9
Sutton County,2021-Jun,1182,1071,111,9.4
Sutton County,2021-Jul,1191,1089,102,8.6
Sutton County,2021-Aug,1185,1088,97,8.2
Sutton County,2021-Sep,1154,1070,84,7.3
Sutton County,2021-Oct,1100,1020,80,7.3
Sutton County,2021-Nov,1073,998,75,7
Sutton County,2021-Dec,1076,1008,68,6.3
Sutton County,2022-Jan,1085,1006,79,7.3
Sutton County,2022-Feb,1111,1033,78,7
Sutton County,2022-Mar,1131,1066,65,5.7
Sutton County,2022-Apr,1111,1047,64,5.8
Sutton County,2022-May,1106,1045,61,5.5
Sutton County,2022-Jun,1114,1044,70,6.3
Sutton County,2022-Jul,1138(P),1072(P),66(P),5.8(P)
Swisher County,2012-Jan,3043,2854,189,6.2
Swisher County,2012-Feb,3022,2842,180,6
Swisher County,2012-Mar,3038,2866,172,5.7
Swisher County,2012-Apr,3090,2918,172,5.6
Swisher County,2012-May,3089,2903,186,6
Swisher County,2012-Jun,3157,2945,212,6.7
Swisher County,2012-Jul,3077,2870,207,6.7
Swisher County,2012-Aug,3030,2846,184,6.1
Swisher County,2012-Sep,3046,2878,168,5.5
Swisher County,2012-Oct,2996,2834,162,5.4
Swisher County,2012-Nov,2981,2826,155,5.2
Swisher County,2012-Dec,2946,2779,167,5.7
Swisher County,2013-Jan,2884,2682,202,7
Swisher County,2013-Feb,2947,2693,254,8.6
Swisher County,2013-Mar,2929,2683,246,8.4
Swisher County,2013-Apr,2982,2712,270,9.1
Swisher County,2013-May,3003,2739,264,8.8
Swisher County,2013-Jun,3046,2754,292,9.6
Swisher County,2013-Jul,3022,2740,282,9.3
Swisher County,2013-Aug,2960,2692,268,9.1
Swisher County,2013-Sep,2982,2718,264,8.9
Swisher County,2013-Oct,2956,2711,245,8.3
Swisher County,2013-Nov,2891,2663,228,7.9
Swisher County,2013-Dec,2899,2694,205,7.1
Swisher County,2014-Jan,2859,2644,215,7.5
Swisher County,2014-Feb,2924,2702,222,7.6
Swisher County,2014-Mar,2911,2709,202,6.9
Swisher County,2014-Apr,2915,2743,172,5.9
Swisher County,2014-May,2920,2737,183,6.3
Swisher County,2014-Jun,2922,2734,188,6.4
Swisher County,2014-Jul,2892,2703,189,6.5
Swisher County,2014-Aug,2831,2653,178,6.3
Swisher County,2014-Sep,2897,2731,166,5.7
Swisher County,2014-Oct,2869,2717,152,5.3
Swisher County,2014-Nov,2822,2674,148,5.2
Swisher County,2014-Dec,2764,2637,127,4.6
Swisher County,2015-Jan,2693,2545,148,5.5
Swisher County,2015-Feb,2717,2577,140,5.2
Swisher County,2015-Mar,2750,2615,135,4.9
Swisher County,2015-Apr,2783,2665,118,4.2
Swisher County,2015-May,2829,2697,132,4.7
Swisher County,2015-Jun,2822,2677,145,5.1
Swisher County,2015-Jul,2750,2608,142,5.2
Swisher County,2015-Aug,2712,2586,126,4.6
Swisher County,2015-Sep,2711,2582,129,4.8
Swisher County,2015-Oct,2697,2573,124,4.6
Swisher County,2015-Nov,2665,2544,121,4.5
Swisher County,2015-Dec,2671,2560,111,4.2
Swisher County,2016-Jan,2578,2461,117,4.5
Swisher County,2016-Feb,2703,2583,120,4.4
Swisher County,2016-Mar,2736,2618,118,4.3
Swisher County,2016-Apr,2781,2668,113,4.1
Swisher County,2016-May,2798,2692,106,3.8
Swisher County,2016-Jun,2790,2665,125,4.5
Swisher County,2016-Jul,2669,2544,125,4.7
Swisher County,2016-Aug,2727,2603,124,4.5
Swisher County,2016-Sep,2714,2591,123,4.5
Swisher County,2016-Oct,2721,2611,110,4
Swisher County,2016-Nov,2699,2593,106,3.9
Swisher County,2016-Dec,2677,2575,102,3.8
Swisher County,2017-Jan,2650,2536,114,4.3
Swisher County,2017-Feb,2708,2578,130,4.8
Swisher County,2017-Mar,2769,2643,126,4.6
Swisher County,2017-Apr,2721,2610,111,4.1
Swisher County,2017-May,2726,2615,111,4.1
Swisher County,2017-Jun,2708,2592,116,4.3
Swisher County,2017-Jul,2628,2519,109,4.1
Swisher County,2017-Aug,2656,2549,107,4
Swisher County,2017-Sep,2612,2506,106,4.1
Swisher County,2017-Oct,2640,2541,99,3.8
Swisher County,2017-Nov,2608,2506,102,3.9
Swisher County,2017-Dec,2627,2534,93,3.5
Swisher County,2018-Jan,2605,2497,108,4.1
Swisher County,2018-Feb,2633,2523,110,4.2
Swisher County,2018-Mar,2717,2602,115,4.2
Swisher County,2018-Apr,2663,2548,115,4.3
Swisher County,2018-May,2667,2558,109,4.1
Swisher County,2018-Jun,2660,2533,127,4.8
Swisher County,2018-Jul,2588,2466,122,4.7
Swisher County,2018-Aug,2654,2527,127,4.8
Swisher County,2018-Sep,2635,2514,121,4.6
Swisher County,2018-Oct,2582,2483,99,3.8
Swisher County,2018-Nov,2569,2463,106,4.1
Swisher County,2018-Dec,2553,2452,101,4
Swisher County,2019-Jan,2563,2448,115,4.5
Swisher County,2019-Feb,2615,2509,106,4.1
Swisher County,2019-Mar,2630,2528,102,3.9
Swisher County,2019-Apr,2586,2503,83,3.2
Swisher County,2019-May,2604,2521,83,3.2
Swisher County,2019-Jun,2595,2496,99,3.8
Swisher County,2019-Jul,2578,2479,99,3.8
Swisher County,2019-Aug,2639,2538,101,3.8
Swisher County,2019-Sep,2568,2479,89,3.5
Swisher County,2019-Oct,2579,2490,89,3.5
Swisher County,2019-Nov,2519,2431,88,3.5
Swisher County,2019-Dec,2522,2441,81,3.2
Swisher County,2020-Jan,2516,2424,92,3.7
Swisher County,2020-Feb,2531,2439,92,3.6
Swisher County,2020-Mar,2508,2377,131,5.2
Swisher County,2020-Apr,2381,2228,153,6.4
Swisher County,2020-May,2433,2269,164,6.7
Swisher County,2020-Jun,2460,2305,155,6.3
Swisher County,2020-Jul,2485,2336,149,6
Swisher County,2020-Aug,2536,2409,127,5
Swisher County,2020-Sep,2526,2401,125,4.9
Swisher County,2020-Oct,2564,2449,115,4.5
Swisher County,2020-Nov,2518,2395,123,4.9
Swisher County,2020-Dec,2524,2393,131,5.2
Swisher County,2021-Jan,2559,2403,156,6.1
Swisher County,2021-Feb,2611,2466,145,5.6
Swisher County,2021-Mar,2649,2505,144,5.4
Swisher County,2021-Apr,2630,2502,128,4.9
Swisher County,2021-May,2590,2462,128,4.9
Swisher County,2021-Jun,2601,2447,154,5.9
Swisher County,2021-Jul,2595,2471,124,4.8
Swisher County,2021-Aug,2635,2505,130,4.9
Swisher County,2021-Sep,2614,2492,122,4.7
Swisher County,2021-Oct,2581,2469,112,4.3
Swisher County,2021-Nov,2538,2431,107,4.2
Swisher County,2021-Dec,2514,2427,87,3.5
Swisher County,2022-Jan,2518,2414,104,4.1
Swisher County,2022-Feb,2625,2520,105,4
Swisher County,2022-Mar,2683,2595,88,3.3
Swisher County,2022-Apr,2651,2573,78,2.9
Swisher County,2022-May,2607,2520,87,3.3
Swisher County,2022-Jun,2610,2503,107,4.1
Swisher County,2022-Jul,2674(P),2574(P),100(P),3.7(P)
Tarrant County,2012-Jan,951529,884731,66798,7
Tarrant County,2012-Feb,958227,892016,66211,6.9
Tarrant County,2012-Mar,957969,895554,62415,6.5
Tarrant County,2012-Apr,957886,899457,58429,6.1
Tarrant County,2012-May,963716,901818,61898,6.4
Tarrant County,2012-Jun,969409,901519,67890,7
Tarrant County,2012-Jul,968411,900658,67753,7
Tarrant County,2012-Aug,965654,900824,64830,6.7
Tarrant County,2012-Sep,965754,906133,59621,6.2
Tarrant County,2012-Oct,968134,909699,58435,6
Tarrant County,2012-Nov,968723,912179,56544,5.8
Tarrant County,2012-Dec,971141,913449,57692,5.9
Tarrant County,2013-Jan,971314,903795,67519,7
Tarrant County,2013-Feb,972078,909948,62130,6.4
Tarrant County,2013-Mar,972436,912451,59985,6.2
Tarrant County,2013-Apr,975696,918908,56788,5.8
Tarrant County,2013-May,981670,921983,59687,6.1
Tarrant County,2013-Jun,985645,920401,65244,6.6
Tarrant County,2013-Jul,984627,921624,63003,6.4
Tarrant County,2013-Aug,983131,923034,60097,6.1
Tarrant County,2013-Sep,985169,926209,58960,6
Tarrant County,2013-Oct,976904,919805,57099,5.8
Tarrant County,2013-Nov,984117,929424,54693,5.6
Tarrant County,2013-Dec,981907,930570,51337,5.2
Tarrant County,2014-Jan,977784,921907,55877,5.7
Tarrant County,2014-Feb,983154,927776,55378,5.6
Tarrant County,2014-Mar,987408,933949,53459,5.4
Tarrant County,2014-Apr,985796,938651,47145,4.8
Tarrant County,2014-May,989730,939724,50006,5.1
Tarrant County,2014-Jun,994037,940519,53518,5.4
Tarrant County,2014-Jul,994447,939602,54845,5.5
Tarrant County,2014-Aug,992777,939157,53620,5.4
Tarrant County,2014-Sep,990970,941887,49083,5
Tarrant County,2014-Oct,992284,946212,46072,4.6
Tarrant County,2014-Nov,994443,948951,45492,4.6
Tarrant County,2014-Dec,992112,950970,41142,4.1
Tarrant County,2015-Jan,986683,940598,46085,4.7
Tarrant County,2015-Feb,986099,942816,43283,4.4
Tarrant County,2015-Mar,982586,940802,41784,4.3
Tarrant County,2015-Apr,987950,949742,38208,3.9
Tarrant County,2015-May,992451,952149,40302,4.1
Tarrant County,2015-Jun,992861,948992,43869,4.4
Tarrant County,2015-Jul,994322,949961,44361,4.5
Tarrant County,2015-Aug,994107,951932,42175,4.2
Tarrant County,2015-Sep,991746,950338,41408,4.2
Tarrant County,2015-Oct,994010,953658,40352,4.1
Tarrant County,2015-Nov,999198,959169,40029,4
Tarrant County,2015-Dec,1000727,963396,37331,3.7
Tarrant County,2016-Jan,995307,955613,39694,4
Tarrant County,2016-Feb,1003064,963587,39477,3.9
Tarrant County,2016-Mar,1004229,964455,39774,4
Tarrant County,2016-Apr,1006410,968969,37441,3.7
Tarrant County,2016-May,1006122,969176,36946,3.7
Tarrant County,2016-Jun,1011180,968003,43177,4.3
Tarrant County,2016-Jul,1017116,972946,44170,4.3
Tarrant County,2016-Aug,1015984,973029,42955,4.2
Tarrant County,2016-Sep,1019132,976602,42530,4.2
Tarrant County,2016-Oct,1015973,976027,39946,3.9
Tarrant County,2016-Nov,1022665,983754,38911,3.8
Tarrant County,2016-Dec,1021337,982291,39046,3.8
Tarrant County,2017-Jan,1013408,970687,42721,4.2
Tarrant County,2017-Feb,1019138,975651,43487,4.3
Tarrant County,2017-Mar,1020725,979536,41189,4
Tarrant County,2017-Apr,1022703,985985,36718,3.6
Tarrant County,2017-May,1019983,982977,37006,3.6
Tarrant County,2017-Jun,1026823,986104,40719,4
Tarrant County,2017-Jul,1034219,993517,40702,3.9
Tarrant County,2017-Aug,1034328,993467,40861,4
Tarrant County,2017-Sep,1039371,1002939,36432,3.5
Tarrant County,2017-Oct,1033234,999548,33686,3.3
Tarrant County,2017-Nov,1041112,1005748,35364,3.4
Tarrant County,2017-Dec,1038010,1003707,34303,3.3
Tarrant County,2018-Jan,1034432,995650,38782,3.7
Tarrant County,2018-Feb,1044935,1005926,39009,3.7
Tarrant County,2018-Mar,1041894,1003726,38168,3.7
Tarrant County,2018-Apr,1045081,1010270,34811,3.3
Tarrant County,2018-May,1044948,1010393,34555,3.3
Tarrant County,2018-Jun,1052845,1011935,40910,3.9
Tarrant County,2018-Jul,1055333,1015632,39701,3.8
Tarrant County,2018-Aug,1048813,1010528,38285,3.7
Tarrant County,2018-Sep,1052099,1015493,36606,3.5
Tarrant County,2018-Oct,1056272,1021374,34898,3.3
Tarrant County,2018-Nov,1059292,1024595,34697,3.3
Tarrant County,2018-Dec,1060627,1025520,35107,3.3
Tarrant County,2019-Jan,1058119,1014129,43990,4.2
Tarrant County,2019-Feb,1059187,1021951,37236,3.5
Tarrant County,2019-Mar,1056987,1021550,35437,3.4
Tarrant County,2019-Apr,1053516,1022937,30579,2.9
Tarrant County,2019-May,1054497,1023319,31178,3
Tarrant County,2019-Jun,1063970,1026126,37844,3.6
Tarrant County,2019-Jul,1069814,1031064,38750,3.6
Tarrant County,2019-Aug,1067694,1030784,36910,3.5
Tarrant County,2019-Sep,1073190,1038597,34593,3.2
Tarrant County,2019-Oct,1078786,1043777,35009,3.2
Tarrant County,2019-Nov,1084734,1051428,33306,3.1
Tarrant County,2019-Dec,1082130,1051245,30885,2.9
Tarrant County,2020-Jan,1074091,1039039,35052,3.3
Tarrant County,2020-Feb,1079821,1046438,33383,3.1
Tarrant County,2020-Mar,1062535,1009505,53030,5
Tarrant County,2020-Apr,1012343,885935,126408,12.5
Tarrant County,2020-May,1048804,921617,127187,12.1
Tarrant County,2020-Jun,1066754,955229,111525,10.5
Tarrant County,2020-Jul,1071284,971177,100107,9.3
Tarrant County,2020-Aug,1073603,992695,80908,7.5
Tarrant County,2020-Sep,1075045,998487,76558,7.1
Tarrant County,2020-Oct,1089043,1021785,67258,6.2
Tarrant County,2020-Nov,1093569,1024309,69260,6.3
Tarrant County,2020-Dec,1094546,1026131,68415,6.3
Tarrant County,2021-Jan,1086906,1015509,71397,6.6
Tarrant County,2021-Feb,1091277,1020458,70819,6.5
Tarrant County,2021-Mar,1093017,1024992,68025,6.2
Tarrant County,2021-Apr,1091349,1030047,61302,5.6
Tarrant County,2021-May,1089653,1031419,58234,5.3
Tarrant County,2021-Jun,1098689,1033125,65564,6
Tarrant County,2021-Jul,1100113,1040326,59787,5.4
Tarrant County,2021-Aug,1099859,1043858,56001,5.1
Tarrant County,2021-Sep,1101189,1049589,51600,4.7
Tarrant County,2021-Oct,1107981,1058990,48991,4.4
Tarrant County,2021-Nov,1119995,1074207,45788,4.1
Tarrant County,2021-Dec,1118243,1076152,42091,3.8
Tarrant County,2022-Jan,1115230,1067295,47935,4.3
Tarrant County,2022-Feb,1127267,1079670,47597,4.2
Tarrant County,2022-Mar,1127870,1088862,39008,3.5
Tarrant County,2022-Apr,1123338,1086464,36874,3.3
Tarrant County,2022-May,1127250,1088582,38668,3.4
Tarrant County,2022-Jun,1130471,1085622,44849,4
Tarrant County,2022-Jul,1134956(P),1090473(P),44483(P),3.9(P)
Taylor County,2012-Jan,64354,60429,3925,6.1
Taylor County,2012-Feb,64697,60915,3782,5.8
Taylor County,2012-Mar,64578,61045,3533,5.5
Taylor County,2012-Apr,64345,60972,3373,5.2
Taylor County,2012-May,64243,60623,3620,5.6
Taylor County,2012-Jun,64204,60111,4093,6.4
Taylor County,2012-Jul,64476,60408,4068,6.3
Taylor County,2012-Aug,63851,60106,3745,5.9
Taylor County,2012-Sep,64112,60695,3417,5.3
Taylor County,2012-Oct,64547,61216,3331,5.2
Taylor County,2012-Nov,64389,61151,3238,5
Taylor County,2012-Dec,64179,60871,3308,5.2
Taylor County,2013-Jan,64283,60550,3733,5.8
Taylor County,2013-Feb,64483,60937,3546,5.5
Taylor County,2013-Mar,64183,60808,3375,5.3
Taylor County,2013-Apr,64763,61547,3216,5
Taylor County,2013-May,64817,61328,3489,5.4
Taylor County,2013-Jun,64707,60805,3902,6
Taylor County,2013-Jul,64529,60780,3749,5.8
Taylor County,2013-Aug,64000,60511,3489,5.5
Taylor County,2013-Sep,64485,61064,3421,5.3
Taylor County,2013-Oct,64566,61317,3249,5
Taylor County,2013-Nov,65069,61969,3100,4.8
Taylor County,2013-Dec,64473,61576,2897,4.5
Taylor County,2014-Jan,64242,61252,2990,4.7
Taylor County,2014-Feb,64536,61494,3042,4.7
Taylor County,2014-Mar,64459,61532,2927,4.5
Taylor County,2014-Apr,64731,62228,2503,3.9
Taylor County,2014-May,64807,62042,2765,4.3
Taylor County,2014-Jun,64588,61584,3004,4.7
Taylor County,2014-Jul,64561,61460,3101,4.8
Taylor County,2014-Aug,63934,61062,2872,4.5
Taylor County,2014-Sep,64078,61391,2687,4.2
Taylor County,2014-Oct,64066,61579,2487,3.9
Taylor County,2014-Nov,64126,61714,2412,3.8
Taylor County,2014-Dec,63657,61493,2164,3.4
Taylor County,2015-Jan,63485,61006,2479,3.9
Taylor County,2015-Feb,63611,61175,2436,3.8
Taylor County,2015-Mar,63206,60891,2315,3.7
Taylor County,2015-Apr,63729,61586,2143,3.4
Taylor County,2015-May,63833,61468,2365,3.7
Taylor County,2015-Jun,63547,60981,2566,4
Taylor County,2015-Jul,63231,60697,2534,4
Taylor County,2015-Aug,62979,60650,2329,3.7
Taylor County,2015-Sep,63115,60763,2352,3.7
Taylor County,2015-Oct,63082,60827,2255,3.6
Taylor County,2015-Nov,63520,61267,2253,3.5
Taylor County,2015-Dec,63148,61064,2084,3.3
Taylor County,2016-Jan,63184,60886,2298,3.6
Taylor County,2016-Feb,63729,61430,2299,3.6
Taylor County,2016-Mar,63489,61177,2312,3.6
Taylor County,2016-Apr,63106,60979,2127,3.4
Taylor County,2016-May,62823,60612,2211,3.5
Taylor County,2016-Jun,63124,60546,2578,4.1
Taylor County,2016-Jul,63293,60666,2627,4.2
Taylor County,2016-Aug,63201,60699,2502,4
Taylor County,2016-Sep,63632,61107,2525,4
Taylor County,2016-Oct,63406,61020,2386,3.8
Taylor County,2016-Nov,63585,61282,2303,3.6
Taylor County,2016-Dec,63290,60988,2302,3.6
Taylor County,2017-Jan,62856,60379,2477,3.9
Taylor County,2017-Feb,63669,61134,2535,4
Taylor County,2017-Mar,63719,61401,2318,3.6
Taylor County,2017-Apr,63805,61701,2104,3.3
Taylor County,2017-May,63669,61403,2266,3.6
Taylor County,2017-Jun,63609,61099,2510,3.9
Taylor County,2017-Jul,63533,61085,2448,3.9
Taylor County,2017-Aug,63757,61315,2442,3.8
Taylor County,2017-Sep,64354,62195,2159,3.4
Taylor County,2017-Oct,63847,61861,1986,3.1
Taylor County,2017-Nov,64075,62031,2044,3.2
Taylor County,2017-Dec,63894,61941,1953,3.1
Taylor County,2018-Jan,63685,61482,2203,3.5
Taylor County,2018-Feb,64590,62407,2183,3.4
Taylor County,2018-Mar,64535,62411,2124,3.3
Taylor County,2018-Apr,65117,63195,1922,3
Taylor County,2018-May,64993,63099,1894,2.9
Taylor County,2018-Jun,64904,62601,2303,3.5
Taylor County,2018-Jul,64840,62655,2185,3.4
Taylor County,2018-Aug,64141,62025,2116,3.3
Taylor County,2018-Sep,64652,62621,2031,3.1
Taylor County,2018-Oct,64956,63029,1927,3
Taylor County,2018-Nov,65070,63167,1903,2.9
Taylor County,2018-Dec,65008,63077,1931,3
Taylor County,2019-Jan,64745,62574,2171,3.4
Taylor County,2019-Feb,65414,63412,2002,3.1
Taylor County,2019-Mar,65504,63584,1920,2.9
Taylor County,2019-Apr,65500,63889,1611,2.5
Taylor County,2019-May,65403,63726,1677,2.6
Taylor County,2019-Jun,65616,63527,2089,3.2
Taylor County,2019-Jul,66067,63964,2103,3.2
Taylor County,2019-Aug,65985,63996,1989,3
Taylor County,2019-Sep,66728,64865,1863,2.8
Taylor County,2019-Oct,66964,65154,1810,2.7
Taylor County,2019-Nov,67187,65390,1797,2.7
Taylor County,2019-Dec,66829,65174,1655,2.5
Taylor County,2020-Jan,66601,64672,1929,2.9
Taylor County,2020-Feb,67003,65168,1835,2.7
Taylor County,2020-Mar,65608,62784,2824,4.3
Taylor County,2020-Apr,61208,56104,5104,8.3
Taylor County,2020-May,63310,58099,5211,8.2
Taylor County,2020-Jun,64439,59594,4845,7.5
Taylor County,2020-Jul,65360,60832,4528,6.9
Taylor County,2020-Aug,65870,62268,3602,5.5
Taylor County,2020-Sep,66165,62686,3479,5.3
Taylor County,2020-Oct,66788,63708,3080,4.6
Taylor County,2020-Nov,67232,63958,3274,4.9
Taylor County,2020-Dec,67199,63958,3241,4.8
Taylor County,2021-Jan,66949,63462,3487,5.2
Taylor County,2021-Feb,67132,63660,3472,5.2
Taylor County,2021-Mar,66939,63592,3347,5
Taylor County,2021-Apr,66966,64056,2910,4.3
Taylor County,2021-May,66765,63905,2860,4.3
Taylor County,2021-Jun,67171,63840,3331,5
Taylor County,2021-Jul,67117,64125,2992,4.5
Taylor County,2021-Aug,66608,63815,2793,4.2
Taylor County,2021-Sep,67324,64667,2657,3.9
Taylor County,2021-Oct,67551,64980,2571,3.8
Taylor County,2021-Nov,67900,65470,2430,3.6
Taylor County,2021-Dec,67556,65376,2180,3.2
Taylor County,2022-Jan,67624,65103,2521,3.7
Taylor County,2022-Feb,68137,65597,2540,3.7
Taylor County,2022-Mar,67967,65892,2075,3.1
Taylor County,2022-Apr,67243,65288,1955,2.9
Taylor County,2022-May,67151,65076,2075,3.1
Taylor County,2022-Jun,67313,64901,2412,3.6
Taylor County,2022-Jul,67505(P),65148(P),2357(P),3.5(P)
Terrell County,2012-Jan,496,468,28,5.6
Terrell County,2012-Feb,500,475,25,5
Terrell County,2012-Mar,513,489,24,4.7
Terrell County,2012-Apr,528,506,22,4.2
Terrell County,2012-May,556,534,22,4
Terrell County,2012-Jun,575,549,26,4.5
Terrell County,2012-Jul,574,546,28,4.9
Terrell County,2012-Aug,560,533,27,4.8
Terrell County,2012-Sep,578,552,26,4.5
Terrell County,2012-Oct,557,532,25,4.5
Terrell County,2012-Nov,566,543,23,4.1
Terrell County,2012-Dec,561,533,28,5
Terrell County,2013-Jan,522,493,29,5.6
Terrell County,2013-Feb,532,502,30,5.6
Terrell County,2013-Mar,521,493,28,5.4
Terrell County,2013-Apr,530,500,30,5.7
Terrell County,2013-May,529,503,26,4.9
Terrell County,2013-Jun,543,519,24,4.4
Terrell County,2013-Jul,556,534,22,4
Terrell County,2013-Aug,527,501,26,4.9
Terrell County,2013-Sep,535,511,24,4.5
Terrell County,2013-Oct,506,481,25,4.9
Terrell County,2013-Nov,494,470,24,4.9
Terrell County,2013-Dec,482,460,22,4.6
Terrell County,2014-Jan,495,469,26,5.3
Terrell County,2014-Feb,493,466,27,5.5
Terrell County,2014-Mar,467,440,27,5.8
Terrell County,2014-Apr,497,474,23,4.6
Terrell County,2014-May,487,465,22,4.5
Terrell County,2014-Jun,478,458,20,4.2
Terrell County,2014-Jul,487,467,20,4.1
Terrell County,2014-Aug,475,456,19,4
Terrell County,2014-Sep,468,448,20,4.3
Terrell County,2014-Oct,474,454,20,4.2
Terrell County,2014-Nov,467,448,19,4.1
Terrell County,2014-Dec,458,442,16,3.5
Terrell County,2015-Jan,434,419,15,3.5
Terrell County,2015-Feb,450,434,16,3.6
Terrell County,2015-Mar,461,442,19,4.1
Terrell County,2015-Apr,453,433,20,4.4
Terrell County,2015-May,461,438,23,5
Terrell County,2015-Jun,463,438,25,5.4
Terrell County,2015-Jul,436,411,25,5.7
Terrell County,2015-Aug,426,401,25,5.9
Terrell County,2015-Sep,420,395,25,6
Terrell County,2015-Oct,410,388,22,5.4
Terrell County,2015-Nov,403,383,20,5
Terrell County,2015-Dec,398,380,18,4.5
Terrell County,2016-Jan,399,380,19,4.8
Terrell County,2016-Feb,412,395,17,4.1
Terrell County,2016-Mar,412,397,15,3.6
Terrell County,2016-Apr,416,402,14,3.4
Terrell County,2016-May,416,403,13,3.1
Terrell County,2016-Jun,422,407,15,3.6
Terrell County,2016-Jul,420,404,16,3.8
Terrell County,2016-Aug,411,395,16,3.9
Terrell County,2016-Sep,414,396,18,4.3
Terrell County,2016-Oct,397,380,17,4.3
Terrell County,2016-Nov,390,372,18,4.6
Terrell County,2016-Dec,373,353,20,5.4
Terrell County,2017-Jan,371,345,26,7
Terrell County,2017-Feb,390,365,25,6.4
Terrell County,2017-Mar,402,378,24,6
Terrell County,2017-Apr,402,381,21,5.2
Terrell County,2017-May,401,382,19,4.7
Terrell County,2017-Jun,396,377,19,4.8
Terrell County,2017-Jul,388,370,18,4.6
Terrell County,2017-Aug,371,357,14,3.8
Terrell County,2017-Sep,377,363,14,3.7
Terrell County,2017-Oct,403,390,13,3.2
Terrell County,2017-Nov,400,385,15,3.8
Terrell County,2017-Dec,388,375,13,3.4
Terrell County,2018-Jan,367,354,13,3.5
Terrell County,2018-Feb,368,353,15,4.1
Terrell County,2018-Mar,384,369,15,3.9
Terrell County,2018-Apr,384,369,15,3.9
Terrell County,2018-May,386,373,13,3.4
Terrell County,2018-Jun,382,371,11,2.9
Terrell County,2018-Jul,379,367,12,3.2
Terrell County,2018-Aug,376,364,12,3.2
Terrell County,2018-Sep,372,360,12,3.2
Terrell County,2018-Oct,368,357,11,3
Terrell County,2018-Nov,362,351,11,3
Terrell County,2018-Dec,362,349,13,3.6
Terrell County,2019-Jan,357,342,15,4.2
Terrell County,2019-Feb,370,357,13,3.5
Terrell County,2019-Mar,371,358,13,3.5
Terrell County,2019-Apr,368,359,9,2.4
Terrell County,2019-May,387,377,10,2.6
Terrell County,2019-Jun,393,382,11,2.8
Terrell County,2019-Jul,362,350,12,3.3
Terrell County,2019-Aug,369,355,14,3.8
Terrell County,2019-Sep,367,351,16,4.4
Terrell County,2019-Oct,370,357,13,3.5
Terrell County,2019-Nov,376,363,13,3.5
Terrell County,2019-Dec,382,369,13,3.4
Terrell County,2020-Jan,380,369,11,2.9
Terrell County,2020-Feb,376,366,10,2.7
Terrell County,2020-Mar,373,354,19,5.1
Terrell County,2020-Apr,348,330,18,5.2
Terrell County,2020-May,356,336,20,5.6
Terrell County,2020-Jun,375,352,23,6.1
Terrell County,2020-Jul,393,370,23,5.9
Terrell County,2020-Aug,398,379,19,4.8
Terrell County,2020-Sep,386,368,18,4.7
Terrell County,2020-Oct,384,370,14,3.6
Terrell County,2020-Nov,383,367,16,4.2
Terrell County,2020-Dec,374,361,13,3.5
Terrell County,2021-Jan,407,392,15,3.7
Terrell County,2021-Feb,407,392,15,3.7
Terrell County,2021-Mar,424,407,17,4
Terrell County,2021-Apr,416,402,14,3.4
Terrell County,2021-May,408,395,13,3.2
Terrell County,2021-Jun,409,394,15,3.7
Terrell County,2021-Jul,416,401,15,3.6
Terrell County,2021-Aug,403,387,16,4
Terrell County,2021-Sep,412,398,14,3.4
Terrell County,2021-Oct,408,393,15,3.7
Terrell County,2021-Nov,410,396,14,3.4
Terrell County,2021-Dec,405,390,15,3.7
Terrell County,2022-Jan,432,413,19,4.4
Terrell County,2022-Feb,434,417,17,3.9
Terrell County,2022-Mar,449,435,14,3.1
Terrell County,2022-Apr,436,424,12,2.8
Terrell County,2022-May,433,420,13,3
Terrell County,2022-Jun,437,424,13,3
Terrell County,2022-Jul,452(P),438(P),14(P),3.1(P)
Terry County,2012-Jan,5632,5232,400,7.1
Terry County,2012-Feb,5596,5198,398,7.1
Terry County,2012-Mar,5667,5289,378,6.7
Terry County,2012-Apr,5727,5380,347,6.1
Terry County,2012-May,5739,5373,366,6.4
Terry County,2012-Jun,5849,5439,410,7
Terry County,2012-Jul,5776,5367,409,7.1
Terry County,2012-Aug,5638,5269,369,6.5
Terry County,2012-Sep,5626,5285,341,6.1
Terry County,2012-Oct,5541,5210,331,6
Terry County,2012-Nov,5469,5152,317,5.8
Terry County,2012-Dec,5556,5215,341,6.1
Terry County,2013-Jan,5368,4977,391,7.3
Terry County,2013-Feb,5351,4984,367,6.9
Terry County,2013-Mar,5326,4974,352,6.6
Terry County,2013-Apr,5453,5131,322,5.9
Terry County,2013-May,5563,5236,327,5.9
Terry County,2013-Jun,5682,5306,376,6.6
Terry County,2013-Jul,5713,5356,357,6.2
Terry County,2013-Aug,5548,5232,316,5.7
Terry County,2013-Sep,5585,5263,322,5.8
Terry County,2013-Oct,5601,5309,292,5.2
Terry County,2013-Nov,5439,5167,272,5
Terry County,2013-Dec,5634,5373,261,4.6
Terry County,2014-Jan,5428,5169,259,4.8
Terry County,2014-Feb,5534,5249,285,5.1
Terry County,2014-Mar,5536,5277,259,4.7
Terry County,2014-Apr,5658,5431,227,4
Terry County,2014-May,5696,5450,246,4.3
Terry County,2014-Jun,5703,5430,273,4.8
Terry County,2014-Jul,5692,5420,272,4.8
Terry County,2014-Aug,5598,5345,253,4.5
Terry County,2014-Sep,5562,5327,235,4.2
Terry County,2014-Oct,5655,5430,225,4
Terry County,2014-Nov,5630,5424,206,3.7
Terry County,2014-Dec,5550,5362,188,3.4
Terry County,2015-Jan,5424,5187,237,4.4
Terry County,2015-Feb,5493,5237,256,4.7
Terry County,2015-Mar,5518,5263,255,4.6
Terry County,2015-Apr,5459,5219,240,4.4
Terry County,2015-May,5487,5230,257,4.7
Terry County,2015-Jun,5500,5208,292,5.3
Terry County,2015-Jul,5417,5128,289,5.3
Terry County,2015-Aug,5324,5051,273,5.1
Terry County,2015-Sep,5278,5018,260,4.9
Terry County,2015-Oct,5310,5067,243,4.6
Terry County,2015-Nov,5346,5111,235,4.4
Terry County,2015-Dec,5303,5083,220,4.1
Terry County,2016-Jan,5029,4794,235,4.7
Terry County,2016-Feb,5274,5021,253,4.8
Terry County,2016-Mar,5393,5134,259,4.8
Terry County,2016-Apr,5466,5222,244,4.5
Terry County,2016-May,5627,5378,249,4.4
Terry County,2016-Jun,5525,5239,286,5.2
Terry County,2016-Jul,5394,5102,292,5.4
Terry County,2016-Aug,5466,5192,274,5
Terry County,2016-Sep,5383,5117,266,4.9
Terry County,2016-Oct,5257,5012,245,4.7
Terry County,2016-Nov,5220,4985,235,4.5
Terry County,2016-Dec,5189,4958,231,4.5
Terry County,2017-Jan,5072,4818,254,5
Terry County,2017-Feb,5190,4889,301,5.8
Terry County,2017-Mar,5349,5061,288,5.4
Terry County,2017-Apr,5387,5125,262,4.9
Terry County,2017-May,5389,5131,258,4.8
Terry County,2017-Jun,5323,5027,296,5.6
Terry County,2017-Jul,5123,4839,284,5.5
Terry County,2017-Aug,5189,4900,289,5.6
Terry County,2017-Sep,5069,4817,252,5
Terry County,2017-Oct,5160,4933,227,4.4
Terry County,2017-Nov,5118,4894,224,4.4
Terry County,2017-Dec,5090,4865,225,4.4
Terry County,2018-Jan,4986,4735,251,5
Terry County,2018-Feb,5048,4801,247,4.9
Terry County,2018-Mar,5198,4973,225,4.3
Terry County,2018-Apr,5145,4943,202,3.9
Terry County,2018-May,5212,5017,195,3.7
Terry County,2018-Jun,5170,4939,231,4.5
Terry County,2018-Jul,5087,4878,209,4.1
Terry County,2018-Aug,5140,4944,196,3.8
Terry County,2018-Sep,5099,4907,192,3.8
Terry County,2018-Oct,5019,4830,189,3.8
Terry County,2018-Nov,4993,4807,186,3.7
Terry County,2018-Dec,4886,4699,187,3.8
Terry County,2019-Jan,4873,4660,213,4.4
Terry County,2019-Feb,4971,4766,205,4.1
Terry County,2019-Mar,5020,4836,184,3.7
Terry County,2019-Apr,4963,4796,167,3.4
Terry County,2019-May,5016,4846,170,3.4
Terry County,2019-Jun,4957,4761,196,4
Terry County,2019-Jul,4916,4719,197,4
Terry County,2019-Aug,5011,4828,183,3.7
Terry County,2019-Sep,4876,4708,168,3.4
Terry County,2019-Oct,5016,4851,165,3.3
Terry County,2019-Nov,4823,4661,162,3.4
Terry County,2019-Dec,4812,4658,154,3.2
Terry County,2020-Jan,4764,4586,178,3.7
Terry County,2020-Feb,4818,4660,158,3.3
Terry County,2020-Mar,4823,4564,259,5.4
Terry County,2020-Apr,4617,4231,386,8.4
Terry County,2020-May,4695,4208,487,10.4
Terry County,2020-Jun,4795,4303,492,10.3
Terry County,2020-Jul,4789,4348,441,9.2
Terry County,2020-Aug,4883,4511,372,7.6
Terry County,2020-Sep,4794,4423,371,7.7
Terry County,2020-Oct,4877,4536,341,7
Terry County,2020-Nov,4715,4357,358,7.6
Terry County,2020-Dec,4687,4341,346,7.4
Terry County,2021-Jan,4816,4461,355,7.4
Terry County,2021-Feb,4896,4542,354,7.2
Terry County,2021-Mar,5030,4702,328,6.5
Terry County,2021-Apr,4944,4639,305,6.2
Terry County,2021-May,4800,4513,287,6
Terry County,2021-Jun,4761,4432,329,6.9
Terry County,2021-Jul,4743,4443,300,6.3
Terry County,2021-Aug,4754,4485,269,5.7
Terry County,2021-Sep,4753,4489,264,5.6
Terry County,2021-Oct,4718,4463,255,5.4
Terry County,2021-Nov,4563,4328,235,5.2
Terry County,2021-Dec,4539,4311,228,5
Terry County,2022-Jan,4615,4365,250,5.4
Terry County,2022-Feb,4823,4578,245,5.1
Terry County,2022-Mar,4975,4774,201,4
Terry County,2022-Apr,4877,4681,196,4
Terry County,2022-May,4725,4524,201,4.3
Terry County,2022-Jun,4686,4458,228,4.9
Terry County,2022-Jul,4827(P),4612(P),215(P),4.5(P)
Throckmorton County,2012-Jan,828,780,48,5.8
Throckmorton County,2012-Feb,821,776,45,5.5
Throckmorton County,2012-Mar,828,785,43,5.2
Throckmorton County,2012-Apr,837,792,45,5.4
Throckmorton County,2012-May,845,796,49,5.8
Throckmorton County,2012-Jun,856,804,52,6.1
Throckmorton County,2012-Jul,844,795,49,5.8
Throckmorton County,2012-Aug,823,782,41,5
Throckmorton County,2012-Sep,825,788,37,4.5
Throckmorton County,2012-Oct,821,782,39,4.8
Throckmorton County,2012-Nov,811,773,38,4.7
Throckmorton County,2012-Dec,800,761,39,4.9
Throckmorton County,2013-Jan,770,726,44,5.7
Throckmorton County,2013-Feb,779,737,42,5.4
Throckmorton County,2013-Mar,770,731,39,5.1
Throckmorton County,2013-Apr,782,746,36,4.6
Throckmorton County,2013-May,804,763,41,5.1
Throckmorton County,2013-Jun,810,768,42,5.2
Throckmorton County,2013-Jul,810,769,41,5.1
Throckmorton County,2013-Aug,792,753,39,4.9
Throckmorton County,2013-Sep,805,764,41,5.1
Throckmorton County,2013-Oct,810,766,44,5.4
Throckmorton County,2013-Nov,786,750,36,4.6
Throckmorton County,2013-Dec,807,772,35,4.3
Throckmorton County,2014-Jan,808,774,34,4.2
Throckmorton County,2014-Feb,829,793,36,4.3
Throckmorton County,2014-Mar,838,800,38,4.5
Throckmorton County,2014-Apr,840,808,32,3.8
Throckmorton County,2014-May,857,822,35,4.1
Throckmorton County,2014-Jun,855,820,35,4.1
Throckmorton County,2014-Jul,847,808,39,4.6
Throckmorton County,2014-Aug,828,792,36,4.3
Throckmorton County,2014-Sep,831,800,31,3.7
Throckmorton County,2014-Oct,828,799,29,3.5
Throckmorton County,2014-Nov,812,783,29,3.6
Throckmorton County,2014-Dec,801,778,23,2.9
Throckmorton County,2015-Jan,786,758,28,3.6
Throckmorton County,2015-Feb,797,771,26,3.3
Throckmorton County,2015-Mar,798,775,23,2.9
Throckmorton County,2015-Apr,801,777,24,3
Throckmorton County,2015-May,813,787,26,3.2
Throckmorton County,2015-Jun,812,783,29,3.6
Throckmorton County,2015-Jul,787,760,27,3.4
Throckmorton County,2015-Aug,765,740,25,3.3
Throckmorton County,2015-Sep,761,736,25,3.3
Throckmorton County,2015-Oct,758,735,23,3
Throckmorton County,2015-Nov,745,721,24,3.2
Throckmorton County,2015-Dec,749,727,22,2.9
Throckmorton County,2016-Jan,735,713,22,3
Throckmorton County,2016-Feb,759,735,24,3.2
Throckmorton County,2016-Mar,775,749,26,3.4
Throckmorton County,2016-Apr,766,740,26,3.4
Throckmorton County,2016-May,781,758,23,2.9
Throckmorton County,2016-Jun,772,744,28,3.6
Throckmorton County,2016-Jul,738,710,28,3.8
Throckmorton County,2016-Aug,744,718,26,3.5
Throckmorton County,2016-Sep,725,698,27,3.7
Throckmorton County,2016-Oct,715,689,26,3.6
Throckmorton County,2016-Nov,702,675,27,3.8
Throckmorton County,2016-Dec,702,676,26,3.7
Throckmorton County,2017-Jan,668,638,30,4.5
Throckmorton County,2017-Feb,678,646,32,4.7
Throckmorton County,2017-Mar,708,678,30,4.2
Throckmorton County,2017-Apr,718,683,35,4.9
Throckmorton County,2017-May,715,683,32,4.5
Throckmorton County,2017-Jun,710,678,32,4.5
Throckmorton County,2017-Jul,682,650,32,4.7
Throckmorton County,2017-Aug,696,661,35,5
Throckmorton County,2017-Sep,664,634,30,4.5
Throckmorton County,2017-Oct,680,654,26,3.8
Throckmorton County,2017-Nov,654,631,23,3.5
Throckmorton County,2017-Dec,652,632,20,3.1
Throckmorton County,2018-Jan,643,621,22,3.4
Throckmorton County,2018-Feb,662,637,25,3.8
Throckmorton County,2018-Mar,687,662,25,3.6
Throckmorton County,2018-Apr,705,684,21,3
Throckmorton County,2018-May,721,698,23,3.2
Throckmorton County,2018-Jun,709,683,26,3.7
Throckmorton County,2018-Jul,709,685,24,3.4
Throckmorton County,2018-Aug,721,698,23,3.2
Throckmorton County,2018-Sep,707,683,24,3.4
Throckmorton County,2018-Oct,693,670,23,3.3
Throckmorton County,2018-Nov,690,668,22,3.2
Throckmorton County,2018-Dec,684,663,21,3.1
Throckmorton County,2019-Jan,614,593,21,3.4
Throckmorton County,2019-Feb,636,612,24,3.8
Throckmorton County,2019-Mar,653,630,23,3.5
Throckmorton County,2019-Apr,639,620,19,3
Throckmorton County,2019-May,650,632,18,2.8
Throckmorton County,2019-Jun,657,629,28,4.3
Throckmorton County,2019-Jul,651,623,28,4.3
Throckmorton County,2019-Aug,673,643,30,4.5
Throckmorton County,2019-Sep,645,618,27,4.2
Throckmorton County,2019-Oct,643,618,25,3.9
Throckmorton County,2019-Nov,616,592,24,3.9
Throckmorton County,2019-Dec,611,591,20,3.3
Throckmorton County,2020-Jan,632,611,21,3.3
Throckmorton County,2020-Feb,640,620,20,3.1
Throckmorton County,2020-Mar,633,605,28,4.4
Throckmorton County,2020-Apr,579,560,19,3.3
Throckmorton County,2020-May,603,567,36,6
Throckmorton County,2020-Jun,609,571,38,6.2
Throckmorton County,2020-Jul,635,594,41,6.5
Throckmorton County,2020-Aug,653,620,33,5.1
Throckmorton County,2020-Sep,632,597,35,5.5
Throckmorton County,2020-Oct,665,638,27,4.1
Throckmorton County,2020-Nov,656,623,33,5
Throckmorton County,2020-Dec,660,627,33,5
Throckmorton County,2021-Jan,723,689,34,4.7
Throckmorton County,2021-Feb,770,736,34,4.4
Throckmorton County,2021-Mar,803,770,33,4.1
Throckmorton County,2021-Apr,915,886,29,3.2
Throckmorton County,2021-May,987,962,25,2.5
Throckmorton County,2021-Jun,1083,1052,31,2.9
Throckmorton County,2021-Jul,1115,1089,26,2.3
Throckmorton County,2021-Aug,1138,1113,25,2.2
Throckmorton County,2021-Sep,1129,1105,24,2.1
Throckmorton County,2021-Oct,1148,1124,24,2.1
Throckmorton County,2021-Nov,1142,1117,25,2.2
Throckmorton County,2021-Dec,1140,1118,22,1.9
Throckmorton County,2022-Jan,1135,1109,26,2.3
Throckmorton County,2022-Feb,1202,1176,26,2.2
Throckmorton County,2022-Mar,1237,1214,23,1.9
Throckmorton County,2022-Apr,1311,1294,17,1.3
Throckmorton County,2022-May,1370,1350,20,1.5
Throckmorton County,2022-Jun,1447,1421,26,1.8
Throckmorton County,2022-Jul,1502(P),1479(P),23(P),1.5(P)
Titus County,2012-Jan,13222,12168,1054,8
Titus County,2012-Feb,13352,12332,1020,7.6
Titus County,2012-Mar,13330,12392,938,7
Titus County,2012-Apr,13310,12433,877,6.6
Titus County,2012-May,13295,12365,930,7
Titus County,2012-Jun,13414,12329,1085,8.1
Titus County,2012-Jul,13298,12167,1131,8.5
Titus County,2012-Aug,13082,12040,1042,8
Titus County,2012-Sep,13257,12296,961,7.2
Titus County,2012-Oct,13114,12164,950,7.2
Titus County,2012-Nov,13082,12170,912,7
Titus County,2012-Dec,13066,12116,950,7.3
Titus County,2013-Jan,13112,12094,1018,7.8
Titus County,2013-Feb,13055,12062,993,7.6
Titus County,2013-Mar,13010,12054,956,7.3
Titus County,2013-Apr,13085,12180,905,6.9
Titus County,2013-May,13028,12062,966,7.4
Titus County,2013-Jun,13117,12027,1090,8.3
Titus County,2013-Jul,13018,11939,1079,8.3
Titus County,2013-Aug,12939,11889,1050,8.1
Titus County,2013-Sep,13136,12140,996,7.6
Titus County,2013-Oct,13009,12083,926,7.1
Titus County,2013-Nov,13079,12177,902,6.9
Titus County,2013-Dec,13064,12214,850,6.5
Titus County,2014-Jan,13013,12135,878,6.7
Titus County,2014-Feb,13095,12209,886,6.8
Titus County,2014-Mar,13089,12207,882,6.7
Titus County,2014-Apr,12973,12210,763,5.9
Titus County,2014-May,12915,12104,811,6.3
Titus County,2014-Jun,13017,12101,916,7
Titus County,2014-Jul,12905,11981,924,7.2
Titus County,2014-Aug,12767,11859,908,7.1
Titus County,2014-Sep,12858,12067,791,6.2
Titus County,2014-Oct,12746,12018,728,5.7
Titus County,2014-Nov,12759,12042,717,5.6
Titus County,2014-Dec,12586,11914,672,5.3
Titus County,2015-Jan,12573,11830,743,5.9
Titus County,2015-Feb,12656,11944,712,5.6
Titus County,2015-Mar,12736,12030,706,5.5
Titus County,2015-Apr,12819,12124,695,5.4
Titus County,2015-May,12817,12076,741,5.8
Titus County,2015-Jun,12887,12058,829,6.4
Titus County,2015-Jul,12727,11886,841,6.6
Titus County,2015-Aug,12662,11884,778,6.1
Titus County,2015-Sep,12656,11922,734,5.8
Titus County,2015-Oct,12741,12036,705,5.5
Titus County,2015-Nov,12810,12111,699,5.5
Titus County,2015-Dec,12814,12126,688,5.4
Titus County,2016-Jan,12700,11982,718,5.7
Titus County,2016-Feb,12832,12135,697,5.4
Titus County,2016-Mar,12864,12147,717,5.6
Titus County,2016-Apr,12883,12177,706,5.5
Titus County,2016-May,12932,12179,753,5.8
Titus County,2016-Jun,13011,12105,906,7
Titus County,2016-Jul,12953,12026,927,7.2
Titus County,2016-Aug,13002,12091,911,7
Titus County,2016-Sep,12944,12070,874,6.8
Titus County,2016-Oct,12801,12014,787,6.1
Titus County,2016-Nov,12838,12062,776,6
Titus County,2016-Dec,12844,12070,774,6
Titus County,2017-Jan,12938,12068,870,6.7
Titus County,2017-Feb,13015,12183,832,6.4
Titus County,2017-Mar,13020,12223,797,6.1
Titus County,2017-Apr,12896,12213,683,5.3
Titus County,2017-May,12783,12124,659,5.2
Titus County,2017-Jun,12870,12124,746,5.8
Titus County,2017-Jul,12895,12170,725,5.6
Titus County,2017-Aug,12935,12222,713,5.5
Titus County,2017-Sep,12849,12237,612,4.8
Titus County,2017-Oct,12673,12121,552,4.4
Titus County,2017-Nov,12662,12059,603,4.8
Titus County,2017-Dec,12727,12134,593,4.7
Titus County,2018-Jan,12699,12046,653,5.1
Titus County,2018-Feb,12994,12289,705,5.4
Titus County,2018-Mar,13006,12320,686,5.3
Titus County,2018-Apr,12938,12319,619,4.8
Titus County,2018-May,12834,12229,605,4.7
Titus County,2018-Jun,12883,12136,747,5.8
Titus County,2018-Jul,12817,12102,715,5.6
Titus County,2018-Aug,12631,11961,670,5.3
Titus County,2018-Sep,12706,12075,631,5
Titus County,2018-Oct,12622,12025,597,4.7
Titus County,2018-Nov,12603,12032,571,4.5
Titus County,2018-Dec,12559,11985,574,4.6
Titus County,2019-Jan,12504,11859,645,5.2
Titus County,2019-Feb,12625,12072,553,4.4
Titus County,2019-Mar,12676,12117,559,4.4
Titus County,2019-Apr,12690,12231,459,3.6
Titus County,2019-May,12701,12227,474,3.7
Titus County,2019-Jun,12845,12267,578,4.5
Titus County,2019-Jul,12831,12236,595,4.6
Titus County,2019-Aug,12789,12245,544,4.3
Titus County,2019-Sep,12954,12454,500,3.9
Titus County,2019-Oct,12964,12481,483,3.7
Titus County,2019-Nov,12907,12422,485,3.8
Titus County,2019-Dec,12896,12424,472,3.7
Titus County,2020-Jan,13129,12571,558,4.3
Titus County,2020-Feb,13342,12834,508,3.8
Titus County,2020-Mar,13175,12397,778,5.9
Titus County,2020-Apr,12409,11245,1164,9.4
Titus County,2020-May,12677,11586,1091,8.6
Titus County,2020-Jun,12993,11790,1203,9.3
Titus County,2020-Jul,13176,12063,1113,8.4
Titus County,2020-Aug,13252,12346,906,6.8
Titus County,2020-Sep,13341,12475,866,6.5
Titus County,2020-Oct,13393,12620,773,5.8
Titus County,2020-Nov,13433,12621,812,6
Titus County,2020-Dec,13513,12663,850,6.3
Titus County,2021-Jan,13426,12564,862,6.4
Titus County,2021-Feb,13668,12817,851,6.2
Titus County,2021-Mar,13669,12871,798,5.8
Titus County,2021-Apr,13514,12806,708,5.2
Titus County,2021-May,13483,12798,685,5.1
Titus County,2021-Jun,13532,12696,836,6.2
Titus County,2021-Jul,13570,12789,781,5.8
Titus County,2021-Aug,13544,12821,723,5.3
Titus County,2021-Sep,13623,12956,667,4.9
Titus County,2021-Oct,13593,12955,638,4.7
Titus County,2021-Nov,13577,12979,598,4.4
Titus County,2021-Dec,13565,12997,568,4.2
Titus County,2022-Jan,13591,12929,662,4.9
Titus County,2022-Feb,13851,13190,661,4.8
Titus County,2022-Mar,13879,13367,512,3.7
Titus County,2022-Apr,13465,12977,488,3.6
Titus County,2022-May,13570,13049,521,3.8
Titus County,2022-Jun,13632,12967,665,4.9
Titus County,2022-Jul,13701(P),13079(P),622(P),4.5(P)
Tom Green County,2012-Jan,52959,49841,3118,5.9
Tom Green County,2012-Feb,53181,50211,2970,5.6
Tom Green County,2012-Mar,53214,50456,2758,5.2
Tom Green County,2012-Apr,53506,50863,2643,4.9
Tom Green County,2012-May,53763,50937,2826,5.3
Tom Green County,2012-Jun,54008,50853,3155,5.8
Tom Green County,2012-Jul,53979,50804,3175,5.9
Tom Green County,2012-Aug,53860,50929,2931,5.4
Tom Green County,2012-Sep,54023,51323,2700,5
Tom Green County,2012-Oct,53839,51195,2644,4.9
Tom Green County,2012-Nov,53804,51224,2580,4.8
Tom Green County,2012-Dec,53814,51186,2628,4.9
Tom Green County,2013-Jan,53612,50590,3022,5.6
Tom Green County,2013-Feb,53890,51027,2863,5.3
Tom Green County,2013-Mar,54000,51244,2756,5.1
Tom Green County,2013-Apr,54441,51689,2752,5.1
Tom Green County,2013-May,54653,51809,2844,5.2
Tom Green County,2013-Jun,54557,51316,3241,5.9
Tom Green County,2013-Jul,54310,51203,3107,5.7
Tom Green County,2013-Aug,54338,51500,2838,5.2
Tom Green County,2013-Sep,54443,51641,2802,5.1
Tom Green County,2013-Oct,53832,51191,2641,4.9
Tom Green County,2013-Nov,53712,51172,2540,4.7
Tom Green County,2013-Dec,53764,51390,2374,4.4
Tom Green County,2014-Jan,54076,51589,2487,4.6
Tom Green County,2014-Feb,54556,52053,2503,4.6
Tom Green County,2014-Mar,54835,52436,2399,4.4
Tom Green County,2014-Apr,54428,52400,2028,3.7
Tom Green County,2014-May,54490,52247,2243,4.1
Tom Green County,2014-Jun,54672,52272,2400,4.4
Tom Green County,2014-Jul,54785,52307,2478,4.5
Tom Green County,2014-Aug,54653,52344,2309,4.2
Tom Green County,2014-Sep,54880,52730,2150,3.9
Tom Green County,2014-Oct,54525,52526,1999,3.7
Tom Green County,2014-Nov,54662,52658,2004,3.7
Tom Green County,2014-Dec,54400,52626,1774,3.3
Tom Green County,2015-Jan,54350,52205,2145,3.9
Tom Green County,2015-Feb,54626,52469,2157,3.9
Tom Green County,2015-Mar,54663,52482,2181,4
Tom Green County,2015-Apr,55028,52912,2116,3.8
Tom Green County,2015-May,55195,52887,2308,4.2
Tom Green County,2015-Jun,55086,52609,2477,4.5
Tom Green County,2015-Jul,54490,52036,2454,4.5
Tom Green County,2015-Aug,54270,51983,2287,4.2
Tom Green County,2015-Sep,54171,51915,2256,4.2
Tom Green County,2015-Oct,54248,52007,2241,4.1
Tom Green County,2015-Nov,54348,52070,2278,4.2
Tom Green County,2015-Dec,54339,52179,2160,4
Tom Green County,2016-Jan,54059,51803,2256,4.2
Tom Green County,2016-Feb,54910,52490,2420,4.4
Tom Green County,2016-Mar,54955,52489,2466,4.5
Tom Green County,2016-Apr,54781,52390,2391,4.4
Tom Green County,2016-May,54719,52394,2325,4.2
Tom Green County,2016-Jun,54801,52181,2620,4.8
Tom Green County,2016-Jul,54221,51528,2693,5
Tom Green County,2016-Aug,54107,51524,2583,4.8
Tom Green County,2016-Sep,53873,51358,2515,4.7
Tom Green County,2016-Oct,53691,51305,2386,4.4
Tom Green County,2016-Nov,53739,51446,2293,4.3
Tom Green County,2016-Dec,53416,51151,2265,4.2
Tom Green County,2017-Jan,53389,50964,2425,4.5
Tom Green County,2017-Feb,53666,51316,2350,4.4
Tom Green County,2017-Mar,53739,51547,2192,4.1
Tom Green County,2017-Apr,53636,51708,1928,3.6
Tom Green County,2017-May,53469,51484,1985,3.7
Tom Green County,2017-Jun,53906,51761,2145,4
Tom Green County,2017-Jul,53835,51758,2077,3.9
Tom Green County,2017-Aug,53867,51873,1994,3.7
Tom Green County,2017-Sep,54078,52290,1788,3.3
Tom Green County,2017-Oct,53888,52244,1644,3.1
Tom Green County,2017-Nov,53851,52131,1720,3.2
Tom Green County,2017-Dec,53785,52162,1623,3
Tom Green County,2018-Jan,53674,51867,1807,3.4
Tom Green County,2018-Feb,54218,52444,1774,3.3
Tom Green County,2018-Mar,54209,52469,1740,3.2
Tom Green County,2018-Apr,54267,52709,1558,2.9
Tom Green County,2018-May,54024,52461,1563,2.9
Tom Green County,2018-Jun,54152,52264,1888,3.5
Tom Green County,2018-Jul,54175,52363,1812,3.3
Tom Green County,2018-Aug,54096,52344,1752,3.2
Tom Green County,2018-Sep,54239,52523,1716,3.2
Tom Green County,2018-Oct,54173,52535,1638,3
Tom Green County,2018-Nov,54339,52681,1658,3.1
Tom Green County,2018-Dec,53808,52135,1673,3.1
Tom Green County,2019-Jan,53951,52088,1863,3.5
Tom Green County,2019-Feb,54466,52715,1751,3.2
Tom Green County,2019-Mar,54210,52573,1637,3
Tom Green County,2019-Apr,53975,52594,1381,2.6
Tom Green County,2019-May,53625,52170,1455,2.7
Tom Green County,2019-Jun,53952,52163,1789,3.3
Tom Green County,2019-Jul,53595,51764,1831,3.4
Tom Green County,2019-Aug,54011,52306,1705,3.2
Tom Green County,2019-Sep,54182,52592,1590,2.9
Tom Green County,2019-Oct,54046,52487,1559,2.9
Tom Green County,2019-Nov,53938,52379,1559,2.9
Tom Green County,2019-Dec,53852,52385,1467,2.7
Tom Green County,2020-Jan,53944,52273,1671,3.1
Tom Green County,2020-Feb,54381,52853,1528,2.8
Tom Green County,2020-Mar,53356,51006,2350,4.4
Tom Green County,2020-Apr,50542,45787,4755,9.4
Tom Green County,2020-May,52060,47111,4949,9.5
Tom Green County,2020-Jun,53029,48321,4708,8.9
Tom Green County,2020-Jul,53326,48883,4443,8.3
Tom Green County,2020-Aug,53472,50010,3462,6.5
Tom Green County,2020-Sep,53447,50076,3371,6.3
Tom Green County,2020-Oct,54120,51140,2980,5.5
Tom Green County,2020-Nov,54002,50822,3180,5.9
Tom Green County,2020-Dec,54038,50890,3148,5.8
Tom Green County,2021-Jan,53916,50655,3261,6
Tom Green County,2021-Feb,54335,51161,3174,5.8
Tom Green County,2021-Mar,54494,51547,2947,5.4
Tom Green County,2021-Apr,54322,51665,2657,4.9
Tom Green County,2021-May,53966,51379,2587,4.8
Tom Green County,2021-Jun,54204,51223,2981,5.5
Tom Green County,2021-Jul,53593,50926,2667,5
Tom Green County,2021-Aug,53641,51141,2500,4.7
Tom Green County,2021-Sep,53789,51397,2392,4.4
Tom Green County,2021-Oct,53972,51692,2280,4.2
Tom Green County,2021-Nov,54018,51887,2131,3.9
Tom Green County,2021-Dec,53855,51912,1943,3.6
Tom Green County,2022-Jan,54068,51825,2243,4.1
Tom Green County,2022-Feb,54889,52659,2230,4.1
Tom Green County,2022-Mar,54781,52980,1801,3.3
Tom Green County,2022-Apr,54132,52488,1644,3
Tom Green County,2022-May,53974,52232,1742,3.2
Tom Green County,2022-Jun,54285,52242,2043,3.8
Tom Green County,2022-Jul,54106(P),52140(P),1966(P),3.6(P)
Travis County,2012-Jan,601660,565478,36182,6
Travis County,2012-Feb,604545,569196,35349,5.8
Travis County,2012-Mar,604942,571617,33325,5.5
Travis County,2012-Apr,605963,574839,31124,5.1
Travis County,2012-May,607376,574402,32974,5.4
Travis County,2012-Jun,610740,574412,36328,5.9
Travis County,2012-Jul,611558,575158,36400,6
Travis County,2012-Aug,609657,575307,34350,5.6
Travis County,2012-Sep,614039,582047,31992,5.2
Travis County,2012-Oct,618836,587296,31540,5.1
Travis County,2012-Nov,621661,591490,30171,4.9
Travis County,2012-Dec,619125,588095,31030,5
Travis County,2013-Jan,618998,583698,35300,5.7
Travis County,2013-Feb,620708,587504,33204,5.3
Travis County,2013-Mar,621399,589205,32194,5.2
Travis County,2013-Apr,626485,596065,30420,4.9
Travis County,2013-May,627566,595961,31605,5
Travis County,2013-Jun,630364,595598,34766,5.5
Travis County,2013-Jul,630891,597045,33846,5.4
Travis County,2013-Aug,629183,596863,32320,5.1
Travis County,2013-Sep,632836,600449,32387,5.1
Travis County,2013-Oct,631903,600526,31377,5
Travis County,2013-Nov,638305,609466,28839,4.5
Travis County,2013-Dec,634771,607802,26969,4.2
Travis County,2014-Jan,633592,604659,28933,4.6
Travis County,2014-Feb,639100,609961,29139,4.6
Travis County,2014-Mar,642260,614099,28161,4.4
Travis County,2014-Apr,641063,616914,24149,3.8
Travis County,2014-May,641507,615406,26101,4.1
Travis County,2014-Jun,644190,616306,27884,4.3
Travis County,2014-Jul,645585,616540,29045,4.5
Travis County,2014-Aug,643404,614947,28457,4.4
Travis County,2014-Sep,645117,618436,26681,4.1
Travis County,2014-Oct,648503,623706,24797,3.8
Travis County,2014-Nov,650971,626734,24237,3.7
Travis County,2014-Dec,645566,623642,21924,3.4
Travis County,2015-Jan,644078,619338,24740,3.8
Travis County,2015-Feb,646140,623309,22831,3.5
Travis County,2015-Mar,647559,626294,21265,3.3
Travis County,2015-Apr,652583,633061,19522,3
Travis County,2015-May,655577,634582,20995,3.2
Travis County,2015-Jun,657468,634780,22688,3.5
Travis County,2015-Jul,656733,633500,23233,3.5
Travis County,2015-Aug,655335,633719,21616,3.3
Travis County,2015-Sep,658515,636946,21569,3.3
Travis County,2015-Oct,662687,641502,21185,3.2
Travis County,2015-Nov,667721,646730,20991,3.1
Travis County,2015-Dec,666624,646993,19631,2.9
Travis County,2016-Jan,663911,642678,21233,3.2
Travis County,2016-Feb,670738,649921,20817,3.1
Travis County,2016-Mar,673031,652222,20809,3.1
Travis County,2016-Apr,674440,655364,19076,2.8
Travis County,2016-May,674083,654762,19321,2.9
Travis County,2016-Jun,679135,656371,22764,3.4
Travis County,2016-Jul,682495,658719,23776,3.5
Travis County,2016-Aug,679724,656789,22935,3.4
Travis County,2016-Sep,683334,659909,23425,3.4
Travis County,2016-Oct,685971,663729,22242,3.2
Travis County,2016-Nov,688461,666885,21576,3.1
Travis County,2016-Dec,686428,665122,21306,3.1
Travis County,2017-Jan,680818,657267,23551,3.5
Travis County,2017-Feb,687298,663221,24077,3.5
Travis County,2017-Mar,688611,666001,22610,3.3
Travis County,2017-Apr,691332,671449,19883,2.9
Travis County,2017-May,690289,669890,20399,3
Travis County,2017-Jun,693571,671300,22271,3.2
Travis County,2017-Jul,696268,673844,22424,3.2
Travis County,2017-Aug,693631,671138,22493,3.2
Travis County,2017-Sep,699035,678588,20447,2.9
Travis County,2017-Oct,698239,679442,18797,2.7
Travis County,2017-Nov,701455,681572,19883,2.8
Travis County,2017-Dec,700546,681507,19039,2.7
Travis County,2018-Jan,698772,677581,21191,3
Travis County,2018-Feb,707337,685791,21546,3
Travis County,2018-Mar,707190,686034,21156,3
Travis County,2018-Apr,710409,691390,19019,2.7
Travis County,2018-May,709330,690637,18693,2.6
Travis County,2018-Jun,714548,692204,22344,3.1
Travis County,2018-Jul,715110,693233,21877,3.1
Travis County,2018-Aug,709377,688090,21287,3
Travis County,2018-Sep,713127,692488,20639,2.9
Travis County,2018-Oct,719120,699644,19476,2.7
Travis County,2018-Nov,721276,701996,19280,2.7
Travis County,2018-Dec,721002,701830,19172,2.7
Travis County,2019-Jan,718021,694975,23046,3.2
Travis County,2019-Feb,723074,702626,20448,2.8
Travis County,2019-Mar,722088,702918,19170,2.7
Travis County,2019-Apr,722797,706360,16437,2.3
Travis County,2019-May,721427,704793,16634,2.3
Travis County,2019-Jun,727954,707722,20232,2.8
Travis County,2019-Jul,730864,709841,21023,2.9
Travis County,2019-Aug,728804,708710,20094,2.8
Travis County,2019-Sep,732700,713573,19127,2.6
Travis County,2019-Oct,736859,718579,18280,2.5
Travis County,2019-Nov,740144,722148,17996,2.4
Travis County,2019-Dec,739729,722877,16852,2.3
Travis County,2020-Jan,735922,716542,19380,2.6
Travis County,2020-Feb,741993,723467,18526,2.5
Travis County,2020-Mar,726045,697051,28994,4
Travis County,2020-Apr,687230,607485,79745,11.6
Travis County,2020-May,709397,632339,77058,10.9
Travis County,2020-Jun,723322,657189,66133,9.1
Travis County,2020-Jul,729941,669612,60329,8.3
Travis County,2020-Aug,734908,686680,48228,6.6
Travis County,2020-Sep,737127,692052,45075,6.1
Travis County,2020-Oct,744777,706647,38130,5.1
Travis County,2020-Nov,747679,709428,38251,5.1
Travis County,2020-Dec,748750,711491,37259,5
Travis County,2021-Jan,747154,708218,38936,5.2
Travis County,2021-Feb,753589,715102,38487,5.1
Travis County,2021-Mar,755475,718840,36635,4.8
Travis County,2021-Apr,760847,728156,32691,4.3
Travis County,2021-May,763003,732058,30945,4.1
Travis County,2021-Jun,770974,736501,34473,4.5
Travis County,2021-Jul,776096,744835,31261,4
Travis County,2021-Aug,776186,746798,29388,3.8
Travis County,2021-Sep,778476,750902,27574,3.5
Travis County,2021-Oct,786333,760069,26264,3.3
Travis County,2021-Nov,791721,766945,24776,3.1
Travis County,2021-Dec,790558,768168,22390,2.8
Travis County,2022-Jan,787439,761765,25674,3.3
Travis County,2022-Feb,795999,770032,25967,3.3
Travis County,2022-Mar,799523,778332,21191,2.7
Travis County,2022-Apr,793590,774074,19516,2.5
Travis County,2022-May,792570,771691,20879,2.6
Travis County,2022-Jun,799467,775283,24184,3
Travis County,2022-Jul,801200(P),777286(P),23914(P),3.0(P)
Trinity County,2012-Jan,5525,5009,516,9.3
Trinity County,2012-Feb,5501,5016,485,8.8
Trinity County,2012-Mar,5500,5051,449,8.2
Trinity County,2012-Apr,5558,5128,430,7.7
Trinity County,2012-May,5581,5129,452,8.1
Trinity County,2012-Jun,5650,5156,494,8.7
Trinity County,2012-Jul,5651,5155,496,8.8
Trinity County,2012-Aug,5569,5118,451,8.1
Trinity County,2012-Sep,5613,5179,434,7.7
Trinity County,2012-Oct,5558,5147,411,7.4
Trinity County,2012-Nov,5525,5126,399,7.2
Trinity County,2012-Dec,5510,5077,433,7.9
Trinity County,2013-Jan,5513,5039,474,8.6
Trinity County,2013-Feb,5497,5066,431,7.8
Trinity County,2013-Mar,5477,5057,420,7.7
Trinity County,2013-Apr,5556,5148,408,7.3
Trinity County,2013-May,5600,5180,420,7.5
Trinity County,2013-Jun,5664,5193,471,8.3
Trinity County,2013-Jul,5657,5204,453,8
Trinity County,2013-Aug,5584,5159,425,7.6
Trinity County,2013-Sep,5643,5230,413,7.3
Trinity County,2013-Oct,5559,5170,389,7
Trinity County,2013-Nov,5503,5132,371,6.7
Trinity County,2013-Dec,5449,5102,347,6.4
Trinity County,2014-Jan,5396,5027,369,6.8
Trinity County,2014-Feb,5510,5141,369,6.7
Trinity County,2014-Mar,5510,5160,350,6.4
Trinity County,2014-Apr,5546,5232,314,5.7
Trinity County,2014-May,5599,5254,345,6.2
Trinity County,2014-Jun,5609,5256,353,6.3
Trinity County,2014-Jul,5604,5232,372,6.6
Trinity County,2014-Aug,5517,5168,349,6.3
Trinity County,2014-Sep,5582,5257,325,5.8
Trinity County,2014-Oct,5501,5194,307,5.6
Trinity County,2014-Nov,5444,5150,294,5.4
Trinity County,2014-Dec,5377,5090,287,5.3
Trinity County,2015-Jan,5401,5079,322,6
Trinity County,2015-Feb,5467,5149,318,5.8
Trinity County,2015-Mar,5483,5178,305,5.6
Trinity County,2015-Apr,5487,5193,294,5.4
Trinity County,2015-May,5539,5221,318,5.7
Trinity County,2015-Jun,5591,5245,346,6.2
Trinity County,2015-Jul,5532,5175,357,6.5
Trinity County,2015-Aug,5478,5136,342,6.2
Trinity County,2015-Sep,5514,5183,331,6
Trinity County,2015-Oct,5465,5144,321,5.9
Trinity County,2015-Nov,5441,5110,331,6.1
Trinity County,2015-Dec,5416,5092,324,6
Trinity County,2016-Jan,5353,5022,331,6.2
Trinity County,2016-Feb,5460,5131,329,6
Trinity County,2016-Mar,5518,5182,336,6.1
Trinity County,2016-Apr,5557,5231,326,5.9
Trinity County,2016-May,5560,5239,321,5.8
Trinity County,2016-Jun,5587,5229,358,6.4
Trinity County,2016-Jul,5504,5148,356,6.5
Trinity County,2016-Aug,5506,5152,354,6.4
Trinity County,2016-Sep,5515,5158,357,6.5
Trinity County,2016-Oct,5435,5121,314,5.8
Trinity County,2016-Nov,5427,5111,316,5.8
Trinity County,2016-Dec,5391,5082,309,5.7
Trinity County,2017-Jan,5323,4984,339,6.4
Trinity County,2017-Feb,5393,5056,337,6.2
Trinity County,2017-Mar,5491,5166,325,5.9
Trinity County,2017-Apr,5487,5182,305,5.6
Trinity County,2017-May,5418,5133,285,5.3
Trinity County,2017-Jun,5448,5157,291,5.3
Trinity County,2017-Jul,5307,5016,291,5.5
Trinity County,2017-Aug,5275,4973,302,5.7
Trinity County,2017-Sep,5240,4945,295,5.6
Trinity County,2017-Oct,5254,4994,260,4.9
Trinity County,2017-Nov,5220,4941,279,5.3
Trinity County,2017-Dec,5192,4930,262,5
Trinity County,2018-Jan,5240,4939,301,5.7
Trinity County,2018-Feb,5257,4956,301,5.7
Trinity County,2018-Mar,5314,5028,286,5.4
Trinity County,2018-Apr,5298,5039,259,4.9
Trinity County,2018-May,5349,5095,254,4.7
Trinity County,2018-Jun,5364,5068,296,5.5
Trinity County,2018-Jul,5282,4998,284,5.4
Trinity County,2018-Aug,5285,5008,277,5.2
Trinity County,2018-Sep,5296,5034,262,4.9
Trinity County,2018-Oct,5189,4950,239,4.6
Trinity County,2018-Nov,5185,4929,256,4.9
Trinity County,2018-Dec,5108,4845,263,5.1
Trinity County,2019-Jan,5150,4851,299,5.8
Trinity County,2019-Feb,5213,4942,271,5.2
Trinity County,2019-Mar,5239,4997,242,4.6
Trinity County,2019-Apr,5165,4960,205,4
Trinity County,2019-May,5217,5010,207,4
Trinity County,2019-Jun,5241,4994,247,4.7
Trinity County,2019-Jul,5246,4990,256,4.9
Trinity County,2019-Aug,5317,5062,255,4.8
Trinity County,2019-Sep,5300,5053,247,4.7
Trinity County,2019-Oct,5283,5034,249,4.7
Trinity County,2019-Nov,5245,4983,262,5
Trinity County,2019-Dec,5200,4948,252,4.8
Trinity County,2020-Jan,5243,4954,289,5.5
Trinity County,2020-Feb,5277,5023,254,4.8
Trinity County,2020-Mar,5233,4858,375,7.2
Trinity County,2020-Apr,5014,4533,481,9.6
Trinity County,2020-May,5158,4605,553,10.7
Trinity County,2020-Jun,5236,4709,527,10.1
Trinity County,2020-Jul,5236,4723,513,9.8
Trinity County,2020-Aug,5321,4876,445,8.4
Trinity County,2020-Sep,5353,4915,438,8.2
Trinity County,2020-Oct,5401,5014,387,7.2
Trinity County,2020-Nov,5341,4919,422,7.9
Trinity County,2020-Dec,5349,4902,447,8.4
Trinity County,2021-Jan,5335,4884,451,8.5
Trinity County,2021-Feb,5424,4968,456,8.4
Trinity County,2021-Mar,5538,5101,437,7.9
Trinity County,2021-Apr,5494,5102,392,7.1
Trinity County,2021-May,5403,5010,393,7.3
Trinity County,2021-Jun,5401,4965,436,8.1
Trinity County,2021-Jul,5368,4965,403,7.5
Trinity County,2021-Aug,5270,4887,383,7.3
Trinity County,2021-Sep,5321,4964,357,6.7
Trinity County,2021-Oct,5301,4950,351,6.6
Trinity County,2021-Nov,5231,4892,339,6.5
Trinity County,2021-Dec,5175,4861,314,6.1
Trinity County,2022-Jan,5199,4844,355,6.8
Trinity County,2022-Feb,5352,4983,369,6.9
Trinity County,2022-Mar,5431,5138,293,5.4
Trinity County,2022-Apr,5374,5097,277,5.2
Trinity County,2022-May,5286,5003,283,5.4
Trinity County,2022-Jun,5286,4971,315,6
Trinity County,2022-Jul,5328(P),5024(P),304(P),5.7(P)
Tyler County,2012-Jan,7599,6734,865,11.4
Tyler County,2012-Feb,7541,6728,813,10.8
Tyler County,2012-Mar,7546,6788,758,10
Tyler County,2012-Apr,7573,6842,731,9.7
Tyler County,2012-May,7620,6840,780,10.2
Tyler County,2012-Jun,7727,6852,875,11.3
Tyler County,2012-Jul,7642,6777,865,11.3
Tyler County,2012-Aug,7512,6693,819,10.9
Tyler County,2012-Sep,7533,6741,792,10.5
Tyler County,2012-Oct,7493,6724,769,10.3
Tyler County,2012-Nov,7462,6707,755,10.1
Tyler County,2012-Dec,7469,6652,817,10.9
Tyler County,2013-Jan,7577,6688,889,11.7
Tyler County,2013-Feb,7576,6757,819,10.8
Tyler County,2013-Mar,7572,6792,780,10.3
Tyler County,2013-Apr,7639,6889,750,9.8
Tyler County,2013-May,7648,6880,768,10
Tyler County,2013-Jun,7741,6886,855,11
Tyler County,2013-Jul,7650,6829,821,10.7
Tyler County,2013-Aug,7507,6711,796,10.6
Tyler County,2013-Sep,7572,6804,768,10.1
Tyler County,2013-Oct,7549,6817,732,9.7
Tyler County,2013-Nov,7480,6751,729,9.7
Tyler County,2013-Dec,7559,6849,710,9.4
Tyler County,2014-Jan,7517,6799,718,9.6
Tyler County,2014-Feb,7632,6949,683,8.9
Tyler County,2014-Mar,7692,7029,663,8.6
Tyler County,2014-Apr,7713,7133,580,7.5
Tyler County,2014-May,7694,7101,593,7.7
Tyler County,2014-Jun,7644,7014,630,8.2
Tyler County,2014-Jul,7615,6965,650,8.5
Tyler County,2014-Aug,7550,6900,650,8.6
Tyler County,2014-Sep,7569,6976,593,7.8
Tyler County,2014-Oct,7492,6960,532,7.1
Tyler County,2014-Nov,7411,6867,544,7.3
Tyler County,2014-Dec,7292,6784,508,7
Tyler County,2015-Jan,7372,6826,546,7.4
Tyler County,2015-Feb,7494,6970,524,7
Tyler County,2015-Mar,7537,7035,502,6.7
Tyler County,2015-Apr,7524,7033,491,6.5
Tyler County,2015-May,7559,7043,516,6.8
Tyler County,2015-Jun,7470,6933,537,7.2
Tyler County,2015-Jul,7382,6840,542,7.3
Tyler County,2015-Aug,7263,6741,522,7.2
Tyler County,2015-Sep,7225,6719,506,7
Tyler County,2015-Oct,7279,6775,504,6.9
Tyler County,2015-Nov,7179,6651,528,7.4
Tyler County,2015-Dec,7171,6647,524,7.3
Tyler County,2016-Jan,7037,6540,497,7.1
Tyler County,2016-Feb,7191,6691,500,7
Tyler County,2016-Mar,7234,6717,517,7.1
Tyler County,2016-Apr,7293,6818,475,6.5
Tyler County,2016-May,7280,6828,452,6.2
Tyler County,2016-Jun,7293,6731,562,7.7
Tyler County,2016-Jul,7245,6668,577,8
Tyler County,2016-Aug,7256,6689,567,7.8
Tyler County,2016-Sep,7185,6622,563,7.8
Tyler County,2016-Oct,7185,6683,502,7
Tyler County,2016-Nov,7197,6656,541,7.5
Tyler County,2016-Dec,7204,6622,582,8.1
Tyler County,2017-Jan,7127,6497,630,8.8
Tyler County,2017-Feb,7178,6600,578,8.1
Tyler County,2017-Mar,7279,6734,545,7.5
Tyler County,2017-Apr,7247,6758,489,6.7
Tyler County,2017-May,7158,6683,475,6.6
Tyler County,2017-Jun,7147,6611,536,7.5
Tyler County,2017-Jul,6933,6399,534,7.7
Tyler County,2017-Aug,6927,6367,560,8.1
Tyler County,2017-Sep,6826,6314,512,7.5
Tyler County,2017-Oct,6807,6380,427,6.3
Tyler County,2017-Nov,6813,6354,459,6.7
Tyler County,2017-Dec,6825,6330,495,7.3
Tyler County,2018-Jan,6855,6305,550,8
Tyler County,2018-Feb,6898,6374,524,7.6
Tyler County,2018-Mar,6922,6436,486,7
Tyler County,2018-Apr,6880,6424,456,6.6
Tyler County,2018-May,6937,6506,431,6.2
Tyler County,2018-Jun,6934,6457,477,6.9
Tyler County,2018-Jul,6892,6405,487,7.1
Tyler County,2018-Aug,6923,6453,470,6.8
Tyler County,2018-Sep,6984,6552,432,6.2
Tyler County,2018-Oct,6945,6554,391,5.6
Tyler County,2018-Nov,6933,6530,403,5.8
Tyler County,2018-Dec,6885,6461,424,6.2
Tyler County,2019-Jan,6981,6482,499,7.1
Tyler County,2019-Feb,7062,6638,424,6
Tyler County,2019-Mar,7077,6691,386,5.5
Tyler County,2019-Apr,6962,6632,330,4.7
Tyler County,2019-May,6972,6635,337,4.8
Tyler County,2019-Jun,7087,6655,432,6.1
Tyler County,2019-Jul,7191,6746,445,6.2
Tyler County,2019-Aug,7255,6827,428,5.9
Tyler County,2019-Sep,7106,6716,390,5.5
Tyler County,2019-Oct,7054,6695,359,5.1
Tyler County,2019-Nov,7028,6624,404,5.7
Tyler County,2019-Dec,7080,6650,430,6.1
Tyler County,2020-Jan,7287,6821,466,6.4
Tyler County,2020-Feb,7314,6914,400,5.5
Tyler County,2020-Mar,7309,6701,608,8.3
Tyler County,2020-Apr,7004,6113,891,12.7
Tyler County,2020-May,7209,6247,962,13.3
Tyler County,2020-Jun,7279,6361,918,12.6
Tyler County,2020-Jul,7328,6456,872,11.9
Tyler County,2020-Aug,7389,6650,739,10
Tyler County,2020-Sep,7343,6604,739,10.1
Tyler County,2020-Oct,7369,6739,630,8.5
Tyler County,2020-Nov,7351,6664,687,9.3
Tyler County,2020-Dec,7375,6635,740,10
Tyler County,2021-Jan,7395,6625,770,10.4
Tyler County,2021-Feb,7451,6706,745,10
Tyler County,2021-Mar,7485,6837,648,8.7
Tyler County,2021-Apr,7493,6857,636,8.5
Tyler County,2021-May,7363,6735,628,8.5
Tyler County,2021-Jun,7397,6692,705,9.5
Tyler County,2021-Jul,7416,6781,635,8.6
Tyler County,2021-Aug,7417,6800,617,8.3
Tyler County,2021-Sep,7424,6858,566,7.6
Tyler County,2021-Oct,7384,6840,544,7.4
Tyler County,2021-Nov,7350,6811,539,7.3
Tyler County,2021-Dec,7330,6802,528,7.2
Tyler County,2022-Jan,7458,6861,597,8
Tyler County,2022-Feb,7601,7035,566,7.4
Tyler County,2022-Mar,7673,7212,461,6
Tyler County,2022-Apr,7606,7169,437,5.7
Tyler County,2022-May,7479,7036,443,5.9
Tyler County,2022-Jun,7489,6993,496,6.6
Tyler County,2022-Jul,7621(P),7129(P),492(P),6.5(P)
Upshur County,2012-Jan,18643,17292,1351,7.2
Upshur County,2012-Feb,18698,17388,1310,7
Upshur County,2012-Mar,18793,17565,1228,6.5
Upshur County,2012-Apr,18838,17686,1152,6.1
Upshur County,2012-May,18749,17524,1225,6.5
Upshur County,2012-Jun,18767,17403,1364,7.3
Upshur County,2012-Jul,18722,17364,1358,7.3
Upshur County,2012-Aug,18555,17284,1271,6.8
Upshur County,2012-Sep,18602,17401,1201,6.5
Upshur County,2012-Oct,18664,17477,1187,6.4
Upshur County,2012-Nov,18642,17481,1161,6.2
Upshur County,2012-Dec,18500,17297,1203,6.5
Upshur County,2013-Jan,18539,17203,1336,7.2
Upshur County,2013-Feb,18638,17377,1261,6.8
Upshur County,2013-Mar,18613,17422,1191,6.4
Upshur County,2013-Apr,18632,17487,1145,6.1
Upshur County,2013-May,18548,17352,1196,6.4
Upshur County,2013-Jun,18638,17326,1312,7
Upshur County,2013-Jul,18593,17325,1268,6.8
Upshur County,2013-Aug,18429,17233,1196,6.5
Upshur County,2013-Sep,18444,17264,1180,6.4
Upshur County,2013-Oct,18278,17158,1120,6.1
Upshur County,2013-Nov,18369,17277,1092,5.9
Upshur County,2013-Dec,18300,17285,1015,5.5
Upshur County,2014-Jan,18326,17241,1085,5.9
Upshur County,2014-Feb,18436,17366,1070,5.8
Upshur County,2014-Mar,18455,17414,1041,5.6
Upshur County,2014-Apr,18520,17616,904,4.9
Upshur County,2014-May,18559,17600,959,5.2
Upshur County,2014-Jun,18687,17650,1037,5.5
Upshur County,2014-Jul,18688,17620,1068,5.7
Upshur County,2014-Aug,18619,17608,1011,5.4
Upshur County,2014-Sep,18668,17742,926,5
Upshur County,2014-Oct,18627,17763,864,4.6
Upshur County,2014-Nov,18609,17757,852,4.6
Upshur County,2014-Dec,18414,17644,770,4.2
Upshur County,2015-Jan,18252,17378,874,4.8
Upshur County,2015-Feb,18188,17336,852,4.7
Upshur County,2015-Mar,18060,17214,846,4.7
Upshur County,2015-Apr,18069,17176,893,4.9
Upshur County,2015-May,18037,17079,958,5.3
Upshur County,2015-Jun,17952,16927,1025,5.7
Upshur County,2015-Jul,17946,16882,1064,5.9
Upshur County,2015-Aug,17878,16873,1005,5.6
Upshur County,2015-Sep,17798,16816,982,5.5
Upshur County,2015-Oct,17856,16879,977,5.5
Upshur County,2015-Nov,17946,16973,973,5.4
Upshur County,2015-Dec,17819,16856,963,5.4
Upshur County,2016-Jan,17822,16805,1017,5.7
Upshur County,2016-Feb,17964,16966,998,5.6
Upshur County,2016-Mar,18063,17016,1047,5.8
Upshur County,2016-Apr,17986,16903,1083,6
Upshur County,2016-May,17918,16831,1087,6.1
Upshur County,2016-Jun,17989,16709,1280,7.1
Upshur County,2016-Jul,17932,16625,1307,7.3
Upshur County,2016-Aug,17951,16634,1317,7.3
Upshur County,2016-Sep,17914,16630,1284,7.2
Upshur County,2016-Oct,17849,16699,1150,6.4
Upshur County,2016-Nov,17767,16660,1107,6.2
Upshur County,2016-Dec,17679,16566,1113,6.3
Upshur County,2017-Jan,17647,16451,1196,6.8
Upshur County,2017-Feb,17750,16570,1180,6.6
Upshur County,2017-Mar,17770,16711,1059,6
Upshur County,2017-Apr,17684,16726,958,5.4
Upshur County,2017-May,17518,16617,901,5.1
Upshur County,2017-Jun,17621,16677,944,5.4
Upshur County,2017-Jul,17560,16652,908,5.2
Upshur County,2017-Aug,17539,16648,891,5.1
Upshur County,2017-Sep,17544,16732,812,4.6
Upshur County,2017-Oct,17452,16699,753,4.3
Upshur County,2017-Nov,17480,16685,795,4.5
Upshur County,2017-Dec,17498,16740,758,4.3
Upshur County,2018-Jan,17289,16468,821,4.7
Upshur County,2018-Feb,17467,16652,815,4.7
Upshur County,2018-Mar,17608,16833,775,4.4
Upshur County,2018-Apr,17599,16888,711,4
Upshur County,2018-May,17557,16867,690,3.9
Upshur County,2018-Jun,17578,16794,784,4.5
Upshur County,2018-Jul,17550,16794,756,4.3
Upshur County,2018-Aug,17470,16742,728,4.2
Upshur County,2018-Sep,17486,16780,706,4
Upshur County,2018-Oct,17499,16811,688,3.9
Upshur County,2018-Nov,17496,16796,700,4
Upshur County,2018-Dec,17461,16758,703,4
Upshur County,2019-Jan,17716,16916,800,4.5
Upshur County,2019-Feb,17781,17081,700,3.9
Upshur County,2019-Mar,17782,17127,655,3.7
Upshur County,2019-Apr,17771,17211,560,3.2
Upshur County,2019-May,17725,17164,561,3.2
Upshur County,2019-Jun,17735,17067,668,3.8
Upshur County,2019-Jul,17818,17110,708,4
Upshur County,2019-Aug,17871,17178,693,3.9
Upshur County,2019-Sep,17835,17195,640,3.6
Upshur County,2019-Oct,17827,17203,624,3.5
Upshur County,2019-Nov,17830,17166,664,3.7
Upshur County,2019-Dec,17762,17123,639,3.6
Upshur County,2020-Jan,17829,17071,758,4.3
Upshur County,2020-Feb,17877,17164,713,4
Upshur County,2020-Mar,17656,16613,1043,5.9
Upshur County,2020-Apr,16527,14801,1726,10.4
Upshur County,2020-May,17022,15171,1851,10.9
Upshur County,2020-Jun,17181,15405,1776,10.3
Upshur County,2020-Jul,17216,15557,1659,9.6
Upshur County,2020-Aug,17327,15975,1352,7.8
Upshur County,2020-Sep,17350,15991,1359,7.8
Upshur County,2020-Oct,17489,16263,1226,7
Upshur County,2020-Nov,17544,16269,1275,7.3
Upshur County,2020-Dec,17530,16217,1313,7.5
Upshur County,2021-Jan,17405,16068,1337,7.7
Upshur County,2021-Feb,17553,16246,1307,7.4
Upshur County,2021-Mar,17562,16351,1211,6.9
Upshur County,2021-Apr,17496,16386,1110,6.3
Upshur County,2021-May,17442,16364,1078,6.2
Upshur County,2021-Jun,17509,16288,1221,7
Upshur County,2021-Jul,17560,16449,1111,6.3
Upshur County,2021-Aug,17628,16567,1061,6
Upshur County,2021-Sep,17702,16697,1005,5.7
Upshur County,2021-Oct,17641,16685,956,5.4
Upshur County,2021-Nov,17631,16701,930,5.3
Upshur County,2021-Dec,17532,16670,862,4.9
Upshur County,2022-Jan,17651,16687,964,5.5
Upshur County,2022-Feb,17830,16878,952,5.3
Upshur County,2022-Mar,17787,17006,781,4.4
Upshur County,2022-Apr,17595,16870,725,4.1
Upshur County,2022-May,17610,16860,750,4.3
Upshur County,2022-Jun,17755,16893,862,4.9
Upshur County,2022-Jul,17804(P),16967(P),837(P),4.7(P)
Upton County,2012-Jan,1544,1467,77,5
Upton County,2012-Feb,1532,1465,67,4.4
Upton County,2012-Mar,1524,1464,60,3.9
Upton County,2012-Apr,1568,1511,57,3.6
Upton County,2012-May,1587,1523,64,4
Upton County,2012-Jun,1616,1549,67,4.1
Upton County,2012-Jul,1662,1590,72,4.3
Upton County,2012-Aug,1635,1571,64,3.9
Upton County,2012-Sep,1618,1558,60,3.7
Upton County,2012-Oct,1600,1542,58,3.6
Upton County,2012-Nov,1593,1533,60,3.8
Upton County,2012-Dec,1570,1512,58,3.7
Upton County,2013-Jan,1621,1549,72,4.4
Upton County,2013-Feb,1610,1542,68,4.2
Upton County,2013-Mar,1617,1551,66,4.1
Upton County,2013-Apr,1661,1596,65,3.9
Upton County,2013-May,1703,1635,68,4
Upton County,2013-Jun,1746,1665,81,4.6
Upton County,2013-Jul,1776,1697,79,4.4
Upton County,2013-Aug,1750,1674,76,4.3
Upton County,2013-Sep,1738,1662,76,4.4
Upton County,2013-Oct,1736,1670,66,3.8
Upton County,2013-Nov,1748,1681,67,3.8
Upton County,2013-Dec,1770,1707,63,3.6
Upton County,2014-Jan,1800,1736,64,3.6
Upton County,2014-Feb,1826,1755,71,3.9
Upton County,2014-Mar,1835,1772,63,3.4
Upton County,2014-Apr,1831,1777,54,2.9
Upton County,2014-May,1841,1784,57,3.1
Upton County,2014-Jun,1869,1801,68,3.6
Upton County,2014-Jul,1913,1843,70,3.7
Upton County,2014-Aug,1911,1848,63,3.3
Upton County,2014-Sep,1886,1826,60,3.2
Upton County,2014-Oct,1926,1868,58,3
Upton County,2014-Nov,1916,1864,52,2.7
Upton County,2014-Dec,1903,1855,48,2.5
Upton County,2015-Jan,1871,1813,58,3.1
Upton County,2015-Feb,1875,1816,59,3.1
Upton County,2015-Mar,1841,1783,58,3.2
Upton County,2015-Apr,1779,1719,60,3.4
Upton County,2015-May,1779,1712,67,3.8
Upton County,2015-Jun,1814,1734,80,4.4
Upton County,2015-Jul,1788,1716,72,4
Upton County,2015-Aug,1775,1704,71,4
Upton County,2015-Sep,1732,1656,76,4.4
Upton County,2015-Oct,1732,1657,75,4.3
Upton County,2015-Nov,1727,1638,89,5.2
Upton County,2015-Dec,1700,1623,77,4.5
Upton County,2016-Jan,1637,1564,73,4.5
Upton County,2016-Feb,1638,1555,83,5.1
Upton County,2016-Mar,1618,1526,92,5.7
Upton County,2016-Apr,1613,1527,86,5.3
Upton County,2016-May,1593,1510,83,5.2
Upton County,2016-Jun,1585,1490,95,6
Upton County,2016-Jul,1597,1508,89,5.6
Upton County,2016-Aug,1587,1503,84,5.3
Upton County,2016-Sep,1557,1467,90,5.8
Upton County,2016-Oct,1516,1435,81,5.3
Upton County,2016-Nov,1522,1442,80,5.3
Upton County,2016-Dec,1516,1443,73,4.8
Upton County,2017-Jan,1515,1441,74,4.9
Upton County,2017-Feb,1534,1463,71,4.6
Upton County,2017-Mar,1564,1499,65,4.2
Upton County,2017-Apr,1534,1480,54,3.5
Upton County,2017-May,1515,1456,59,3.9
Upton County,2017-Jun,1565,1508,57,3.6
Upton County,2017-Jul,1570,1511,59,3.8
Upton County,2017-Aug,1541,1486,55,3.6
Upton County,2017-Sep,1514,1463,51,3.4
Upton County,2017-Oct,1523,1474,49,3.2
Upton County,2017-Nov,1523,1469,54,3.5
Upton County,2017-Dec,1537,1488,49,3.2
Upton County,2018-Jan,1526,1470,56,3.7
Upton County,2018-Feb,1554,1496,58,3.7
Upton County,2018-Mar,1563,1512,51,3.3
Upton County,2018-Apr,1567,1514,53,3.4
Upton County,2018-May,1543,1494,49,3.2
Upton County,2018-Jun,1567,1511,56,3.6
Upton County,2018-Jul,1575,1525,50,3.2
Upton County,2018-Aug,1571,1522,49,3.1
Upton County,2018-Sep,1548,1501,47,3
Upton County,2018-Oct,1591,1533,58,3.6
Upton County,2018-Nov,1602,1543,59,3.7
Upton County,2018-Dec,1569,1510,59,3.8
Upton County,2019-Jan,1601,1533,68,4.2
Upton County,2019-Feb,1595,1542,53,3.3
Upton County,2019-Mar,1612,1561,51,3.2
Upton County,2019-Apr,1659,1612,47,2.8
Upton County,2019-May,1653,1606,47,2.8
Upton County,2019-Jun,1692,1637,55,3.3
Upton County,2019-Jul,1678,1624,54,3.2
Upton County,2019-Aug,1696,1644,52,3.1
Upton County,2019-Sep,1640,1593,47,2.9
Upton County,2019-Oct,1612,1573,39,2.4
Upton County,2019-Nov,1609,1568,41,2.5
Upton County,2019-Dec,1589,1551,38,2.4
Upton County,2020-Jan,1849,1797,52,2.8
Upton County,2020-Feb,1901,1850,51,2.7
Upton County,2020-Mar,1827,1754,73,4
Upton County,2020-Apr,1769,1662,107,6
Upton County,2020-May,1777,1640,137,7.7
Upton County,2020-Jun,1787,1640,147,8.2
Upton County,2020-Jul,1807,1673,134,7.4
Upton County,2020-Aug,1830,1719,111,6.1
Upton County,2020-Sep,1796,1689,107,6
Upton County,2020-Oct,1744,1639,105,6
Upton County,2020-Nov,1740,1634,106,6.1
Upton County,2020-Dec,1758,1658,100,5.7
Upton County,2021-Jan,1799,1694,105,5.8
Upton County,2021-Feb,1855,1743,112,6
Upton County,2021-Mar,1867,1758,109,5.8
Upton County,2021-Apr,1848,1751,97,5.2
Upton County,2021-May,1815,1723,92,5.1
Upton County,2021-Jun,1788,1690,98,5.5
Upton County,2021-Jul,1754,1660,94,5.4
Upton County,2021-Aug,1724,1633,91,5.3
Upton County,2021-Sep,1705,1624,81,4.8
Upton County,2021-Oct,1654,1576,78,4.7
Upton County,2021-Nov,1662,1590,72,4.3
Upton County,2021-Dec,1668,1597,71,4.3
Upton County,2022-Jan,1763,1684,79,4.5
Upton County,2022-Feb,1809,1728,81,4.5
Upton County,2022-Mar,1814,1746,68,3.7
Upton County,2022-Apr,1817,1754,63,3.5
Upton County,2022-May,1776,1712,64,3.6
Upton County,2022-Jun,1773,1698,75,4.2
Upton County,2022-Jul,1772(P),1706(P),66(P),3.7(P)
Uvalde County,2012-Jan,11910,10878,1032,8.7
Uvalde County,2012-Feb,11840,10827,1013,8.6
Uvalde County,2012-Mar,11932,10933,999,8.4
Uvalde County,2012-Apr,11938,11067,871,7.3
Uvalde County,2012-May,11969,11079,890,7.4
Uvalde County,2012-Jun,12167,11155,1012,8.3
Uvalde County,2012-Jul,12254,11215,1039,8.5
Uvalde County,2012-Aug,12087,11085,1002,8.3
Uvalde County,2012-Sep,11977,11095,882,7.4
Uvalde County,2012-Oct,11675,10835,840,7.2
Uvalde County,2012-Nov,11684,10840,844,7.2
Uvalde County,2012-Dec,11651,10774,877,7.5
Uvalde County,2013-Jan,11807,10830,977,8.3
Uvalde County,2013-Feb,11754,10835,919,7.8
Uvalde County,2013-Mar,11795,10895,900,7.6
Uvalde County,2013-Apr,11874,11064,810,6.8
Uvalde County,2013-May,12101,11260,841,6.9
Uvalde County,2013-Jun,12280,11382,898,7.3
Uvalde County,2013-Jul,12147,11248,899,7.4
Uvalde County,2013-Aug,12074,11224,850,7
Uvalde County,2013-Sep,11987,11207,780,6.5
Uvalde County,2013-Oct,11841,11080,761,6.4
Uvalde County,2013-Nov,11719,10973,746,6.4
Uvalde County,2013-Dec,11748,11033,715,6.1
Uvalde County,2014-Jan,11502,10749,753,6.5
Uvalde County,2014-Feb,11637,10884,753,6.5
Uvalde County,2014-Mar,11753,11005,748,6.4
Uvalde County,2014-Apr,11628,11013,615,5.3
Uvalde County,2014-May,11723,11099,624,5.3
Uvalde County,2014-Jun,11861,11158,703,5.9
Uvalde County,2014-Jul,11816,11059,757,6.4
Uvalde County,2014-Aug,11760,11028,732,6.2
Uvalde County,2014-Sep,11717,11076,641,5.5
Uvalde County,2014-Oct,11629,11026,603,5.2
Uvalde County,2014-Nov,11570,10970,600,5.2
Uvalde County,2014-Dec,11448,10895,553,4.8
Uvalde County,2015-Jan,11568,10952,616,5.3
Uvalde County,2015-Feb,11660,11069,591,5.1
Uvalde County,2015-Mar,11768,11197,571,4.9
Uvalde County,2015-Apr,11640,11126,514,4.4
Uvalde County,2015-May,11797,11244,553,4.7
Uvalde County,2015-Jun,11872,11259,613,5.2
Uvalde County,2015-Jul,11787,11140,647,5.5
Uvalde County,2015-Aug,11619,11010,609,5.2
Uvalde County,2015-Sep,11696,11105,591,5.1
Uvalde County,2015-Oct,11707,11118,589,5
Uvalde County,2015-Nov,11583,10966,617,5.3
Uvalde County,2015-Dec,11544,10931,613,5.3
Uvalde County,2016-Jan,11431,10795,636,5.6
Uvalde County,2016-Feb,11703,11066,637,5.4
Uvalde County,2016-Mar,11868,11241,627,5.3
Uvalde County,2016-Apr,11897,11300,597,5
Uvalde County,2016-May,12016,11455,561,4.7
Uvalde County,2016-Jun,12085,11429,656,5.4
Uvalde County,2016-Jul,11996,11324,672,5.6
Uvalde County,2016-Aug,12051,11403,648,5.4
Uvalde County,2016-Sep,11837,11197,640,5.4
Uvalde County,2016-Oct,11645,11015,630,5.4
Uvalde County,2016-Nov,11633,11014,619,5.3
Uvalde County,2016-Dec,11597,10973,624,5.4
Uvalde County,2017-Jan,11523,10861,662,5.7
Uvalde County,2017-Feb,11606,10968,638,5.5
Uvalde County,2017-Mar,11798,11222,576,4.9
Uvalde County,2017-Apr,11784,11264,520,4.4
Uvalde County,2017-May,11820,11303,517,4.4
Uvalde County,2017-Jun,11985,11401,584,4.9
Uvalde County,2017-Jul,11827,11248,579,4.9
Uvalde County,2017-Aug,11826,11243,583,4.9
Uvalde County,2017-Sep,11476,10977,499,4.3
Uvalde County,2017-Oct,11339,10881,458,4
Uvalde County,2017-Nov,11213,10724,489,4.4
Uvalde County,2017-Dec,11209,10734,475,4.2
Uvalde County,2018-Jan,11234,10720,514,4.6
Uvalde County,2018-Feb,11399,10872,527,4.6
Uvalde County,2018-Mar,11570,11077,493,4.3
Uvalde County,2018-Apr,11380,10936,444,3.9
Uvalde County,2018-May,11424,10987,437,3.8
Uvalde County,2018-Jun,11626,11081,545,4.7
Uvalde County,2018-Jul,11522,10988,534,4.6
Uvalde County,2018-Aug,11447,10942,505,4.4
Uvalde County,2018-Sep,11273,10782,491,4.4
Uvalde County,2018-Oct,11153,10693,460,4.1
Uvalde County,2018-Nov,11154,10702,452,4.1
Uvalde County,2018-Dec,11112,10648,464,4.2
Uvalde County,2019-Jan,11087,10554,533,4.8
Uvalde County,2019-Feb,11211,10730,481,4.3
Uvalde County,2019-Mar,11347,10913,434,3.8
Uvalde County,2019-Apr,11344,10966,378,3.3
Uvalde County,2019-May,11421,11042,379,3.3
Uvalde County,2019-Jun,11575,11103,472,4.1
Uvalde County,2019-Jul,11546,11068,478,4.1
Uvalde County,2019-Aug,11551,11108,443,3.8
Uvalde County,2019-Sep,11386,10980,406,3.6
Uvalde County,2019-Oct,11362,10969,393,3.5
Uvalde County,2019-Nov,11137,10753,384,3.4
Uvalde County,2019-Dec,11192,10824,368,3.3
Uvalde County,2020-Jan,11160,10744,416,3.7
Uvalde County,2020-Feb,11367,10985,382,3.4
Uvalde County,2020-Mar,11323,10750,573,5.1
Uvalde County,2020-Apr,10579,9629,950,9
Uvalde County,2020-May,11102,10156,946,8.5
Uvalde County,2020-Jun,11400,10480,920,8.1
Uvalde County,2020-Jul,11332,10449,883,7.8
Uvalde County,2020-Aug,11348,10614,734,6.5
Uvalde County,2020-Sep,11225,10500,725,6.5
Uvalde County,2020-Oct,11280,10618,662,5.9
Uvalde County,2020-Nov,11211,10494,717,6.4
Uvalde County,2020-Dec,11166,10440,726,6.5
Uvalde County,2021-Jan,11126,10371,755,6.8
Uvalde County,2021-Feb,11239,10486,753,6.7
Uvalde County,2021-Mar,11429,10727,702,6.1
Uvalde County,2021-Apr,11424,10776,648,5.7
Uvalde County,2021-May,11278,10673,605,5.4
Uvalde County,2021-Jun,11419,10687,732,6.4
Uvalde County,2021-Jul,11396,10753,643,5.6
Uvalde County,2021-Aug,11382,10797,585,5.1
Uvalde County,2021-Sep,11218,10679,539,4.8
Uvalde County,2021-Oct,11130,10603,527,4.7
Uvalde County,2021-Nov,11010,10513,497,4.5
Uvalde County,2021-Dec,10964,10501,463,4.2
Uvalde County,2022-Jan,10949,10415,534,4.9
Uvalde County,2022-Feb,11212,10667,545,4.9
Uvalde County,2022-Mar,11444,11002,442,3.9
Uvalde County,2022-Apr,11141,10716,425,3.8
Uvalde County,2022-May,11201,10762,439,3.9
Uvalde County,2022-Jun,11319,10782,537,4.7
Uvalde County,2022-Jul,11423(P),10876(P),547(P),4.8(P)
Val Verde County,2012-Jan,20275,18559,1716,8.5
Val Verde County,2012-Feb,20152,18513,1639,8.1
Val Verde County,2012-Mar,20158,18640,1518,7.5
Val Verde County,2012-Apr,19947,18508,1439,7.2
Val Verde County,2012-May,20054,18550,1504,7.5
Val Verde County,2012-Jun,20113,18474,1639,8.1
Val Verde County,2012-Jul,19826,18250,1576,7.9
Val Verde County,2012-Aug,19570,18083,1487,7.6
Val Verde County,2012-Sep,19839,18441,1398,7
Val Verde County,2012-Oct,19841,18447,1394,7
Val Verde County,2012-Nov,19849,18474,1375,6.9
Val Verde County,2012-Dec,19951,18481,1470,7.4
Val Verde County,2013-Jan,19851,18180,1671,8.4
Val Verde County,2013-Feb,19766,18162,1604,8.1
Val Verde County,2013-Mar,19692,18214,1478,7.5
Val Verde County,2013-Apr,19684,18280,1404,7.1
Val Verde County,2013-May,19671,18249,1422,7.2
Val Verde County,2013-Jun,19824,18273,1551,7.8
Val Verde County,2013-Jul,19918,17993,1925,9.7
Val Verde County,2013-Aug,19315,17919,1396,7.2
Val Verde County,2013-Sep,19516,18179,1337,6.9
Val Verde County,2013-Oct,19290,17993,1297,6.7
Val Verde County,2013-Nov,19259,18006,1253,6.5
Val Verde County,2013-Dec,19345,18159,1186,6.1
Val Verde County,2014-Jan,19577,18289,1288,6.6
Val Verde County,2014-Feb,19690,18399,1291,6.6
Val Verde County,2014-Mar,19617,18405,1212,6.2
Val Verde County,2014-Apr,19533,18465,1068,5.5
Val Verde County,2014-May,19532,18433,1099,5.6
Val Verde County,2014-Jun,19500,18330,1170,6
Val Verde County,2014-Jul,19231,18010,1221,6.3
Val Verde County,2014-Aug,19078,17894,1184,6.2
Val Verde County,2014-Sep,19257,18184,1073,5.6
Val Verde County,2014-Oct,19175,18193,982,5.1
Val Verde County,2014-Nov,19086,18094,992,5.2
Val Verde County,2014-Dec,19014,18070,944,5
Val Verde County,2015-Jan,19359,18241,1118,5.8
Val Verde County,2015-Feb,19442,18305,1137,5.8
Val Verde County,2015-Mar,19497,18332,1165,6
Val Verde County,2015-Apr,19610,18458,1152,5.9
Val Verde County,2015-May,19649,18470,1179,6
Val Verde County,2015-Jun,19811,18558,1253,6.3
Val Verde County,2015-Jul,19558,18304,1254,6.4
Val Verde County,2015-Aug,19510,18316,1194,6.1
Val Verde County,2015-Sep,19570,18396,1174,6
Val Verde County,2015-Oct,19597,18403,1194,6.1
Val Verde County,2015-Nov,19705,18502,1203,6.1
Val Verde County,2015-Dec,19666,18489,1177,6
Val Verde County,2016-Jan,19797,18545,1252,6.3
Val Verde County,2016-Feb,20116,18857,1259,6.3
Val Verde County,2016-Mar,20213,18911,1302,6.4
Val Verde County,2016-Apr,20197,18942,1255,6.2
Val Verde County,2016-May,20423,19232,1191,5.8
Val Verde County,2016-Jun,20224,18906,1318,6.5
Val Verde County,2016-Jul,19949,18654,1295,6.5
Val Verde County,2016-Aug,19942,18647,1295,6.5
Val Verde County,2016-Sep,20226,18926,1300,6.4
Val Verde County,2016-Oct,20169,18941,1228,6.1
Val Verde County,2016-Nov,20286,19085,1201,5.9
Val Verde County,2016-Dec,20223,18997,1226,6.1
Val Verde County,2017-Jan,20083,18793,1290,6.4
Val Verde County,2017-Feb,19984,18728,1256,6.3
Val Verde County,2017-Mar,20041,18922,1119,5.6
Val Verde County,2017-Apr,20016,18995,1021,5.1
Val Verde County,2017-May,19967,18996,971,4.9
Val Verde County,2017-Jun,20098,19095,1003,5
Val Verde County,2017-Jul,19663,18500,1163,5.9
Val Verde County,2017-Aug,19770,18779,991,5
Val Verde County,2017-Sep,19922,19028,894,4.5
Val Verde County,2017-Oct,19826,19004,822,4.1
Val Verde County,2017-Nov,20014,19138,876,4.4
Val Verde County,2017-Dec,19942,19079,863,4.3
Val Verde County,2018-Jan,22286,21320,966,4.3
Val Verde County,2018-Feb,22271,21284,987,4.4
Val Verde County,2018-Mar,22215,21250,965,4.3
Val Verde County,2018-Apr,22312,21405,907,4.1
Val Verde County,2018-May,22230,21379,851,3.8
Val Verde County,2018-Jun,22265,21355,910,4.1
Val Verde County,2018-Jul,22078,21210,868,3.9
Val Verde County,2018-Aug,22023,21200,823,3.7
Val Verde County,2018-Sep,22187,21378,809,3.6
Val Verde County,2018-Oct,22184,21407,777,3.5
Val Verde County,2018-Nov,22182,21426,756,3.4
Val Verde County,2018-Dec,22260,21471,789,3.5
Val Verde County,2019-Jan,22243,21351,892,4
Val Verde County,2019-Feb,22268,21456,812,3.6
Val Verde County,2019-Mar,22426,21670,756,3.4
Val Verde County,2019-Apr,22565,21924,641,2.8
Val Verde County,2019-May,22688,22006,682,3
Val Verde County,2019-Jun,22871,22088,783,3.4
Val Verde County,2019-Jul,22640,21852,788,3.5
Val Verde County,2019-Aug,22564,21834,730,3.2
Val Verde County,2019-Sep,22666,21958,708,3.1
Val Verde County,2019-Oct,22723,22004,719,3.2
Val Verde County,2019-Nov,22757,22003,754,3.3
Val Verde County,2019-Dec,22927,22136,791,3.5
Val Verde County,2020-Jan,21109,20181,928,4.4
Val Verde County,2020-Feb,21008,20139,869,4.1
Val Verde County,2020-Mar,20760,19446,1314,6.3
Val Verde County,2020-Apr,19836,17254,2582,13
Val Verde County,2020-May,20860,17947,2913,14
Val Verde County,2020-Jun,21033,18505,2528,12
Val Verde County,2020-Jul,21630,19489,2141,9.9
Val Verde County,2020-Aug,21669,19934,1735,8
Val Verde County,2020-Sep,22018,20324,1694,7.7
Val Verde County,2020-Oct,21937,20420,1517,6.9
Val Verde County,2020-Nov,22203,20641,1562,7
Val Verde County,2020-Dec,22200,20627,1573,7.1
Val Verde County,2021-Jan,21919,20283,1636,7.5
Val Verde County,2021-Feb,21993,20415,1578,7.2
Val Verde County,2021-Mar,21890,20433,1457,6.7
Val Verde County,2021-Apr,22039,20691,1348,6.1
Val Verde County,2021-May,22080,20771,1309,5.9
Val Verde County,2021-Jun,22379,20914,1465,6.5
Val Verde County,2021-Jul,22192,20895,1297,5.8
Val Verde County,2021-Aug,21930,20728,1202,5.5
Val Verde County,2021-Sep,22133,20984,1149,5.2
Val Verde County,2021-Oct,22087,20934,1153,5.2
Val Verde County,2021-Nov,22272,21160,1112,5
Val Verde County,2021-Dec,22256,21206,1050,4.7
Val Verde County,2022-Jan,21992,20780,1212,5.5
Val Verde County,2022-Feb,22103,20901,1202,5.4
Val Verde County,2022-Mar,22082,21111,971,4.4
Val Verde County,2022-Apr,21922,21008,914,4.2
Val Verde County,2022-May,21813,20880,933,4.3
Val Verde County,2022-Jun,21991,20972,1019,4.6
Val Verde County,2022-Jul,22250(P),21128(P),1122(P),5.0(P)
Van Zandt County,2012-Jan,23494,21745,1749,7.4
Van Zandt County,2012-Feb,23416,21725,1691,7.2
Van Zandt County,2012-Mar,23407,21829,1578,6.7
Van Zandt County,2012-Apr,23418,21909,1509,6.4
Van Zandt County,2012-May,23526,21923,1603,6.8
Van Zandt County,2012-Jun,23876,22091,1785,7.5
Van Zandt County,2012-Jul,23733,21963,1770,7.5
Van Zandt County,2012-Aug,23575,21900,1675,7.1
Van Zandt County,2012-Sep,23527,21970,1557,6.6
Van Zandt County,2012-Oct,23634,22099,1535,6.5
Van Zandt County,2012-Nov,23597,22113,1484,6.3
Van Zandt County,2012-Dec,23542,21991,1551,6.6
Van Zandt County,2013-Jan,23656,21942,1714,7.2
Van Zandt County,2013-Feb,23575,21984,1591,6.7
Van Zandt County,2013-Mar,23571,22028,1543,6.5
Van Zandt County,2013-Apr,23650,22184,1466,6.2
Van Zandt County,2013-May,23739,22196,1543,6.5
Van Zandt County,2013-Jun,24179,22464,1715,7.1
Van Zandt County,2013-Jul,24216,22549,1667,6.9
Van Zandt County,2013-Aug,24007,22423,1584,6.6
Van Zandt County,2013-Sep,23921,22313,1608,6.7
Van Zandt County,2013-Oct,23747,22233,1514,6.4
Van Zandt County,2013-Nov,23748,22307,1441,6.1
Van Zandt County,2013-Dec,23630,22240,1390,5.9
Van Zandt County,2014-Jan,23585,22142,1443,6.1
Van Zandt County,2014-Feb,23782,22294,1488,6.3
Van Zandt County,2014-Mar,23805,22408,1397,5.9
Van Zandt County,2014-Apr,23833,22639,1194,5
Van Zandt County,2014-May,24012,22746,1266,5.3
Van Zandt County,2014-Jun,24202,22835,1367,5.6
Van Zandt County,2014-Jul,24084,22691,1393,5.8
Van Zandt County,2014-Aug,23995,22647,1348,5.6
Van Zandt County,2014-Sep,23800,22576,1224,5.1
Van Zandt County,2014-Oct,23822,22700,1122,4.7
Van Zandt County,2014-Nov,23902,22788,1114,4.7
Van Zandt County,2014-Dec,23598,22597,1001,4.2
Van Zandt County,2015-Jan,23851,22724,1127,4.7
Van Zandt County,2015-Feb,23958,22848,1110,4.6
Van Zandt County,2015-Mar,24017,22957,1060,4.4
Van Zandt County,2015-Apr,24210,23178,1032,4.3
Van Zandt County,2015-May,24298,23206,1092,4.5
Van Zandt County,2015-Jun,24666,23477,1189,4.8
Van Zandt County,2015-Jul,24630,23421,1209,4.9
Van Zandt County,2015-Aug,24384,23252,1132,4.6
Van Zandt County,2015-Sep,24211,23124,1087,4.5
Van Zandt County,2015-Oct,24193,23120,1073,4.4
Van Zandt County,2015-Nov,24176,23121,1055,4.4
Van Zandt County,2015-Dec,24062,23061,1001,4.2
Van Zandt County,2016-Jan,24117,23078,1039,4.3
Van Zandt County,2016-Feb,24501,23456,1045,4.3
Van Zandt County,2016-Mar,24637,23591,1046,4.2
Van Zandt County,2016-Apr,24637,23658,979,4
Van Zandt County,2016-May,24895,23917,978,3.9
Van Zandt County,2016-Jun,25367,24172,1195,4.7
Van Zandt County,2016-Jul,25267,24058,1209,4.8
Van Zandt County,2016-Aug,25243,24114,1129,4.5
Van Zandt County,2016-Sep,24977,23836,1141,4.6
Van Zandt County,2016-Oct,24864,23801,1063,4.3
Van Zandt County,2016-Nov,24938,23921,1017,4.1
Van Zandt County,2016-Dec,24903,23895,1008,4
Van Zandt County,2017-Jan,24817,23722,1095,4.4
Van Zandt County,2017-Feb,24974,23908,1066,4.3
Van Zandt County,2017-Mar,25182,24198,984,3.9
Van Zandt County,2017-Apr,25030,24145,885,3.5
Van Zandt County,2017-May,25229,24340,889,3.5
Van Zandt County,2017-Jun,25602,24596,1006,3.9
Van Zandt County,2017-Jul,25514,24501,1013,4
Van Zandt County,2017-Aug,25413,24401,1012,4
Van Zandt County,2017-Sep,25154,24236,918,3.6
Van Zandt County,2017-Oct,25051,24214,837,3.3
Van Zandt County,2017-Nov,25197,24304,893,3.5
Van Zandt County,2017-Dec,25195,24340,855,3.4
Van Zandt County,2018-Jan,25040,24089,951,3.8
Van Zandt County,2018-Feb,25270,24333,937,3.7
Van Zandt County,2018-Mar,25454,24534,920,3.6
Van Zandt County,2018-Apr,25543,24704,839,3.3
Van Zandt County,2018-May,25788,24936,852,3.3
Van Zandt County,2018-Jun,25984,24975,1009,3.9
Van Zandt County,2018-Jul,25803,24826,977,3.8
Van Zandt County,2018-Aug,25654,24730,924,3.6
Van Zandt County,2018-Sep,25458,24574,884,3.5
Van Zandt County,2018-Oct,25323,24480,843,3.3
Van Zandt County,2018-Nov,25380,24537,843,3.3
Van Zandt County,2018-Dec,25391,24550,841,3.3
Van Zandt County,2019-Jan,25412,24442,970,3.8
Van Zandt County,2019-Feb,25618,24709,909,3.5
Van Zandt County,2019-Mar,25721,24858,863,3.4
Van Zandt County,2019-Apr,25631,24907,724,2.8
Van Zandt County,2019-May,25747,25028,719,2.8
Van Zandt County,2019-Jun,26157,25260,897,3.4
Van Zandt County,2019-Jul,26091,25162,929,3.6
Van Zandt County,2019-Aug,26092,25198,894,3.4
Van Zandt County,2019-Sep,25843,25012,831,3.2
Van Zandt County,2019-Oct,25873,25075,798,3.1
Van Zandt County,2019-Nov,25845,25047,798,3.1
Van Zandt County,2019-Dec,25782,25006,776,3
Van Zandt County,2020-Jan,25925,25027,898,3.5
Van Zandt County,2020-Feb,26155,25296,859,3.3
Van Zandt County,2020-Mar,25689,24403,1286,5
Van Zandt County,2020-Apr,24112,21868,2244,9.3
Van Zandt County,2020-May,25052,22811,2241,8.9
Van Zandt County,2020-Jun,25982,23838,2144,8.3
Van Zandt County,2020-Jul,26241,24294,1947,7.4
Van Zandt County,2020-Aug,26506,24929,1577,5.9
Van Zandt County,2020-Sep,26224,24669,1555,5.9
Van Zandt County,2020-Oct,26199,24800,1399,5.3
Van Zandt County,2020-Nov,26204,24732,1472,5.6
Van Zandt County,2020-Dec,26207,24746,1461,5.6
Van Zandt County,2021-Jan,26354,24791,1563,5.9
Van Zandt County,2021-Feb,26544,25024,1520,5.7
Van Zandt County,2021-Mar,26750,25289,1461,5.5
Van Zandt County,2021-Apr,26619,25339,1280,4.8
Van Zandt County,2021-May,26748,25494,1254,4.7
Van Zandt County,2021-Jun,27031,25588,1443,5.3
Van Zandt County,2021-Jul,27046,25760,1286,4.8
Van Zandt County,2021-Aug,27062,25851,1211,4.5
Van Zandt County,2021-Sep,26915,25781,1134,4.2
Van Zandt County,2021-Oct,26771,25685,1086,4.1
Van Zandt County,2021-Nov,26820,25795,1025,3.8
Van Zandt County,2021-Dec,26706,25784,922,3.5
Van Zandt County,2022-Jan,26832,25771,1061,4
Van Zandt County,2022-Feb,27200,26137,1063,3.9
Van Zandt County,2022-Mar,27461,26597,864,3.1
Van Zandt County,2022-Apr,27260,26462,798,2.9
Van Zandt County,2022-May,27490,26598,892,3.2
Van Zandt County,2022-Jun,27743,26713,1030,3.7
Van Zandt County,2022-Jul,27866(P),26848(P),1018(P),3.7(P)
Victoria County,2012-Jan,44328,41618,2710,6.1
Victoria County,2012-Feb,44620,42000,2620,5.9
Victoria County,2012-Mar,44635,42211,2424,5.4
Victoria County,2012-Apr,44665,42379,2286,5.1
Victoria County,2012-May,44824,42414,2410,5.4
Victoria County,2012-Jun,45332,42586,2746,6.1
Victoria County,2012-Jul,45475,42700,2775,6.1
Victoria County,2012-Aug,45190,42660,2530,5.6
Victoria County,2012-Sep,45603,43245,2358,5.2
Victoria County,2012-Oct,45654,43311,2343,5.1
Victoria County,2012-Nov,45648,43219,2429,5.3
Victoria County,2012-Dec,45768,43306,2462,5.4
Victoria County,2013-Jan,45054,42307,2747,6.1
Victoria County,2013-Feb,45093,42544,2549,5.7
Victoria County,2013-Mar,45053,42612,2441,5.4
Victoria County,2013-Apr,45472,43121,2351,5.2
Victoria County,2013-May,45831,43327,2504,5.5
Victoria County,2013-Jun,46046,43279,2767,6
Victoria County,2013-Jul,46191,43506,2685,5.8
Victoria County,2013-Aug,46234,43766,2468,5.3
Victoria County,2013-Sep,46202,43779,2423,5.2
Victoria County,2013-Oct,45769,43465,2304,5
Victoria County,2013-Nov,46019,43807,2212,4.8
Victoria County,2013-Dec,45952,43885,2067,4.5
Victoria County,2014-Jan,45570,43430,2140,4.7
Victoria County,2014-Feb,45861,43685,2176,4.7
Victoria County,2014-Mar,46024,43946,2078,4.5
Victoria County,2014-Apr,45943,44149,1794,3.9
Victoria County,2014-May,46111,44154,1957,4.2
Victoria County,2014-Jun,46271,44123,2148,4.6
Victoria County,2014-Jul,46304,44109,2195,4.7
Victoria County,2014-Aug,46456,44392,2064,4.4
Victoria County,2014-Sep,46495,44605,1890,4.1
Victoria County,2014-Oct,46498,44786,1712,3.7
Victoria County,2014-Nov,46455,44765,1690,3.6
Victoria County,2014-Dec,46272,44741,1531,3.3
Victoria County,2015-Jan,45839,44069,1770,3.9
Victoria County,2015-Feb,45840,44069,1771,3.9
Victoria County,2015-Mar,45531,43757,1774,3.9
Victoria County,2015-Apr,45746,44049,1697,3.7
Victoria County,2015-May,45743,43873,1870,4.1
Victoria County,2015-Jun,45529,43445,2084,4.6
Victoria County,2015-Jul,45338,43222,2116,4.7
Victoria County,2015-Aug,45216,43245,1971,4.4
Victoria County,2015-Sep,45022,43019,2003,4.4
Victoria County,2015-Oct,44852,42848,2004,4.5
Victoria County,2015-Nov,44899,42906,1993,4.4
Victoria County,2015-Dec,44642,42743,1899,4.3
Victoria County,2016-Jan,44242,42223,2019,4.6
Victoria County,2016-Feb,44257,42176,2081,4.7
Victoria County,2016-Mar,44089,41853,2236,5.1
Victoria County,2016-Apr,43926,41674,2252,5.1
Victoria County,2016-May,43650,41400,2250,5.2
Victoria County,2016-Jun,43523,40897,2626,6
Victoria County,2016-Jul,43819,41157,2662,6.1
Victoria County,2016-Aug,43763,41093,2670,6.1
Victoria County,2016-Sep,43716,41108,2608,6
Victoria County,2016-Oct,43274,40856,2418,5.6
Victoria County,2016-Nov,43393,41030,2363,5.4
Victoria County,2016-Dec,43129,40814,2315,5.4
Victoria County,2017-Jan,42743,40198,2545,6
Victoria County,2017-Feb,42982,40531,2451,5.7
Victoria County,2017-Mar,42958,40758,2200,5.1
Victoria County,2017-Apr,42956,40927,2029,4.7
Victoria County,2017-May,42687,40742,1945,4.6
Victoria County,2017-Jun,42781,40651,2130,5
Victoria County,2017-Jul,42652,40565,2087,4.9
Victoria County,2017-Aug,42488,40412,2076,4.9
Victoria County,2017-Sep,42422,40361,2061,4.9
Victoria County,2017-Oct,42142,40311,1831,4.3
Victoria County,2017-Nov,42427,40563,1864,4.4
Victoria County,2017-Dec,42349,40628,1721,4.1
Victoria County,2018-Jan,42314,40423,1891,4.5
Victoria County,2018-Feb,42708,40877,1831,4.3
Victoria County,2018-Mar,42625,40882,1743,4.1
Victoria County,2018-Apr,42716,41126,1590,3.7
Victoria County,2018-May,42558,41027,1531,3.6
Victoria County,2018-Jun,42673,40875,1798,4.2
Victoria County,2018-Jul,42649,40952,1697,4
Victoria County,2018-Aug,42352,40716,1636,3.9
Victoria County,2018-Sep,42497,40920,1577,3.7
Victoria County,2018-Oct,42350,40878,1472,3.5
Victoria County,2018-Nov,42572,41078,1494,3.5
Victoria County,2018-Dec,42537,41041,1496,3.5
Victoria County,2019-Jan,42392,40738,1654,3.9
Victoria County,2019-Feb,42548,41016,1532,3.6
Victoria County,2019-Mar,42337,40883,1454,3.4
Victoria County,2019-Apr,41782,40533,1249,3
Victoria County,2019-May,41842,40551,1291,3.1
Victoria County,2019-Jun,41992,40455,1537,3.7
Victoria County,2019-Jul,42010,40449,1561,3.7
Victoria County,2019-Aug,41927,40436,1491,3.6
Victoria County,2019-Sep,41912,40482,1430,3.4
Victoria County,2019-Oct,41507,40106,1401,3.4
Victoria County,2019-Nov,41401,39923,1478,3.6
Victoria County,2019-Dec,41360,39964,1396,3.4
Victoria County,2020-Jan,41179,39581,1598,3.9
Victoria County,2020-Feb,41039,39522,1517,3.7
Victoria County,2020-Mar,40521,38169,2352,5.8
Victoria County,2020-Apr,39410,34156,5254,13.3
Victoria County,2020-May,39997,35194,4803,12
Victoria County,2020-Jun,40414,36086,4328,10.7
Victoria County,2020-Jul,40744,36105,4639,11.4
Victoria County,2020-Aug,40457,36970,3487,8.6
Victoria County,2020-Sep,40758,37409,3349,8.2
Victoria County,2020-Oct,40723,37727,2996,7.4
Victoria County,2020-Nov,40882,37762,3120,7.6
Victoria County,2020-Dec,41012,37918,3094,7.5
Victoria County,2021-Jan,41013,37770,3243,7.9
Victoria County,2021-Feb,41152,37977,3175,7.7
Victoria County,2021-Mar,40889,37985,2904,7.1
Victoria County,2021-Apr,40424,37759,2665,6.6
Victoria County,2021-May,40313,37734,2579,6.4
Victoria County,2021-Jun,40480,37615,2865,7.1
Victoria County,2021-Jul,40443,37821,2622,6.5
Victoria County,2021-Aug,40424,37938,2486,6.1
Victoria County,2021-Sep,40936,38575,2361,5.8
Victoria County,2021-Oct,41035,38781,2254,5.5
Victoria County,2021-Nov,41157,39006,2151,5.2
Victoria County,2021-Dec,41150,39141,2009,4.9
Victoria County,2022-Jan,40740,38471,2269,5.6
Victoria County,2022-Feb,41019,38791,2228,5.4
Victoria County,2022-Mar,41000,39217,1783,4.3
Victoria County,2022-Apr,40586,38912,1674,4.1
Victoria County,2022-May,40333,38573,1760,4.4
Victoria County,2022-Jun,40317,38329,1988,4.9
Victoria County,2022-Jul,40342(P),38425(P),1917(P),4.8(P)
Walker County,2012-Jan,22831,21134,1697,7.4
Walker County,2012-Feb,23019,21392,1627,7.1
Walker County,2012-Mar,22936,21431,1505,6.6
Walker County,2012-Apr,23088,21661,1427,6.2
Walker County,2012-May,23130,21596,1534,6.6
Walker County,2012-Jun,23404,21577,1827,7.8
Walker County,2012-Jul,23267,21425,1842,7.9
Walker County,2012-Aug,23009,21291,1718,7.5
Walker County,2012-Sep,23183,21652,1531,6.6
Walker County,2012-Oct,23269,21760,1509,6.5
Walker County,2012-Nov,23108,21634,1474,6.4
Walker County,2012-Dec,22931,21463,1468,6.4
Walker County,2013-Jan,23176,21501,1675,7.2
Walker County,2013-Feb,23084,21552,1532,6.6
Walker County,2013-Mar,23059,21585,1474,6.4
Walker County,2013-Apr,23148,21750,1398,6
Walker County,2013-May,23266,21693,1573,6.8
Walker County,2013-Jun,23378,21590,1788,7.6
Walker County,2013-Jul,23065,21334,1731,7.5
Walker County,2013-Aug,22948,21331,1617,7
Walker County,2013-Sep,23253,21733,1520,6.5
Walker County,2013-Oct,22983,21532,1451,6.3
Walker County,2013-Nov,22828,21439,1389,6.1
Walker County,2013-Dec,22736,21430,1306,5.7
Walker County,2014-Jan,22845,21488,1357,5.9
Walker County,2014-Feb,23124,21736,1388,6
Walker County,2014-Mar,23079,21759,1320,5.7
Walker County,2014-Apr,23055,21915,1140,4.9
Walker County,2014-May,23217,21939,1278,5.5
Walker County,2014-Jun,23355,21934,1421,6.1
Walker County,2014-Jul,23197,21694,1503,6.5
Walker County,2014-Aug,22947,21587,1360,5.9
Walker County,2014-Sep,23268,22042,1226,5.3
Walker County,2014-Oct,23182,22045,1137,4.9
Walker County,2014-Nov,23208,22088,1120,4.8
Walker County,2014-Dec,23013,21983,1030,4.5
Walker County,2015-Jan,22839,21683,1156,5.1
Walker County,2015-Feb,22955,21855,1100,4.8
Walker County,2015-Mar,22867,21776,1091,4.8
Walker County,2015-Apr,23019,22002,1017,4.4
Walker County,2015-May,23091,21911,1180,5.1
Walker County,2015-Jun,23177,21890,1287,5.6
Walker County,2015-Jul,22709,21378,1331,5.9
Walker County,2015-Aug,22754,21488,1266,5.6
Walker County,2015-Sep,22992,21783,1209,5.3
Walker County,2015-Oct,23176,22021,1155,5
Walker County,2015-Nov,23240,22066,1174,5.1
Walker County,2015-Dec,23035,21946,1089,4.7
Walker County,2016-Jan,23352,22193,1159,5
Walker County,2016-Feb,23677,22503,1174,5
Walker County,2016-Mar,23569,22381,1188,5
Walker County,2016-Apr,23913,22787,1126,4.7
Walker County,2016-May,23798,22620,1178,4.9
Walker County,2016-Jun,23889,22491,1398,5.9
Walker County,2016-Jul,23725,22297,1428,6
Walker County,2016-Aug,23862,22463,1399,5.9
Walker County,2016-Sep,24049,22711,1338,5.6
Walker County,2016-Oct,23977,22748,1229,5.1
Walker County,2016-Nov,23996,22804,1192,5
Walker County,2016-Dec,23746,22560,1186,5
Walker County,2017-Jan,23600,22326,1274,5.4
Walker County,2017-Feb,23830,22564,1266,5.3
Walker County,2017-Mar,23836,22704,1132,4.7
Walker County,2017-Apr,23708,22687,1021,4.3
Walker County,2017-May,23539,22500,1039,4.4
Walker County,2017-Jun,23450,22240,1210,5.2
Walker County,2017-Jul,23159,21959,1200,5.2
Walker County,2017-Aug,23291,22131,1160,5
Walker County,2017-Sep,23498,22461,1037,4.4
Walker County,2017-Oct,23449,22530,919,3.9
Walker County,2017-Nov,23509,22528,981,4.2
Walker County,2017-Dec,23282,22341,941,4
Walker County,2018-Jan,23491,22399,1092,4.6
Walker County,2018-Feb,23642,22569,1073,4.5
Walker County,2018-Mar,23518,22484,1034,4.4
Walker County,2018-Apr,23561,22623,938,4
Walker County,2018-May,23523,22592,931,4
Walker County,2018-Jun,23693,22550,1143,4.8
Walker County,2018-Jul,23537,22440,1097,4.7
Walker County,2018-Aug,23688,22643,1045,4.4
Walker County,2018-Sep,23963,22999,964,4
Walker County,2018-Oct,23820,22928,892,3.7
Walker County,2018-Nov,23790,22906,884,3.7
Walker County,2018-Dec,23569,22660,909,3.9
Walker County,2019-Jan,23745,22672,1073,4.5
Walker County,2019-Feb,23958,23006,952,4
Walker County,2019-Mar,23893,22989,904,3.8
Walker County,2019-Apr,23698,22947,751,3.2
Walker County,2019-May,23587,22746,841,3.6
Walker County,2019-Jun,23706,22636,1070,4.5
Walker County,2019-Jul,23590,22499,1091,4.6
Walker County,2019-Aug,23846,22809,1037,4.3
Walker County,2019-Sep,24119,23172,947,3.9
Walker County,2019-Oct,24012,23118,894,3.7
Walker County,2019-Nov,23931,23043,888,3.7
Walker County,2019-Dec,23826,23014,812,3.4
Walker County,2020-Jan,23872,22956,916,3.8
Walker County,2020-Feb,24099,23238,861,3.6
Walker County,2020-Mar,23751,22374,1377,5.8
Walker County,2020-Apr,23024,20717,2307,10
Walker County,2020-May,23562,21250,2312,9.8
Walker County,2020-Jun,23620,21421,2199,9.3
Walker County,2020-Jul,23575,21449,2126,9
Walker County,2020-Aug,23887,22114,1773,7.4
Walker County,2020-Sep,24111,22373,1738,7.2
Walker County,2020-Oct,24369,22801,1568,6.4
Walker County,2020-Nov,24322,22636,1686,6.9
Walker County,2020-Dec,24139,22446,1693,7
Walker County,2021-Jan,24348,22577,1771,7.3
Walker County,2021-Feb,24521,22774,1747,7.1
Walker County,2021-Mar,24508,22813,1695,6.9
Walker County,2021-Apr,24420,22926,1494,6.1
Walker County,2021-May,24073,22604,1469,6.1
Walker County,2021-Jun,23970,22245,1725,7.2
Walker County,2021-Jul,23465,21895,1570,6.7
Walker County,2021-Aug,23432,21976,1456,6.2
Walker County,2021-Sep,23687,22334,1353,5.7
Walker County,2021-Oct,23808,22489,1319,5.5
Walker County,2021-Nov,23689,22439,1250,5.3
Walker County,2021-Dec,23490,22335,1155,4.9
Walker County,2022-Jan,23731,22417,1314,5.5
Walker County,2022-Feb,23964,22640,1324,5.5
Walker County,2022-Mar,23921,22841,1080,4.5
Walker County,2022-Apr,23966,22939,1027,4.3
Walker County,2022-May,23704,22622,1082,4.6
Walker County,2022-Jun,23550,22257,1293,5.5
Walker County,2022-Jul,23230(P),21974(P),1256(P),5.4(P)
Waller County,2012-Jan,20064,18560,1504,7.5
Waller County,2012-Feb,20154,18693,1461,7.2
Waller County,2012-Mar,20189,18836,1353,6.7
Waller County,2012-Apr,20245,18951,1294,6.4
Waller County,2012-May,20381,19004,1377,6.8
Waller County,2012-Jun,20687,19036,1651,8
Waller County,2012-Jul,20755,19109,1646,7.9
Waller County,2012-Aug,20573,19044,1529,7.4
Waller County,2012-Sep,20574,19224,1350,6.6
Waller County,2012-Oct,20618,19287,1331,6.5
Waller County,2012-Nov,20600,19303,1297,6.3
Waller County,2012-Dec,20565,19269,1296,6.3
Waller County,2013-Jan,20498,19039,1459,7.1
Waller County,2013-Feb,20615,19214,1401,6.8
Waller County,2013-Mar,20600,19249,1351,6.6
Waller County,2013-Apr,20729,19417,1312,6.3
Waller County,2013-May,20868,19468,1400,6.7
Waller County,2013-Jun,21063,19469,1594,7.6
Waller County,2013-Jul,21094,19579,1515,7.2
Waller County,2013-Aug,20887,19466,1421,6.8
Waller County,2013-Sep,20855,19558,1297,6.2
Waller County,2013-Oct,20755,19532,1223,5.9
Waller County,2013-Nov,20800,19621,1179,5.7
Waller County,2013-Dec,20810,19706,1104,5.3
Waller County,2014-Jan,20944,19768,1176,5.6
Waller County,2014-Feb,21164,19967,1197,5.7
Waller County,2014-Mar,21203,20082,1121,5.3
Waller County,2014-Apr,21177,20190,987,4.7
Waller County,2014-May,21309,20214,1095,5.1
Waller County,2014-Jun,21475,20195,1280,6
Waller County,2014-Jul,21557,20261,1296,6
Waller County,2014-Aug,21362,20157,1205,5.6
Waller County,2014-Sep,21338,20276,1062,5
Waller County,2014-Oct,21378,20389,989,4.6
Waller County,2014-Nov,21349,20378,971,4.5
Waller County,2014-Dec,21208,20356,852,4
Waller County,2015-Jan,21536,20523,1013,4.7
Waller County,2015-Feb,21647,20664,983,4.5
Waller County,2015-Mar,21608,20686,922,4.3
Waller County,2015-Apr,21628,20735,893,4.1
Waller County,2015-May,21728,20732,996,4.6
Waller County,2015-Jun,21840,20649,1191,5.5
Waller County,2015-Jul,21826,20617,1209,5.5
Waller County,2015-Aug,21658,20524,1134,5.2
Waller County,2015-Sep,21579,20523,1056,4.9
Waller County,2015-Oct,21663,20599,1064,4.9
Waller County,2015-Nov,21669,20581,1088,5
Waller County,2015-Dec,21658,20636,1022,4.7
Waller County,2016-Jan,21929,20772,1157,5.3
Waller County,2016-Feb,22201,21045,1156,5.2
Waller County,2016-Mar,22244,21072,1172,5.3
Waller County,2016-Apr,22217,21082,1135,5.1
Waller County,2016-May,22228,21078,1150,5.2
Waller County,2016-Jun,22368,20951,1417,6.3
Waller County,2016-Jul,22330,20912,1418,6.4
Waller County,2016-Aug,22275,20865,1410,6.3
Waller County,2016-Sep,22177,20858,1319,5.9
Waller County,2016-Oct,22094,20879,1215,5.5
Waller County,2016-Nov,22067,20904,1163,5.3
Waller County,2016-Dec,22028,20850,1178,5.3
Waller County,2017-Jan,21977,20721,1256,5.7
Waller County,2017-Feb,22181,20945,1236,5.6
Waller County,2017-Mar,22322,21163,1159,5.2
Waller County,2017-Apr,22281,21242,1039,4.7
Waller County,2017-May,22221,21192,1029,4.6
Waller County,2017-Jun,22365,21164,1201,5.4
Waller County,2017-Jul,22259,21113,1146,5.1
Waller County,2017-Aug,22264,21093,1171,5.3
Waller County,2017-Sep,22172,21126,1046,4.7
Waller County,2017-Oct,22161,21211,950,4.3
Waller County,2017-Nov,22226,21240,986,4.4
Waller County,2017-Dec,22193,21254,939,4.2
Waller County,2018-Jan,22524,21486,1038,4.6
Waller County,2018-Feb,22890,21831,1059,4.6
Waller County,2018-Mar,22924,21938,986,4.3
Waller County,2018-Apr,22849,21948,901,3.9
Waller County,2018-May,22872,21989,883,3.9
Waller County,2018-Jun,23090,21953,1137,4.9
Waller County,2018-Jul,23089,21975,1114,4.8
Waller County,2018-Aug,22966,21895,1071,4.7
Waller County,2018-Sep,22908,21946,962,4.2
Waller County,2018-Oct,22991,22083,908,3.9
Waller County,2018-Nov,22993,22112,881,3.8
Waller County,2018-Dec,22963,22082,881,3.8
Waller County,2019-Jan,23584,22575,1009,4.3
Waller County,2019-Feb,23824,22873,951,4
Waller County,2019-Mar,23799,22914,885,3.7
Waller County,2019-Apr,23637,22910,727,3.1
Waller County,2019-May,23709,22939,770,3.2
Waller County,2019-Jun,23961,22942,1019,4.3
Waller County,2019-Jul,23997,22988,1009,4.2
Waller County,2019-Aug,23960,23017,943,3.9
Waller County,2019-Sep,23968,23085,883,3.7
Waller County,2019-Oct,24092,23205,887,3.7
Waller County,2019-Nov,24034,23171,863,3.6
Waller County,2019-Dec,23988,23172,816,3.4
Waller County,2020-Jan,24648,23693,955,3.9
Waller County,2020-Feb,24863,23985,878,3.5
Waller County,2020-Mar,24494,23122,1372,5.6
Waller County,2020-Apr,22811,20386,2425,10.6
Waller County,2020-May,23647,21124,2523,10.7
Waller County,2020-Jun,24111,21681,2430,10.1
Waller County,2020-Jul,24202,21821,2381,9.8
Waller County,2020-Aug,24268,22306,1962,8.1
Waller County,2020-Sep,24255,22376,1879,7.7
Waller County,2020-Oct,24511,22803,1708,7
Waller County,2020-Nov,24628,22811,1817,7.4
Waller County,2020-Dec,24587,22766,1821,7.4
Waller County,2021-Jan,24569,22627,1942,7.9
Waller County,2021-Feb,24798,22904,1894,7.6
Waller County,2021-Mar,24800,23051,1749,7.1
Waller County,2021-Apr,24729,23110,1619,6.5
Waller County,2021-May,24593,23061,1532,6.2
Waller County,2021-Jun,24876,23017,1859,7.5
Waller County,2021-Jul,24916,23223,1693,6.8
Waller County,2021-Aug,24830,23284,1546,6.2
Waller County,2021-Sep,24806,23417,1389,5.6
Waller County,2021-Oct,24873,23512,1361,5.5
Waller County,2021-Nov,24899,23646,1253,5
Waller County,2021-Dec,24898,23737,1161,4.7
Waller County,2022-Jan,24911,23584,1327,5.3
Waller County,2022-Feb,25282,23983,1299,5.1
Waller County,2022-Mar,25285,24231,1054,4.2
Waller County,2022-Apr,25249,24220,1029,4.1
Waller County,2022-May,25297,24242,1055,4.2
Waller County,2022-Jun,25567,24294,1273,5
Waller County,2022-Jul,25662(P),24442(P),1220(P),4.8(P)
Ward County,2012-Jan,5064,4784,280,5.5
Ward County,2012-Feb,5047,4780,267,5.3
Ward County,2012-Mar,5096,4854,242,4.7
Ward County,2012-Apr,5153,4915,238,4.6
Ward County,2012-May,5291,5042,249,4.7
Ward County,2012-Jun,5402,5112,290,5.4
Ward County,2012-Jul,5553,5268,285,5.1
Ward County,2012-Aug,5641,5379,262,4.6
Ward County,2012-Sep,5472,5228,244,4.5
Ward County,2012-Oct,5422,5180,242,4.5
Ward County,2012-Nov,5533,5298,235,4.2
Ward County,2012-Dec,5447,5209,238,4.4
Ward County,2013-Jan,5277,5000,277,5.2
Ward County,2013-Feb,5362,5099,263,4.9
Ward County,2013-Mar,5343,5085,258,4.8
Ward County,2013-Apr,5419,5175,244,4.5
Ward County,2013-May,5465,5208,257,4.7
Ward County,2013-Jun,5569,5275,294,5.3
Ward County,2013-Jul,5554,5267,287,5.2
Ward County,2013-Aug,5629,5363,266,4.7
Ward County,2013-Sep,5634,5372,262,4.7
Ward County,2013-Oct,5579,5330,249,4.5
Ward County,2013-Nov,5636,5397,239,4.2
Ward County,2013-Dec,5628,5398,230,4.1
Ward County,2014-Jan,5783,5556,227,3.9
Ward County,2014-Feb,5840,5612,228,3.9
Ward County,2014-Mar,5843,5625,218,3.7
Ward County,2014-Apr,5762,5574,188,3.3
Ward County,2014-May,5865,5660,205,3.5
Ward County,2014-Jun,5927,5695,232,3.9
Ward County,2014-Jul,5922,5683,239,4
Ward County,2014-Aug,5954,5721,233,3.9
Ward County,2014-Sep,5971,5751,220,3.7
Ward County,2014-Oct,5982,5776,206,3.4
Ward County,2014-Nov,6020,5825,195,3.2
Ward County,2014-Dec,6074,5889,185,3
Ward County,2015-Jan,6259,6035,224,3.6
Ward County,2015-Feb,6154,5924,230,3.7
Ward County,2015-Mar,6105,5862,243,4
Ward County,2015-Apr,6065,5834,231,3.8
Ward County,2015-May,5954,5701,253,4.2
Ward County,2015-Jun,5963,5684,279,4.7
Ward County,2015-Jul,5985,5706,279,4.7
Ward County,2015-Aug,5892,5624,268,4.5
Ward County,2015-Sep,5793,5521,272,4.7
Ward County,2015-Oct,5633,5374,259,4.6
Ward County,2015-Nov,5648,5380,268,4.7
Ward County,2015-Dec,5523,5270,253,4.6
Ward County,2016-Jan,5470,5192,278,5.1
Ward County,2016-Feb,5424,5123,301,5.5
Ward County,2016-Mar,5396,5073,323,6
Ward County,2016-Apr,5289,4964,325,6.1
Ward County,2016-May,5253,4945,308,5.9
Ward County,2016-Jun,5290,4951,339,6.4
Ward County,2016-Jul,5445,5111,334,6.1
Ward County,2016-Aug,5435,5112,323,5.9
Ward County,2016-Sep,5498,5174,324,5.9
Ward County,2016-Oct,5418,5129,289,5.3
Ward County,2016-Nov,5435,5159,276,5.1
Ward County,2016-Dec,5408,5130,278,5.1
Ward County,2017-Jan,5372,5084,288,5.4
Ward County,2017-Feb,5504,5237,267,4.9
Ward County,2017-Mar,5539,5296,243,4.4
Ward County,2017-Apr,5519,5301,218,3.9
Ward County,2017-May,5563,5335,228,4.1
Ward County,2017-Jun,5531,5297,234,4.2
Ward County,2017-Jul,5457,5235,222,4.1
Ward County,2017-Aug,5530,5307,223,4
Ward County,2017-Sep,5573,5369,204,3.7
Ward County,2017-Oct,5594,5402,192,3.4
Ward County,2017-Nov,5675,5476,199,3.5
Ward County,2017-Dec,5673,5482,191,3.4
Ward County,2018-Jan,6156,5949,207,3.4
Ward County,2018-Feb,6282,6092,190,3
Ward County,2018-Mar,6238,6055,183,2.9
Ward County,2018-Apr,6348,6183,165,2.6
Ward County,2018-May,6461,6306,155,2.4
Ward County,2018-Jun,6784,6595,189,2.8
Ward County,2018-Jul,6925,6747,178,2.6
Ward County,2018-Aug,6955,6779,176,2.5
Ward County,2018-Sep,6923,6762,161,2.3
Ward County,2018-Oct,7099,6947,152,2.1
Ward County,2018-Nov,7173,7016,157,2.2
Ward County,2018-Dec,7144,6980,164,2.3
Ward County,2019-Jan,7325,7139,186,2.5
Ward County,2019-Feb,7445,7266,179,2.4
Ward County,2019-Mar,7377,7209,168,2.3
Ward County,2019-Apr,7356,7216,140,1.9
Ward County,2019-May,7383,7238,145,2
Ward County,2019-Jun,7392,7211,181,2.4
Ward County,2019-Jul,7411,7219,192,2.6
Ward County,2019-Aug,7368,7183,185,2.5
Ward County,2019-Sep,7309,7142,167,2.3
Ward County,2019-Oct,7044,6872,172,2.4
Ward County,2019-Nov,6962,6780,182,2.6
Ward County,2019-Dec,6856,6683,173,2.5
Ward County,2020-Jan,6688,6484,204,3.1
Ward County,2020-Feb,6682,6484,198,3
Ward County,2020-Mar,6502,6187,315,4.8
Ward County,2020-Apr,6175,5563,612,9.9
Ward County,2020-May,6220,5413,807,13
Ward County,2020-Jun,6101,5269,832,13.6
Ward County,2020-Jul,5932,5126,806,13.6
Ward County,2020-Aug,5852,5169,683,11.7
Ward County,2020-Sep,5868,5191,677,11.5
Ward County,2020-Oct,5816,5208,608,10.5
Ward County,2020-Nov,5777,5156,621,10.7
Ward County,2020-Dec,5720,5138,582,10.2
Ward County,2021-Jan,5719,5161,558,9.8
Ward County,2021-Feb,5798,5258,540,9.3
Ward County,2021-Mar,5835,5349,486,8.3
Ward County,2021-Apr,5828,5366,462,7.9
Ward County,2021-May,5794,5362,432,7.5
Ward County,2021-Jun,5874,5414,460,7.8
Ward County,2021-Jul,5935,5524,411,6.9
Ward County,2021-Aug,5933,5552,381,6.4
Ward County,2021-Sep,6059,5697,362,6
Ward County,2021-Oct,5970,5629,341,5.7
Ward County,2021-Nov,5952,5634,318,5.3
Ward County,2021-Dec,5913,5613,300,5.1
Ward County,2022-Jan,5938,5600,338,5.7
Ward County,2022-Feb,6009,5690,319,5.3
Ward County,2022-Mar,6044,5773,271,4.5
Ward County,2022-Apr,6129,5876,253,4.1
Ward County,2022-May,6125,5868,257,4.2
Ward County,2022-Jun,6204,5914,290,4.7
Ward County,2022-Jul,6319(P),6040(P),279(P),4.4(P)
Washington County,2012-Jan,15366,14441,925,6
Washington County,2012-Feb,15519,14632,887,5.7
Washington County,2012-Mar,15529,14662,867,5.6
Washington County,2012-Apr,15631,14836,795,5.1
Washington County,2012-May,15625,14771,854,5.5
Washington County,2012-Jun,15831,14821,1010,6.4
Washington County,2012-Jul,15771,14761,1010,6.4
Washington County,2012-Aug,15605,14680,925,5.9
Washington County,2012-Sep,15691,14871,820,5.2
Washington County,2012-Oct,15671,14862,809,5.2
Washington County,2012-Nov,15570,14784,786,5
Washington County,2012-Dec,15492,14711,781,5
Washington County,2013-Jan,15436,14509,927,6
Washington County,2013-Feb,15516,14651,865,5.6
Washington County,2013-Mar,15583,14712,871,5.6
Washington County,2013-Apr,15624,14821,803,5.1
Washington County,2013-May,15786,14928,858,5.4
Washington County,2013-Jun,15960,14951,1009,6.3
Washington County,2013-Jul,15983,14997,986,6.2
Washington County,2013-Aug,15735,14833,902,5.7
Washington County,2013-Sep,15828,14967,861,5.4
Washington County,2013-Oct,15685,14871,814,5.2
Washington County,2013-Nov,15599,14829,770,4.9
Washington County,2013-Dec,15609,14884,725,4.6
Washington County,2014-Jan,15405,14635,770,5
Washington County,2014-Feb,15730,14934,796,5.1
Washington County,2014-Mar,15908,15111,797,5
Washington County,2014-Apr,15894,15244,650,4.1
Washington County,2014-May,15835,15121,714,4.5
Washington County,2014-Jun,15883,15063,820,5.2
Washington County,2014-Jul,15820,14959,861,5.4
Washington County,2014-Aug,15534,14736,798,5.1
Washington County,2014-Sep,15629,14923,706,4.5
Washington County,2014-Oct,15619,14963,656,4.2
Washington County,2014-Nov,15518,14883,635,4.1
Washington County,2014-Dec,15340,14781,559,3.6
Washington County,2015-Jan,15464,14807,657,4.2
Washington County,2015-Feb,15666,15034,632,4
Washington County,2015-Mar,15778,15176,602,3.8
Washington County,2015-Apr,15692,15133,559,3.6
Washington County,2015-May,15731,15092,639,4.1
Washington County,2015-Jun,15593,14712,881,5.6
Washington County,2015-Jul,15246,14343,903,5.9
Washington County,2015-Aug,15038,14191,847,5.6
Washington County,2015-Sep,15095,14299,796,5.3
Washington County,2015-Oct,15065,14279,786,5.2
Washington County,2015-Nov,15010,14212,798,5.3
Washington County,2015-Dec,15006,14262,744,5
Washington County,2016-Jan,14736,13982,754,5.1
Washington County,2016-Feb,15077,14332,745,4.9
Washington County,2016-Mar,15178,14430,748,4.9
Washington County,2016-Apr,15260,14547,713,4.7
Washington County,2016-May,15302,14605,697,4.6
Washington County,2016-Jun,15368,14505,863,5.6
Washington County,2016-Jul,15096,14231,865,5.7
Washington County,2016-Aug,15056,14223,833,5.5
Washington County,2016-Sep,15124,14307,817,5.4
Washington County,2016-Oct,14988,14225,763,5.1
Washington County,2016-Nov,14969,14247,722,4.8
Washington County,2016-Dec,14913,14210,703,4.7
Washington County,2017-Jan,14580,13849,731,5
Washington County,2017-Feb,14800,14076,724,4.9
Washington County,2017-Mar,14891,14173,718,4.8
Washington County,2017-Apr,14867,14268,599,4
Washington County,2017-May,14907,14320,587,3.9
Washington County,2017-Jun,14893,14218,675,4.5
Washington County,2017-Jul,14808,14129,679,4.6
Washington County,2017-Aug,14704,14050,654,4.4
Washington County,2017-Sep,14675,14113,562,3.8
Washington County,2017-Oct,14682,14166,516,3.5
Washington County,2017-Nov,14677,14118,559,3.8
Washington County,2017-Dec,14661,14130,531,3.6
Washington County,2018-Jan,14518,13934,584,4
Washington County,2018-Feb,14754,14171,583,4
Washington County,2018-Mar,14914,14320,594,4
Washington County,2018-Apr,14815,14323,492,3.3
Washington County,2018-May,14807,14333,474,3.2
Washington County,2018-Jun,14826,14200,626,4.2
Washington County,2018-Jul,14819,14220,599,4
Washington County,2018-Aug,14700,14165,535,3.6
Washington County,2018-Sep,14737,14227,510,3.5
Washington County,2018-Oct,14672,14193,479,3.3
Washington County,2018-Nov,14573,14081,492,3.4
Washington County,2018-Dec,14610,14111,499,3.4
Washington County,2019-Jan,14656,14076,580,4
Washington County,2019-Feb,14825,14290,535,3.6
Washington County,2019-Mar,14842,14289,553,3.7
Washington County,2019-Apr,14859,14435,424,2.9
Washington County,2019-May,14830,14397,433,2.9
Washington County,2019-Jun,14977,14387,590,3.9
Washington County,2019-Jul,15189,14584,605,4
Washington County,2019-Aug,15112,14577,535,3.5
Washington County,2019-Sep,15240,14758,482,3.2
Washington County,2019-Oct,15267,14800,467,3.1
Washington County,2019-Nov,15085,14611,474,3.1
Washington County,2019-Dec,15097,14650,447,3
Washington County,2020-Jan,15041,14534,507,3.4
Washington County,2020-Feb,15309,14833,476,3.1
Washington County,2020-Mar,15164,14360,804,5.3
Washington County,2020-Apr,14172,13193,979,6.9
Washington County,2020-May,14742,13670,1072,7.3
Washington County,2020-Jun,15043,13920,1123,7.5
Washington County,2020-Jul,15147,14100,1047,6.9
Washington County,2020-Aug,15310,14417,893,5.8
Washington County,2020-Sep,15380,14552,828,5.4
Washington County,2020-Oct,15336,14560,776,5.1
Washington County,2020-Nov,15283,14424,859,5.6
Washington County,2020-Dec,15299,14426,873,5.7
Washington County,2021-Jan,15304,14336,968,6.3
Washington County,2021-Feb,15456,14508,948,6.1
Washington County,2021-Mar,15552,14661,891,5.7
Washington County,2021-Apr,15386,14595,791,5.1
Washington County,2021-May,15257,14498,759,5
Washington County,2021-Jun,15353,14408,945,6.2
Washington County,2021-Jul,15183,14331,852,5.6
Washington County,2021-Aug,15114,14330,784,5.2
Washington County,2021-Sep,15099,14386,713,4.7
Washington County,2021-Oct,14942,14266,676,4.5
Washington County,2021-Nov,14826,14181,645,4.4
Washington County,2021-Dec,14769,14192,577,3.9
Washington County,2022-Jan,14769,14094,675,4.6
Washington County,2022-Feb,15023,14366,657,4.4
Washington County,2022-Mar,15176,14625,551,3.6
Washington County,2022-Apr,14935,14412,523,3.5
Washington County,2022-May,14848,14298,550,3.7
Washington County,2022-Jun,14888,14199,689,4.6
Washington County,2022-Jul,15027(P),14352(P),675(P),4.5(P)
Webb County,2012-Jan,108654,101082,7572,7
Webb County,2012-Feb,108786,101335,7451,6.8
Webb County,2012-Mar,108533,101713,6820,6.3
Webb County,2012-Apr,108036,101479,6557,6.1
Webb County,2012-May,108005,101076,6929,6.4
Webb County,2012-Jun,109038,101039,7999,7.3
Webb County,2012-Jul,109286,101440,7846,7.2
Webb County,2012-Aug,108634,101550,7084,6.5
Webb County,2012-Sep,109050,102490,6560,6
Webb County,2012-Oct,109114,102685,6429,5.9
Webb County,2012-Nov,109759,103389,6370,5.8
Webb County,2012-Dec,109646,103122,6524,6
Webb County,2013-Jan,109942,102508,7434,6.8
Webb County,2013-Feb,110192,102999,7193,6.5
Webb County,2013-Mar,109445,102687,6758,6.2
Webb County,2013-Apr,110242,103648,6594,6
Webb County,2013-May,110490,103623,6867,6.2
Webb County,2013-Jun,110564,102818,7746,7
Webb County,2013-Jul,110628,103262,7366,6.7
Webb County,2013-Aug,110204,103388,6816,6.2
Webb County,2013-Sep,110221,103597,6624,6
Webb County,2013-Oct,109077,102795,6282,5.8
Webb County,2013-Nov,110434,104309,6125,5.5
Webb County,2013-Dec,110294,104444,5850,5.3
Webb County,2014-Jan,110189,103863,6326,5.7
Webb County,2014-Feb,110595,104120,6475,5.9
Webb County,2014-Mar,110688,104588,6100,5.5
Webb County,2014-Apr,110431,105079,5352,4.8
Webb County,2014-May,110439,104818,5621,5.1
Webb County,2014-Jun,111021,104657,6364,5.7
Webb County,2014-Jul,111163,104672,6491,5.8
Webb County,2014-Aug,111152,105239,5913,5.3
Webb County,2014-Sep,111222,105771,5451,4.9
Webb County,2014-Oct,111552,106509,5043,4.5
Webb County,2014-Nov,111986,107007,4979,4.4
Webb County,2014-Dec,111959,107431,4528,4
Webb County,2015-Jan,111199,105909,5290,4.8
Webb County,2015-Feb,111394,106160,5234,4.7
Webb County,2015-Mar,111429,106297,5132,4.6
Webb County,2015-Apr,111798,106850,4948,4.4
Webb County,2015-May,112078,106836,5242,4.7
Webb County,2015-Jun,112408,106490,5918,5.3
Webb County,2015-Jul,111664,105815,5849,5.2
Webb County,2015-Aug,111150,105694,5456,4.9
Webb County,2015-Sep,111495,106211,5284,4.7
Webb County,2015-Oct,111785,106520,5265,4.7
Webb County,2015-Nov,112823,107493,5330,4.7
Webb County,2015-Dec,112814,107755,5059,4.5
Webb County,2016-Jan,112629,107103,5526,4.9
Webb County,2016-Feb,113154,107578,5576,4.9
Webb County,2016-Mar,113517,107873,5644,5
Webb County,2016-Apr,113731,108428,5303,4.7
Webb County,2016-May,113388,108149,5239,4.6
Webb County,2016-Jun,114100,107881,6219,5.5
Webb County,2016-Jul,114550,108339,6211,5.4
Webb County,2016-Aug,114109,108217,5892,5.2
Webb County,2016-Sep,114421,108726,5695,5
Webb County,2016-Oct,113994,108695,5299,4.6
Webb County,2016-Nov,114624,109522,5102,4.5
Webb County,2016-Dec,114539,109255,5284,4.6
Webb County,2017-Jan,113832,107966,5866,5.2
Webb County,2017-Feb,114125,108360,5765,5.1
Webb County,2017-Mar,114481,109151,5330,4.7
Webb County,2017-Apr,114054,109216,4838,4.2
Webb County,2017-May,113751,109024,4727,4.2
Webb County,2017-Jun,114482,109182,5300,4.6
Webb County,2017-Jul,114655,109653,5002,4.4
Webb County,2017-Aug,114613,109657,4956,4.3
Webb County,2017-Sep,114776,110506,4270,3.7
Webb County,2017-Oct,113552,109613,3939,3.5
Webb County,2017-Nov,114447,110276,4171,3.6
Webb County,2017-Dec,114357,110310,4047,3.5
Webb County,2018-Jan,114078,109496,4582,4
Webb County,2018-Feb,115024,110413,4611,4
Webb County,2018-Mar,114858,110382,4476,3.9
Webb County,2018-Apr,114723,110626,4097,3.6
Webb County,2018-May,114220,110219,4001,3.5
Webb County,2018-Jun,115048,110051,4997,4.3
Webb County,2018-Jul,115794,111087,4707,4.1
Webb County,2018-Aug,115139,110774,4365,3.8
Webb County,2018-Sep,114528,110329,4199,3.7
Webb County,2018-Oct,115615,111557,4058,3.5
Webb County,2018-Nov,116298,112236,4062,3.5
Webb County,2018-Dec,116758,112395,4363,3.7
Webb County,2019-Jan,116482,111479,5003,4.3
Webb County,2019-Feb,117079,112301,4778,4.1
Webb County,2019-Mar,116569,112170,4399,3.8
Webb County,2019-Apr,116334,112506,3828,3.3
Webb County,2019-May,116597,112619,3978,3.4
Webb County,2019-Jun,117070,112314,4756,4.1
Webb County,2019-Jul,116907,112148,4759,4.1
Webb County,2019-Aug,117202,112835,4367,3.7
Webb County,2019-Sep,117331,113288,4043,3.4
Webb County,2019-Oct,117317,113310,4007,3.4
Webb County,2019-Nov,117954,113867,4087,3.5
Webb County,2019-Dec,117913,113817,4096,3.5
Webb County,2020-Jan,117683,112995,4688,4
Webb County,2020-Feb,118175,113738,4437,3.8
Webb County,2020-Mar,116071,109395,6676,5.8
Webb County,2020-Apr,108141,94674,13467,12.5
Webb County,2020-May,113053,98156,14897,13.2
Webb County,2020-Jun,114985,101442,13543,11.8
Webb County,2020-Jul,115596,103117,12479,10.8
Webb County,2020-Aug,115827,105533,10294,8.9
Webb County,2020-Sep,115782,105871,9911,8.6
Webb County,2020-Oct,115364,106611,8753,7.6
Webb County,2020-Nov,115741,106778,8963,7.7
Webb County,2020-Dec,115815,106980,8835,7.6
Webb County,2021-Jan,115232,105991,9241,8
Webb County,2021-Feb,115954,106984,8970,7.7
Webb County,2021-Mar,115313,107009,8304,7.2
Webb County,2021-Apr,115584,107997,7587,6.6
Webb County,2021-May,115368,108092,7276,6.3
Webb County,2021-Jun,116727,108290,8437,7.2
Webb County,2021-Jul,116819,109324,7495,6.4
Webb County,2021-Aug,116807,109953,6854,5.9
Webb County,2021-Sep,116630,110237,6393,5.5
Webb County,2021-Oct,116940,110769,6171,5.3
Webb County,2021-Nov,117630,111799,5831,5
Webb County,2021-Dec,117470,111955,5515,4.7
Webb County,2022-Jan,117769,111384,6385,5.4
Webb County,2022-Feb,118697,112407,6290,5.3
Webb County,2022-Mar,118227,113105,5122,4.3
Webb County,2022-Apr,117194,112320,4874,4.2
Webb County,2022-May,117330,112320,5010,4.3
Webb County,2022-Jun,118248,112625,5623,4.8
Webb County,2022-Jul,117698(P),112398(P),5300(P),4.5(P)
Wharton County,2012-Jan,20958,19307,1651,7.9
Wharton County,2012-Feb,21012,19414,1598,7.6
Wharton County,2012-Mar,21158,19695,1463,6.9
Wharton County,2012-Apr,21296,19931,1365,6.4
Wharton County,2012-May,21407,19974,1433,6.7
Wharton County,2012-Jun,21615,20050,1565,7.2
Wharton County,2012-Jul,21827,20263,1564,7.2
Wharton County,2012-Aug,21515,20041,1474,6.9
Wharton County,2012-Sep,21591,20260,1331,6.2
Wharton County,2012-Oct,21541,20263,1278,5.9
Wharton County,2012-Nov,21459,20220,1239,5.8
Wharton County,2012-Dec,21232,19938,1294,6.1
Wharton County,2013-Jan,20990,19554,1436,6.8
Wharton County,2013-Feb,21151,19792,1359,6.4
Wharton County,2013-Mar,21144,19856,1288,6.1
Wharton County,2013-Apr,21426,20207,1219,5.7
Wharton County,2013-May,21643,20368,1275,5.9
Wharton County,2013-Jun,21768,20337,1431,6.6
Wharton County,2013-Jul,21934,20530,1404,6.4
Wharton County,2013-Aug,21517,20188,1329,6.2
Wharton County,2013-Sep,21577,20300,1277,5.9
Wharton County,2013-Oct,21544,20335,1209,5.6
Wharton County,2013-Nov,21371,20217,1154,5.4
Wharton County,2013-Dec,21521,20419,1102,5.1
Wharton County,2014-Jan,21223,20076,1147,5.4
Wharton County,2014-Feb,21477,20347,1130,5.3
Wharton County,2014-Mar,21574,20480,1094,5.1
Wharton County,2014-Apr,21640,20698,942,4.4
Wharton County,2014-May,21729,20717,1012,4.7
Wharton County,2014-Jun,21705,20602,1103,5.1
Wharton County,2014-Jul,21828,20698,1130,5.2
Wharton County,2014-Aug,21461,20368,1093,5.1
Wharton County,2014-Sep,21544,20554,990,4.6
Wharton County,2014-Oct,21647,20755,892,4.1
Wharton County,2014-Nov,21433,20548,885,4.1
Wharton County,2014-Dec,21243,20444,799,3.8
Wharton County,2015-Jan,21011,20101,910,4.3
Wharton County,2015-Feb,21280,20410,870,4.1
Wharton County,2015-Mar,21422,20572,850,4
Wharton County,2015-Apr,21368,20548,820,3.8
Wharton County,2015-May,21453,20580,873,4.1
Wharton County,2015-Jun,21375,20367,1008,4.7
Wharton County,2015-Jul,21458,20382,1076,5
Wharton County,2015-Aug,21057,20022,1035,4.9
Wharton County,2015-Sep,21172,20174,998,4.7
Wharton County,2015-Oct,21183,20205,978,4.6
Wharton County,2015-Nov,21080,20102,978,4.6
Wharton County,2015-Dec,21002,20067,935,4.5
Wharton County,2016-Jan,20621,19631,990,4.8
Wharton County,2016-Feb,21240,20202,1038,4.9
Wharton County,2016-Mar,21421,20360,1061,5
Wharton County,2016-Apr,21294,20293,1001,4.7
Wharton County,2016-May,21506,20517,989,4.6
Wharton County,2016-Jun,21377,20216,1161,5.4
Wharton County,2016-Jul,21141,19967,1174,5.6
Wharton County,2016-Aug,21083,19955,1128,5.4
Wharton County,2016-Sep,21000,19873,1127,5.4
Wharton County,2016-Oct,20772,19758,1014,4.9
Wharton County,2016-Nov,20782,19777,1005,4.8
Wharton County,2016-Dec,20726,19669,1057,5.1
Wharton County,2017-Jan,20408,19310,1098,5.4
Wharton County,2017-Feb,20710,19630,1080,5.2
Wharton County,2017-Mar,21106,20110,996,4.7
Wharton County,2017-Apr,21138,20215,923,4.4
Wharton County,2017-May,21140,20251,889,4.2
Wharton County,2017-Jun,21035,20032,1003,4.8
Wharton County,2017-Jul,21004,20036,968,4.6
Wharton County,2017-Aug,21121,20155,966,4.6
Wharton County,2017-Sep,20863,19915,948,4.5
Wharton County,2017-Oct,21028,20211,817,3.9
Wharton County,2017-Nov,20906,20038,868,4.2
Wharton County,2017-Dec,20868,20045,823,3.9
Wharton County,2018-Jan,20574,19671,903,4.4
Wharton County,2018-Feb,20910,20035,875,4.2
Wharton County,2018-Mar,21215,20407,808,3.8
Wharton County,2018-Apr,21057,20310,747,3.5
Wharton County,2018-May,21197,20473,724,3.4
Wharton County,2018-Jun,21205,20332,873,4.1
Wharton County,2018-Jul,21234,20383,851,4
Wharton County,2018-Aug,21208,20396,812,3.8
Wharton County,2018-Sep,21177,20430,747,3.5
Wharton County,2018-Oct,21162,20456,706,3.3
Wharton County,2018-Nov,21096,20394,702,3.3
Wharton County,2018-Dec,20923,20202,721,3.4
Wharton County,2019-Jan,20676,19876,800,3.9
Wharton County,2019-Feb,21035,20289,746,3.5
Wharton County,2019-Mar,21303,20607,696,3.3
Wharton County,2019-Apr,21228,20617,611,2.9
Wharton County,2019-May,21456,20810,646,3
Wharton County,2019-Jun,21524,20729,795,3.7
Wharton County,2019-Jul,21543,20723,820,3.8
Wharton County,2019-Aug,21567,20798,769,3.6
Wharton County,2019-Sep,21548,20820,728,3.4
Wharton County,2019-Oct,21827,21130,697,3.2
Wharton County,2019-Nov,21618,20911,707,3.3
Wharton County,2019-Dec,21583,20881,702,3.3
Wharton County,2020-Jan,21578,20774,804,3.7
Wharton County,2020-Feb,21888,21145,743,3.4
Wharton County,2020-Mar,21551,20385,1166,5.4
Wharton County,2020-Apr,20314,18549,1765,8.7
Wharton County,2020-May,20645,18779,1866,9
Wharton County,2020-Jun,20889,19038,1851,8.9
Wharton County,2020-Jul,21023,19181,1842,8.8
Wharton County,2020-Aug,21175,19669,1506,7.1
Wharton County,2020-Sep,21211,19676,1535,7.2
Wharton County,2020-Oct,21384,20023,1361,6.4
Wharton County,2020-Nov,21134,19751,1383,6.5
Wharton County,2020-Dec,21134,19716,1418,6.7
Wharton County,2021-Jan,20981,19492,1489,7.1
Wharton County,2021-Feb,21252,19778,1474,6.9
Wharton County,2021-Mar,21587,20204,1383,6.4
Wharton County,2021-Apr,21295,20034,1261,5.9
Wharton County,2021-May,21033,19850,1183,5.6
Wharton County,2021-Jun,21255,19904,1351,6.4
Wharton County,2021-Jul,21088,19848,1240,5.9
Wharton County,2021-Aug,21165,19993,1172,5.5
Wharton County,2021-Sep,21100,20034,1066,5.1
Wharton County,2021-Oct,21043,20044,999,4.7
Wharton County,2021-Nov,20864,19910,954,4.6
Wharton County,2021-Dec,20780,19880,900,4.3
Wharton County,2022-Jan,20675,19663,1012,4.9
Wharton County,2022-Feb,21220,20214,1006,4.7
Wharton County,2022-Mar,21553,20736,817,3.8
Wharton County,2022-Apr,21223,20456,767,3.6
Wharton County,2022-May,21033,20248,785,3.7
Wharton County,2022-Jun,21214,20298,916,4.3
Wharton County,2022-Jul,21385(P),20485(P),900(P),4.2(P)
Wheeler County,2012-Jan,2756,2631,125,4.5
Wheeler County,2012-Feb,2786,2663,123,4.4
Wheeler County,2012-Mar,2895,2781,114,3.9
Wheeler County,2012-Apr,2992,2880,112,3.7
Wheeler County,2012-May,3034,2913,121,4
Wheeler County,2012-Jun,2909,2768,141,4.8
Wheeler County,2012-Jul,2927,2776,151,5.2
Wheeler County,2012-Aug,2852,2721,131,4.6
Wheeler County,2012-Sep,2876,2755,121,4.2
Wheeler County,2012-Oct,2878,2755,123,4.3
Wheeler County,2012-Nov,2883,2763,120,4.2
Wheeler County,2012-Dec,2875,2753,122,4.2
Wheeler County,2013-Jan,2878,2735,143,5
Wheeler County,2013-Feb,2854,2718,136,4.8
Wheeler County,2013-Mar,2880,2752,128,4.4
Wheeler County,2013-Apr,2959,2832,127,4.3
Wheeler County,2013-May,3110,2976,134,4.3
Wheeler County,2013-Jun,3223,3073,150,4.7
Wheeler County,2013-Jul,3330,3186,144,4.3
Wheeler County,2013-Aug,3276,3142,134,4.1
Wheeler County,2013-Sep,3402,3258,144,4.2
Wheeler County,2013-Oct,3287,3144,143,4.4
Wheeler County,2013-Nov,3195,3068,127,4
Wheeler County,2013-Dec,3162,3044,118,3.7
Wheeler County,2014-Jan,3040,2921,119,3.9
Wheeler County,2014-Feb,3047,2926,121,4
Wheeler County,2014-Mar,3091,2976,115,3.7
Wheeler County,2014-Apr,3125,3018,107,3.4
Wheeler County,2014-May,3113,2996,117,3.8
Wheeler County,2014-Jun,3148,3021,127,4
Wheeler County,2014-Jul,3202,3070,132,4.1
Wheeler County,2014-Aug,3147,3036,111,3.5
Wheeler County,2014-Sep,3186,3079,107,3.4
Wheeler County,2014-Oct,2991,2892,99,3.3
Wheeler County,2014-Nov,2931,2837,94,3.2
Wheeler County,2014-Dec,2895,2811,84,2.9
Wheeler County,2015-Jan,2887,2784,103,3.6
Wheeler County,2015-Feb,2873,2767,106,3.7
Wheeler County,2015-Mar,2892,2781,111,3.8
Wheeler County,2015-Apr,2780,2689,91,3.3
Wheeler County,2015-May,2854,2743,111,3.9
Wheeler County,2015-Jun,2883,2762,121,4.2
Wheeler County,2015-Jul,2832,2706,126,4.4
Wheeler County,2015-Aug,2842,2728,114,4
Wheeler County,2015-Sep,2854,2744,110,3.9
Wheeler County,2015-Oct,2772,2664,108,3.9
Wheeler County,2015-Nov,2696,2585,111,4.1
Wheeler County,2015-Dec,2701,2591,110,4.1
Wheeler County,2016-Jan,2547,2438,109,4.3
Wheeler County,2016-Feb,2635,2522,113,4.3
Wheeler County,2016-Mar,2607,2486,121,4.6
Wheeler County,2016-Apr,2539,2420,119,4.7
Wheeler County,2016-May,2593,2476,117,4.5
Wheeler County,2016-Jun,2563,2438,125,4.9
Wheeler County,2016-Jul,2477,2350,127,5.1
Wheeler County,2016-Aug,2440,2323,117,4.8
Wheeler County,2016-Sep,2363,2244,119,5
Wheeler County,2016-Oct,2360,2245,115,4.9
Wheeler County,2016-Nov,2332,2214,118,5.1
Wheeler County,2016-Dec,2344,2231,113,4.8
Wheeler County,2017-Jan,2280,2163,117,5.1
Wheeler County,2017-Feb,2285,2173,112,4.9
Wheeler County,2017-Mar,2333,2230,103,4.4
Wheeler County,2017-Apr,2328,2234,94,4
Wheeler County,2017-May,2426,2338,88,3.6
Wheeler County,2017-Jun,2392,2301,91,3.8
Wheeler County,2017-Jul,2321,2228,93,4
Wheeler County,2017-Aug,2341,2250,91,3.9
Wheeler County,2017-Sep,2291,2206,85,3.7
Wheeler County,2017-Oct,2334,2257,77,3.3
Wheeler County,2017-Nov,2312,2226,86,3.7
Wheeler County,2017-Dec,2377,2296,81,3.4
Wheeler County,2018-Jan,2511,2418,93,3.7
Wheeler County,2018-Feb,2518,2430,88,3.5
Wheeler County,2018-Mar,2543,2457,86,3.4
Wheeler County,2018-Apr,2469,2390,79,3.2
Wheeler County,2018-May,2417,2343,74,3.1
Wheeler County,2018-Jun,2302,2222,80,3.5
Wheeler County,2018-Jul,2333,2261,72,3.1
Wheeler County,2018-Aug,2419,2350,69,2.9
Wheeler County,2018-Sep,2394,2328,66,2.8
Wheeler County,2018-Oct,2338,2267,71,3
Wheeler County,2018-Nov,2316,2247,69,3
Wheeler County,2018-Dec,2278,2212,66,2.9
Wheeler County,2019-Jan,2163,2089,74,3.4
Wheeler County,2019-Feb,2232,2163,69,3.1
Wheeler County,2019-Mar,2242,2177,65,2.9
Wheeler County,2019-Apr,2191,2135,56,2.6
Wheeler County,2019-May,2232,2176,56,2.5
Wheeler County,2019-Jun,2241,2176,65,2.9
Wheeler County,2019-Jul,2309,2239,70,3
Wheeler County,2019-Aug,2298,2229,69,3
Wheeler County,2019-Sep,2227,2156,71,3.2
Wheeler County,2019-Oct,2235,2167,68,3
Wheeler County,2019-Nov,2235,2162,73,3.3
Wheeler County,2019-Dec,2239,2175,64,2.9
Wheeler County,2020-Jan,2251,2180,71,3.2
Wheeler County,2020-Feb,2199,2132,67,3
Wheeler County,2020-Mar,2179,2076,103,4.7
Wheeler County,2020-Apr,2084,1956,128,6.1
Wheeler County,2020-May,2110,1959,151,7.2
Wheeler County,2020-Jun,2109,1954,155,7.3
Wheeler County,2020-Jul,2162,2015,147,6.8
Wheeler County,2020-Aug,2253,2117,136,6
Wheeler County,2020-Sep,2211,2066,145,6.6
Wheeler County,2020-Oct,2212,2066,146,6.6
Wheeler County,2020-Nov,2155,1989,166,7.7
Wheeler County,2020-Dec,2164,1995,169,7.8
Wheeler County,2021-Jan,2087,1916,171,8.2
Wheeler County,2021-Feb,2117,1949,168,7.9
Wheeler County,2021-Mar,2170,2021,149,6.9
Wheeler County,2021-Apr,2142,2003,139,6.5
Wheeler County,2021-May,2113,1986,127,6
Wheeler County,2021-Jun,2135,1993,142,6.7
Wheeler County,2021-Jul,2040,1911,129,6.3
Wheeler County,2021-Aug,2068,1947,121,5.9
Wheeler County,2021-Sep,2048,1935,113,5.5
Wheeler County,2021-Oct,1994,1890,104,5.2
Wheeler County,2021-Nov,1945,1849,96,4.9
Wheeler County,2021-Dec,1937,1849,88,4.5
Wheeler County,2022-Jan,1892,1790,102,5.4
Wheeler County,2022-Feb,1949,1846,103,5.3
Wheeler County,2022-Mar,2019,1933,86,4.3
Wheeler County,2022-Apr,1967,1890,77,3.9
Wheeler County,2022-May,1941,1864,77,4
Wheeler County,2022-Jun,1957,1870,87,4.4
Wheeler County,2022-Jul,1983(P),1896(P),87(P),4.4(P)
Wichita County,2012-Jan,59018,55296,3722,6.3
Wichita County,2012-Feb,58944,55339,3605,6.1
Wichita County,2012-Mar,58837,55402,3435,5.8
Wichita County,2012-Apr,58510,55330,3180,5.4
Wichita County,2012-May,58639,55196,3443,5.9
Wichita County,2012-Jun,58800,54874,3926,6.7
Wichita County,2012-Jul,58574,54645,3929,6.7
Wichita County,2012-Aug,57850,54174,3676,6.4
Wichita County,2012-Sep,57841,54432,3409,5.9
Wichita County,2012-Oct,57637,54275,3362,5.8
Wichita County,2012-Nov,57671,54406,3265,5.7
Wichita County,2012-Dec,57646,54286,3360,5.8
Wichita County,2013-Jan,57637,53893,3744,6.5
Wichita County,2013-Feb,57363,53811,3552,6.2
Wichita County,2013-Mar,57260,53757,3503,6.1
Wichita County,2013-Apr,57368,54137,3231,5.6
Wichita County,2013-May,57512,54115,3397,5.9
Wichita County,2013-Jun,57776,54028,3748,6.5
Wichita County,2013-Jul,57567,53927,3640,6.3
Wichita County,2013-Aug,56922,53557,3365,5.9
Wichita County,2013-Sep,56874,53566,3308,5.8
Wichita County,2013-Oct,56652,53535,3117,5.5
Wichita County,2013-Nov,56934,53894,3040,5.3
Wichita County,2013-Dec,56820,53950,2870,5.1
Wichita County,2014-Jan,56607,53581,3026,5.3
Wichita County,2014-Feb,56686,53660,3026,5.3
Wichita County,2014-Mar,56821,53937,2884,5.1
Wichita County,2014-Apr,56313,53798,2515,4.5
Wichita County,2014-May,56361,53678,2683,4.8
Wichita County,2014-Jun,56899,53795,3104,5.5
Wichita County,2014-Jul,56913,53724,3189,5.6
Wichita County,2014-Aug,56590,53554,3036,5.4
Wichita County,2014-Sep,56307,53576,2731,4.9
Wichita County,2014-Oct,56120,53567,2553,4.5
Wichita County,2014-Nov,55965,53487,2478,4.4
Wichita County,2014-Dec,55560,53332,2228,4
Wichita County,2015-Jan,55372,52893,2479,4.5
Wichita County,2015-Feb,55332,52940,2392,4.3
Wichita County,2015-Mar,55125,52831,2294,4.2
Wichita County,2015-Apr,55325,53165,2160,3.9
Wichita County,2015-May,55428,53108,2320,4.2
Wichita County,2015-Jun,55627,53081,2546,4.6
Wichita County,2015-Jul,55588,53001,2587,4.7
Wichita County,2015-Aug,55204,52852,2352,4.3
Wichita County,2015-Sep,55018,52580,2438,4.4
Wichita County,2015-Oct,55262,52852,2410,4.4
Wichita County,2015-Nov,55502,53099,2403,4.3
Wichita County,2015-Dec,55388,53090,2298,4.1
Wichita County,2016-Jan,55199,52740,2459,4.5
Wichita County,2016-Feb,55501,53072,2429,4.4
Wichita County,2016-Mar,55673,53197,2476,4.4
Wichita County,2016-Apr,55478,53230,2248,4.1
Wichita County,2016-May,55206,52970,2236,4.1
Wichita County,2016-Jun,55693,53108,2585,4.6
Wichita County,2016-Jul,55896,53241,2655,4.7
Wichita County,2016-Aug,55391,52890,2501,4.5
Wichita County,2016-Sep,55009,52534,2475,4.5
Wichita County,2016-Oct,55396,53057,2339,4.2
Wichita County,2016-Nov,55574,53302,2272,4.1
Wichita County,2016-Dec,55807,53519,2288,4.1
Wichita County,2017-Jan,55414,52938,2476,4.5
Wichita County,2017-Feb,55794,53369,2425,4.3
Wichita County,2017-Mar,55813,53546,2267,4.1
Wichita County,2017-Apr,55826,53867,1959,3.5
Wichita County,2017-May,55536,53559,1977,3.6
Wichita County,2017-Jun,55703,53522,2181,3.9
Wichita County,2017-Jul,55838,53667,2171,3.9
Wichita County,2017-Aug,55400,53296,2104,3.8
Wichita County,2017-Sep,55436,53538,1898,3.4
Wichita County,2017-Oct,55294,53568,1726,3.1
Wichita County,2017-Nov,55967,54086,1881,3.4
Wichita County,2017-Dec,55883,54097,1786,3.2
Wichita County,2018-Jan,55728,53713,2015,3.6
Wichita County,2018-Feb,56140,54141,1999,3.6
Wichita County,2018-Mar,55906,53879,2027,3.6
Wichita County,2018-Apr,56040,54301,1739,3.1
Wichita County,2018-May,55845,54097,1748,3.1
Wichita County,2018-Jun,56224,54017,2207,3.9
Wichita County,2018-Jul,55971,53835,2136,3.8
Wichita County,2018-Aug,55360,53447,1913,3.5
Wichita County,2018-Sep,55290,53443,1847,3.3
Wichita County,2018-Oct,55522,53774,1748,3.1
Wichita County,2018-Nov,55889,54103,1786,3.2
Wichita County,2018-Dec,55960,54126,1834,3.3
Wichita County,2019-Jan,55724,53640,2084,3.7
Wichita County,2019-Feb,55657,53750,1907,3.4
Wichita County,2019-Mar,55364,53592,1772,3.2
Wichita County,2019-Apr,55089,53586,1503,2.7
Wichita County,2019-May,54953,53396,1557,2.8
Wichita County,2019-Jun,55649,53662,1987,3.6
Wichita County,2019-Jul,55724,53711,2013,3.6
Wichita County,2019-Aug,55385,53549,1836,3.3
Wichita County,2019-Sep,55464,53763,1701,3.1
Wichita County,2019-Oct,55132,53488,1644,3
Wichita County,2019-Nov,55381,53752,1629,2.9
Wichita County,2019-Dec,55445,53875,1570,2.8
Wichita County,2020-Jan,55714,53935,1779,3.2
Wichita County,2020-Feb,55759,54094,1665,3
Wichita County,2020-Mar,54939,52390,2549,4.6
Wichita County,2020-Apr,52518,47048,5470,10.4
Wichita County,2020-May,53603,48625,4978,9.3
Wichita County,2020-Jun,55106,50389,4717,8.6
Wichita County,2020-Jul,55365,50665,4700,8.5
Wichita County,2020-Aug,55385,51622,3763,6.8
Wichita County,2020-Sep,55207,51516,3691,6.7
Wichita County,2020-Oct,55499,52144,3355,6
Wichita County,2020-Nov,55790,52256,3534,6.3
Wichita County,2020-Dec,55799,52160,3639,6.5
Wichita County,2021-Jan,55591,51881,3710,6.7
Wichita County,2021-Feb,55919,52310,3609,6.5
Wichita County,2021-Mar,55643,52298,3345,6
Wichita County,2021-Apr,55319,52376,2943,5.3
Wichita County,2021-May,55149,52289,2860,5.2
Wichita County,2021-Jun,55699,52377,3322,6
Wichita County,2021-Jul,55453,52442,3011,5.4
Wichita County,2021-Aug,55158,52399,2759,5
Wichita County,2021-Sep,55206,52608,2598,4.7
Wichita County,2021-Oct,54860,52403,2457,4.5
Wichita County,2021-Nov,54943,52598,2345,4.3
Wichita County,2021-Dec,54959,52823,2136,3.9
Wichita County,2022-Jan,55151,52640,2511,4.6
Wichita County,2022-Feb,55530,53062,2468,4.4
Wichita County,2022-Mar,55468,53450,2018,3.6
Wichita County,2022-Apr,55040,53120,1920,3.5
Wichita County,2022-May,55194,53173,2021,3.7
Wichita County,2022-Jun,55771,53394,2377,4.3
Wichita County,2022-Jul,55590(P),53279(P),2311(P),4.2(P)
Wilbarger County,2012-Jan,5896,5509,387,6.6
Wilbarger County,2012-Feb,5871,5499,372,6.3
Wilbarger County,2012-Mar,5891,5541,350,5.9
Wilbarger County,2012-Apr,5930,5602,328,5.5
Wilbarger County,2012-May,5899,5545,354,6
Wilbarger County,2012-Jun,6001,5591,410,6.8
Wilbarger County,2012-Jul,6004,5596,408,6.8
Wilbarger County,2012-Aug,5912,5545,367,6.2
Wilbarger County,2012-Sep,5926,5596,330,5.6
Wilbarger County,2012-Oct,5893,5571,322,5.5
Wilbarger County,2012-Nov,5859,5556,303,5.2
Wilbarger County,2012-Dec,5839,5526,313,5.4
Wilbarger County,2013-Jan,5783,5414,369,6.4
Wilbarger County,2013-Feb,5768,5412,356,6.2
Wilbarger County,2013-Mar,5813,5486,327,5.6
Wilbarger County,2013-Apr,5889,5579,310,5.3
Wilbarger County,2013-May,5955,5618,337,5.7
Wilbarger County,2013-Jun,6015,5616,399,6.6
Wilbarger County,2013-Jul,5807,5435,372,6.4
Wilbarger County,2013-Aug,5695,5353,342,6
Wilbarger County,2013-Sep,5653,5313,340,6
Wilbarger County,2013-Oct,5628,5321,307,5.5
Wilbarger County,2013-Nov,5585,5293,292,5.2
Wilbarger County,2013-Dec,5612,5331,281,5
Wilbarger County,2014-Jan,5401,5108,293,5.4
Wilbarger County,2014-Feb,5352,5059,293,5.5
Wilbarger County,2014-Mar,5437,5170,267,4.9
Wilbarger County,2014-Apr,5398,5153,245,4.5
Wilbarger County,2014-May,5370,5109,261,4.9
Wilbarger County,2014-Jun,5386,5101,285,5.3
Wilbarger County,2014-Jul,5322,5030,292,5.5
Wilbarger County,2014-Aug,5189,4904,285,5.5
Wilbarger County,2014-Sep,5186,4932,254,4.9
Wilbarger County,2014-Oct,5155,4920,235,4.6
Wilbarger County,2014-Nov,5175,4940,235,4.5
Wilbarger County,2014-Dec,5077,4863,214,4.2
Wilbarger County,2015-Jan,5074,4818,256,5
Wilbarger County,2015-Feb,5082,4841,241,4.7
Wilbarger County,2015-Mar,5216,4980,236,4.5
Wilbarger County,2015-Apr,5163,4928,235,4.6
Wilbarger County,2015-May,5201,4927,274,5.3
Wilbarger County,2015-Jun,5217,4925,292,5.6
Wilbarger County,2015-Jul,5163,4886,277,5.4
Wilbarger County,2015-Aug,5067,4817,250,4.9
Wilbarger County,2015-Sep,5096,4855,241,4.7
Wilbarger County,2015-Oct,5073,4837,236,4.7
Wilbarger County,2015-Nov,4989,4764,225,4.5
Wilbarger County,2015-Dec,4999,4779,220,4.4
Wilbarger County,2016-Jan,5040,4804,236,4.7
Wilbarger County,2016-Feb,5089,4863,226,4.4
Wilbarger County,2016-Mar,5117,4885,232,4.5
Wilbarger County,2016-Apr,5088,4877,211,4.1
Wilbarger County,2016-May,5128,4906,222,4.3
Wilbarger County,2016-Jun,5117,4855,262,5.1
Wilbarger County,2016-Jul,5055,4782,273,5.4
Wilbarger County,2016-Aug,5064,4806,258,5.1
Wilbarger County,2016-Sep,5012,4767,245,4.9
Wilbarger County,2016-Oct,4969,4742,227,4.6
Wilbarger County,2016-Nov,4960,4735,225,4.5
Wilbarger County,2016-Dec,4959,4723,236,4.8
Wilbarger County,2017-Jan,4989,4731,258,5.2
Wilbarger County,2017-Feb,5055,4761,294,5.8
Wilbarger County,2017-Mar,5098,4828,270,5.3
Wilbarger County,2017-Apr,4995,4768,227,4.5
Wilbarger County,2017-May,4933,4711,222,4.5
Wilbarger County,2017-Jun,4886,4648,238,4.9
Wilbarger County,2017-Jul,4879,4650,229,4.7
Wilbarger County,2017-Aug,4842,4610,232,4.8
Wilbarger County,2017-Sep,4843,4633,210,4.3
Wilbarger County,2017-Oct,4864,4672,192,3.9
Wilbarger County,2017-Nov,4853,4648,205,4.2
Wilbarger County,2017-Dec,4859,4654,205,4.2
Wilbarger County,2018-Jan,4919,4674,245,5
Wilbarger County,2018-Feb,4923,4703,220,4.5
Wilbarger County,2018-Mar,4953,4739,214,4.3
Wilbarger County,2018-Apr,4906,4702,204,4.2
Wilbarger County,2018-May,4937,4746,191,3.9
Wilbarger County,2018-Jun,4890,4666,224,4.6
Wilbarger County,2018-Jul,4961,4755,206,4.2
Wilbarger County,2018-Aug,4914,4708,206,4.2
Wilbarger County,2018-Sep,4944,4745,199,4
Wilbarger County,2018-Oct,4922,4737,185,3.8
Wilbarger County,2018-Nov,4959,4768,191,3.9
Wilbarger County,2018-Dec,4926,4736,190,3.9
Wilbarger County,2019-Jan,4933,4716,217,4.4
Wilbarger County,2019-Feb,4927,4739,188,3.8
Wilbarger County,2019-Mar,4928,4744,184,3.7
Wilbarger County,2019-Apr,4891,4749,142,2.9
Wilbarger County,2019-May,4877,4727,150,3.1
Wilbarger County,2019-Jun,4905,4714,191,3.9
Wilbarger County,2019-Jul,4918,4717,201,4.1
Wilbarger County,2019-Aug,4868,4685,183,3.8
Wilbarger County,2019-Sep,4897,4737,160,3.3
Wilbarger County,2019-Oct,4908,4756,152,3.1
Wilbarger County,2019-Nov,4837,4675,162,3.3
Wilbarger County,2019-Dec,4837,4674,163,3.4
Wilbarger County,2020-Jan,4917,4731,186,3.8
Wilbarger County,2020-Feb,4936,4750,186,3.8
Wilbarger County,2020-Mar,4852,4581,271,5.6
Wilbarger County,2020-Apr,4633,4334,299,6.5
Wilbarger County,2020-May,4760,4436,324,6.8
Wilbarger County,2020-Jun,4820,4476,344,7.1
Wilbarger County,2020-Jul,4886,4564,322,6.6
Wilbarger County,2020-Aug,4998,4726,272,5.4
Wilbarger County,2020-Sep,4934,4660,274,5.6
Wilbarger County,2020-Oct,4928,4650,278,5.6
Wilbarger County,2020-Nov,4880,4563,317,6.5
Wilbarger County,2020-Dec,4882,4536,346,7.1
Wilbarger County,2021-Jan,4969,4599,370,7.4
Wilbarger County,2021-Feb,5037,4646,391,7.8
Wilbarger County,2021-Mar,5092,4707,385,7.6
Wilbarger County,2021-Apr,4996,4646,350,7
Wilbarger County,2021-May,4900,4580,320,6.5
Wilbarger County,2021-Jun,4884,4519,365,7.5
Wilbarger County,2021-Jul,4844,4519,325,6.7
Wilbarger County,2021-Aug,4847,4542,305,6.3
Wilbarger County,2021-Sep,4863,4580,283,5.8
Wilbarger County,2021-Oct,4796,4531,265,5.5
Wilbarger County,2021-Nov,4741,4484,257,5.4
Wilbarger County,2021-Dec,4717,4474,243,5.2
Wilbarger County,2022-Jan,4806,4525,281,5.8
Wilbarger County,2022-Feb,4867,4582,285,5.9
Wilbarger County,2022-Mar,4905,4668,237,4.8
Wilbarger County,2022-Apr,4799,4569,230,4.8
Wilbarger County,2022-May,4751,4519,232,4.9
Wilbarger County,2022-Jun,4734,4466,268,5.7
Wilbarger County,2022-Jul,4776(P),4518(P),258(P),5.4(P)
Willacy County,2012-Jan,7395,6123,1272,17.2
Willacy County,2012-Feb,7459,6158,1301,17.4
Willacy County,2012-Mar,7403,6218,1185,16
Willacy County,2012-Apr,7392,6293,1099,14.9
Willacy County,2012-May,7413,6265,1148,15.5
Willacy County,2012-Jun,7517,6302,1215,16.2
Willacy County,2012-Jul,7456,6262,1194,16
Willacy County,2012-Aug,7393,6256,1137,15.4
Willacy County,2012-Sep,7366,6260,1106,15
Willacy County,2012-Oct,7351,6276,1075,14.6
Willacy County,2012-Nov,7321,6258,1063,14.5
Willacy County,2012-Dec,7384,6222,1162,15.7
Willacy County,2013-Jan,7514,6226,1288,17.1
Willacy County,2013-Feb,7587,6313,1274,16.8
Willacy County,2013-Mar,7557,6363,1194,15.8
Willacy County,2013-Apr,7589,6419,1170,15.4
Willacy County,2013-May,7585,6395,1190,15.7
Willacy County,2013-Jun,7683,6415,1268,16.5
Willacy County,2013-Jul,7440,6219,1221,16.4
Willacy County,2013-Aug,7309,6121,1188,16.3
Willacy County,2013-Sep,7291,6134,1157,15.9
Willacy County,2013-Oct,7235,6113,1122,15.5
Willacy County,2013-Nov,7156,6098,1058,14.8
Willacy County,2013-Dec,7181,6152,1029,14.3
Willacy County,2014-Jan,7273,6148,1125,15.5
Willacy County,2014-Feb,7298,6212,1086,14.9
Willacy County,2014-Mar,7480,6452,1028,13.7
Willacy County,2014-Apr,7400,6493,907,12.3
Willacy County,2014-May,7329,6448,881,12
Willacy County,2014-Jun,7194,6244,950,13.2
Willacy County,2014-Jul,7069,6144,925,13.1
Willacy County,2014-Aug,7054,6176,878,12.4
Willacy County,2014-Sep,7032,6242,790,11.2
Willacy County,2014-Oct,7039,6306,733,10.4
Willacy County,2014-Nov,6986,6215,771,11
Willacy County,2014-Dec,6858,6144,714,10.4
Willacy County,2015-Jan,6958,6097,861,12.4
Willacy County,2015-Feb,7052,6211,841,11.9
Willacy County,2015-Mar,7047,6098,949,13.5
Willacy County,2015-Apr,6934,5996,938,13.5
Willacy County,2015-May,6865,5934,931,13.6
Willacy County,2015-Jun,6770,5778,992,14.7
Willacy County,2015-Jul,6691,5733,958,14.3
Willacy County,2015-Aug,6679,5764,915,13.7
Willacy County,2015-Sep,6556,5734,822,12.5
Willacy County,2015-Oct,6532,5695,837,12.8
Willacy County,2015-Nov,6510,5689,821,12.6
Willacy County,2015-Dec,6459,5681,778,12
Willacy County,2016-Jan,6490,5678,812,12.5
Willacy County,2016-Feb,6600,5786,814,12.3
Willacy County,2016-Mar,6678,5849,829,12.4
Willacy County,2016-Apr,6594,5793,801,12.1
Willacy County,2016-May,6593,5798,795,12.1
Willacy County,2016-Jun,6627,5733,894,13.5
Willacy County,2016-Jul,6496,5606,890,13.7
Willacy County,2016-Aug,6482,5657,825,12.7
Willacy County,2016-Sep,6482,5685,797,12.3
Willacy County,2016-Oct,6347,5640,707,11.1
Willacy County,2016-Nov,6357,5652,705,11.1
Willacy County,2016-Dec,6315,5607,708,11.2
Willacy County,2017-Jan,6343,5522,821,12.9
Willacy County,2017-Feb,6404,5583,821,12.8
Willacy County,2017-Mar,6515,5719,796,12.2
Willacy County,2017-Apr,6697,5901,796,11.9
Willacy County,2017-May,6467,5733,734,11.3
Willacy County,2017-Jun,6424,5664,760,11.8
Willacy County,2017-Jul,6085,5352,733,12
Willacy County,2017-Aug,6117,5437,680,11.1
Willacy County,2017-Sep,6064,5467,597,9.8
Willacy County,2017-Oct,6107,5567,540,8.8
Willacy County,2017-Nov,6061,5518,543,9
Willacy County,2017-Dec,6073,5516,557,9.2
Willacy County,2018-Jan,6267,5587,680,10.9
Willacy County,2018-Feb,6367,5654,713,11.2
Willacy County,2018-Mar,6506,5830,676,10.4
Willacy County,2018-Apr,6367,5670,697,10.9
Willacy County,2018-May,6329,5660,669,10.6
Willacy County,2018-Jun,6316,5579,737,11.7
Willacy County,2018-Jul,6260,5565,695,11.1
Willacy County,2018-Aug,6221,5646,575,9.2
Willacy County,2018-Sep,6297,5725,572,9.1
Willacy County,2018-Oct,6401,5877,524,8.2
Willacy County,2018-Nov,6340,5840,500,7.9
Willacy County,2018-Dec,6322,5805,517,8.2
Willacy County,2019-Jan,6389,5789,600,9.4
Willacy County,2019-Feb,6515,5925,590,9.1
Willacy County,2019-Mar,6524,5991,533,8.2
Willacy County,2019-Apr,6464,5946,518,8
Willacy County,2019-May,6430,5908,522,8.1
Willacy County,2019-Jun,6439,5835,604,9.4
Willacy County,2019-Jul,6408,5788,620,9.7
Willacy County,2019-Aug,6456,5921,535,8.3
Willacy County,2019-Sep,6576,6080,496,7.5
Willacy County,2019-Oct,6534,6063,471,7.2
Willacy County,2019-Nov,6437,5983,454,7.1
Willacy County,2019-Dec,6482,6022,460,7.1
Willacy County,2020-Jan,6541,6003,538,8.2
Willacy County,2020-Feb,6619,6091,528,8
Willacy County,2020-Mar,6736,5960,776,11.5
Willacy County,2020-Apr,6386,5392,994,15.6
Willacy County,2020-May,6549,5518,1031,15.7
Willacy County,2020-Jun,6584,5594,990,15
Willacy County,2020-Jul,6497,5562,935,14.4
Willacy County,2020-Aug,6554,5768,786,12
Willacy County,2020-Sep,6482,5742,740,11.4
Willacy County,2020-Oct,6542,5887,655,10
Willacy County,2020-Nov,6521,5830,691,10.6
Willacy County,2020-Dec,6590,5850,740,11.2
Willacy County,2021-Jan,7027,6215,812,11.6
Willacy County,2021-Feb,7140,6291,849,11.9
Willacy County,2021-Mar,7214,6394,820,11.4
Willacy County,2021-Apr,7174,6400,774,10.8
Willacy County,2021-May,6988,6252,736,10.5
Willacy County,2021-Jun,7029,6182,847,12.1
Willacy County,2021-Jul,6915,6138,777,11.2
Willacy County,2021-Aug,6944,6216,728,10.5
Willacy County,2021-Sep,6855,6209,646,9.4
Willacy County,2021-Oct,6835,6221,614,9
Willacy County,2021-Nov,6786,6196,590,8.7
Willacy County,2021-Dec,6802,6226,576,8.5
Willacy County,2022-Jan,7164,6463,701,9.8
Willacy County,2022-Feb,7341,6600,741,10.1
Willacy County,2022-Mar,7391,6768,623,8.4
Willacy County,2022-Apr,7488,6797,691,9.2
Willacy County,2022-May,7290,6621,669,9.2
Willacy County,2022-Jun,7259,6522,737,10.2
Willacy County,2022-Jul,7301(P),6557(P),744(P),10.2(P)
Williamson County,2012-Jan,233164,218290,14874,6.4
Williamson County,2012-Feb,234556,220023,14533,6.2
Williamson County,2012-Mar,234627,220996,13631,5.8
Williamson County,2012-Apr,235057,222275,12782,5.4
Williamson County,2012-May,236029,222453,13576,5.8
Williamson County,2012-Jun,237086,222095,14991,6.3
Williamson County,2012-Jul,237436,222397,15039,6.3
Williamson County,2012-Aug,236349,222315,14034,5.9
Williamson County,2012-Sep,237806,224641,13165,5.5
Williamson County,2012-Oct,239791,226871,12920,5.4
Williamson County,2012-Nov,240654,228203,12451,5.2
Williamson County,2012-Dec,239831,227073,12758,5.3
Williamson County,2013-Jan,242263,227769,14494,6
Williamson County,2013-Feb,243025,229329,13696,5.6
Williamson County,2013-Mar,243409,230261,13148,5.4
Williamson County,2013-Apr,245024,232615,12409,5.1
Williamson County,2013-May,245861,232875,12986,5.3
Williamson County,2013-Jun,246956,232751,14205,5.8
Williamson County,2013-Jul,247104,233228,13876,5.6
Williamson County,2013-Aug,246466,233213,13253,5.4
Williamson County,2013-Sep,247759,234534,13225,5.3
Williamson County,2013-Oct,247282,234576,12706,5.1
Williamson County,2013-Nov,249787,237804,11983,4.8
Williamson County,2013-Dec,248484,237267,11217,4.5
Williamson County,2014-Jan,251114,239036,12078,4.8
Williamson County,2014-Feb,253325,240943,12382,4.9
Williamson County,2014-Mar,254615,242700,11915,4.7
Williamson County,2014-Apr,254243,243822,10421,4.1
Williamson County,2014-May,254418,243338,11080,4.4
Williamson County,2014-Jun,255487,243616,11871,4.6
Williamson County,2014-Jul,256087,243777,12310,4.8
Williamson County,2014-Aug,255225,243202,12023,4.7
Williamson County,2014-Sep,255384,244171,11213,4.4
Williamson County,2014-Oct,256594,246137,10457,4.1
Williamson County,2014-Nov,257495,247211,10284,4
Williamson County,2014-Dec,255618,246423,9195,3.6
Williamson County,2015-Jan,259457,249064,10393,4
Williamson County,2015-Feb,260673,251012,9661,3.7
Williamson County,2015-Mar,260971,251874,9097,3.5
Williamson County,2015-Apr,262557,254230,8327,3.2
Williamson County,2015-May,263687,254692,8995,3.4
Williamson County,2015-Jun,264691,254973,9718,3.7
Williamson County,2015-Jul,264372,254491,9881,3.7
Williamson County,2015-Aug,263916,254761,9155,3.5
Williamson County,2015-Sep,265141,255989,9152,3.5
Williamson County,2015-Oct,266624,257711,8913,3.3
Williamson County,2015-Nov,268646,259836,8810,3.3
Williamson County,2015-Dec,268434,260217,8217,3.1
Williamson County,2016-Jan,272687,263729,8958,3.3
Williamson County,2016-Feb,275721,266793,8928,3.2
Williamson County,2016-Mar,276430,267461,8969,3.2
Williamson County,2016-Apr,276739,268480,8259,3
Williamson County,2016-May,276608,268238,8370,3
Williamson County,2016-Jun,278601,268734,9867,3.5
Williamson County,2016-Jul,280178,269918,10260,3.7
Williamson County,2016-Aug,279222,269247,9975,3.6
Williamson County,2016-Sep,281181,271004,10177,3.6
Williamson County,2016-Oct,282052,272305,9747,3.5
Williamson County,2016-Nov,283099,273692,9407,3.3
Williamson County,2016-Dec,282081,272586,9495,3.4
Williamson County,2017-Jan,283400,272806,10594,3.7
Williamson County,2017-Feb,285993,275187,10806,3.8
Williamson County,2017-Mar,286607,276531,10076,3.5
Williamson County,2017-Apr,287871,278916,8955,3.1
Williamson County,2017-May,287311,278206,9105,3.2
Williamson County,2017-Jun,288533,278572,9961,3.5
Williamson County,2017-Jul,289899,279969,9930,3.4
Williamson County,2017-Aug,288796,278837,9959,3.4
Williamson County,2017-Sep,291181,282128,9053,3.1
Williamson County,2017-Oct,290747,282329,8418,2.9
Williamson County,2017-Nov,291851,283040,8811,3
Williamson County,2017-Dec,291078,282610,8468,2.9
Williamson County,2018-Jan,295111,285580,9531,3.2
Williamson County,2018-Feb,299029,289291,9738,3.3
Williamson County,2018-Mar,298552,289093,9459,3.2
Williamson County,2018-Apr,300039,291417,8622,2.9
Williamson County,2018-May,299883,291359,8524,2.8
Williamson County,2018-Jun,302454,292257,10197,3.4
Williamson County,2018-Jul,302534,292646,9888,3.3
Williamson County,2018-Aug,300323,290700,9623,3.2
Williamson County,2018-Sep,301925,292623,9302,3.1
Williamson County,2018-Oct,304692,295773,8919,2.9
Williamson County,2018-Nov,305539,296671,8868,2.9
Williamson County,2018-Dec,304979,296149,8830,2.9
Williamson County,2019-Jan,309754,299364,10390,3.4
Williamson County,2019-Feb,312387,302859,9528,3.1
Williamson County,2019-Mar,311967,303024,8943,2.9
Williamson County,2019-Apr,312489,304769,7720,2.5
Williamson County,2019-May,312110,304183,7927,2.5
Williamson County,2019-Jun,314859,305467,9392,3
Williamson County,2019-Jul,316031,306404,9627,3
Williamson County,2019-Aug,315078,305782,9296,3
Williamson County,2019-Sep,316934,308015,8919,2.8
Williamson County,2019-Oct,319139,310571,8568,2.7
Williamson County,2019-Nov,320260,311821,8439,2.6
Williamson County,2019-Dec,319807,311977,7830,2.4
Williamson County,2020-Jan,326000,316899,9101,2.8
Williamson County,2020-Feb,328574,319870,8704,2.6
Williamson County,2020-Mar,321867,308388,13479,4.2
Williamson County,2020-Apr,301030,269245,31785,10.6
Williamson County,2020-May,310068,279837,30231,9.7
Williamson County,2020-Jun,316432,290743,25689,8.1
Williamson County,2020-Jul,319032,295894,23138,7.3
Williamson County,2020-Aug,321635,303230,18405,5.7
Williamson County,2020-Sep,323515,305949,17566,5.4
Williamson County,2020-Oct,327936,312783,15153,4.6
Williamson County,2020-Nov,329899,314171,15728,4.8
Williamson County,2020-Dec,330491,314942,15549,4.7
Williamson County,2021-Jan,329887,313479,16408,5
Williamson County,2021-Feb,332834,316509,16325,4.9
Williamson County,2021-Mar,333291,317692,15599,4.7
Williamson County,2021-Apr,335924,322099,13825,4.1
Williamson County,2021-May,336961,323602,13359,4
Williamson County,2021-Jun,340924,325696,15228,4.5
Williamson County,2021-Jul,342614,328803,13811,4
Williamson County,2021-Aug,342691,329585,13106,3.8
Williamson County,2021-Sep,343951,331570,12381,3.6
Williamson County,2021-Oct,347788,336002,11786,3.4
Williamson County,2021-Nov,350212,339118,11094,3.2
Williamson County,2021-Dec,349746,339633,10113,2.9
Williamson County,2022-Jan,349104,337572,11532,3.3
Williamson County,2022-Feb,353017,341294,11723,3.3
Williamson County,2022-Mar,353969,344432,9537,2.7
Williamson County,2022-Apr,351831,342951,8880,2.5
Williamson County,2022-May,351038,341548,9490,2.7
Williamson County,2022-Jun,353998,342925,11073,3.1
Williamson County,2022-Jul,354487(P),343671(P),10816(P),3.1(P)
Wilson County,2012-Jan,21378,20077,1301,6.1
Wilson County,2012-Feb,21473,20229,1244,5.8
Wilson County,2012-Mar,21492,20338,1154,5.4
Wilson County,2012-Apr,21556,20460,1096,5.1
Wilson County,2012-May,21638,20479,1159,5.4
Wilson County,2012-Jun,21854,20513,1341,6.1
Wilson County,2012-Jul,21891,20534,1357,6.2
Wilson County,2012-Aug,21762,20509,1253,5.8
Wilson County,2012-Sep,21763,20641,1122,5.2
Wilson County,2012-Oct,21780,20683,1097,5
Wilson County,2012-Nov,21795,20705,1090,5
Wilson County,2012-Dec,21779,20671,1108,5.1
Wilson County,2013-Jan,21839,20573,1266,5.8
Wilson County,2013-Feb,21911,20734,1177,5.4
Wilson County,2013-Mar,21928,20770,1158,5.3
Wilson County,2013-Apr,22082,20987,1095,5
Wilson County,2013-May,22184,21018,1166,5.3
Wilson County,2013-Jun,22399,21068,1331,5.9
Wilson County,2013-Jul,22461,21155,1306,5.8
Wilson County,2013-Aug,22300,21059,1241,5.6
Wilson County,2013-Sep,22320,21124,1196,5.4
Wilson County,2013-Oct,22128,21022,1106,5
Wilson County,2013-Nov,22249,21184,1065,4.8
Wilson County,2013-Dec,22196,21214,982,4.4
Wilson County,2014-Jan,22150,21103,1047,4.7
Wilson County,2014-Feb,22346,21285,1061,4.7
Wilson County,2014-Mar,22436,21435,1001,4.5
Wilson County,2014-Apr,22456,21588,868,3.9
Wilson County,2014-May,22534,21604,930,4.1
Wilson County,2014-Jun,22668,21650,1018,4.5
Wilson County,2014-Jul,22723,21675,1048,4.6
Wilson County,2014-Aug,22547,21567,980,4.3
Wilson County,2014-Sep,22541,21626,915,4.1
Wilson County,2014-Oct,22629,21758,871,3.8
Wilson County,2014-Nov,22648,21793,855,3.8
Wilson County,2014-Dec,22477,21700,777,3.5
Wilson County,2015-Jan,22582,21685,897,4
Wilson County,2015-Feb,22704,21855,849,3.7
Wilson County,2015-Mar,22751,21930,821,3.6
Wilson County,2015-Apr,22906,22125,781,3.4
Wilson County,2015-May,23030,22186,844,3.7
Wilson County,2015-Jun,23054,22113,941,4.1
Wilson County,2015-Jul,23098,22131,967,4.2
Wilson County,2015-Aug,23005,22095,910,4
Wilson County,2015-Sep,23053,22147,906,3.9
Wilson County,2015-Oct,23120,22234,886,3.8
Wilson County,2015-Nov,23261,22363,898,3.9
Wilson County,2015-Dec,23217,22376,841,3.6
Wilson County,2016-Jan,23230,22350,880,3.8
Wilson County,2016-Feb,23547,22656,891,3.8
Wilson County,2016-Mar,23664,22756,908,3.8
Wilson County,2016-Apr,23691,22834,857,3.6
Wilson County,2016-May,23721,22861,860,3.6
Wilson County,2016-Jun,23830,22804,1026,4.3
Wilson County,2016-Jul,23919,22880,1039,4.3
Wilson County,2016-Aug,23884,22890,994,4.2
Wilson County,2016-Sep,23909,22923,986,4.1
Wilson County,2016-Oct,23848,22933,915,3.8
Wilson County,2016-Nov,23957,23061,896,3.7
Wilson County,2016-Dec,23916,23013,903,3.8
Wilson County,2017-Jan,23754,22764,990,4.2
Wilson County,2017-Feb,23901,22928,973,4.1
Wilson County,2017-Mar,24001,23093,908,3.8
Wilson County,2017-Apr,24003,23203,800,3.3
Wilson County,2017-May,23939,23111,828,3.5
Wilson County,2017-Jun,24071,23166,905,3.8
Wilson County,2017-Jul,24122,23230,892,3.7
Wilson County,2017-Aug,24076,23195,881,3.7
Wilson County,2017-Sep,24156,23374,782,3.2
Wilson County,2017-Oct,23957,23252,705,2.9
Wilson County,2017-Nov,24035,23284,751,3.1
Wilson County,2017-Dec,24014,23289,725,3
Wilson County,2018-Jan,23956,23151,805,3.4
Wilson County,2018-Feb,24201,23414,787,3.3
Wilson County,2018-Mar,24261,23500,761,3.1
Wilson County,2018-Apr,24337,23648,689,2.8
Wilson County,2018-May,24301,23601,700,2.9
Wilson County,2018-Jun,24463,23607,856,3.5
Wilson County,2018-Jul,24460,23648,812,3.3
Wilson County,2018-Aug,24322,23546,776,3.2
Wilson County,2018-Sep,24328,23585,743,3.1
Wilson County,2018-Oct,24333,23630,703,2.9
Wilson County,2018-Nov,24372,23678,694,2.8
Wilson County,2018-Dec,24368,23655,713,2.9
Wilson County,2019-Jan,24327,23530,797,3.3
Wilson County,2019-Feb,24478,23734,744,3
Wilson County,2019-Mar,24500,23789,711,2.9
Wilson County,2019-Apr,24447,23845,602,2.5
Wilson County,2019-May,24428,23816,612,2.5
Wilson County,2019-Jun,24669,23895,774,3.1
Wilson County,2019-Jul,24734,23949,785,3.2
Wilson County,2019-Aug,24710,23985,725,2.9
Wilson County,2019-Sep,24726,24052,674,2.7
Wilson County,2019-Oct,24793,24118,675,2.7
Wilson County,2019-Nov,24819,24138,681,2.7
Wilson County,2019-Dec,24815,24187,628,2.5
Wilson County,2020-Jan,24802,24068,734,3
Wilson County,2020-Feb,24991,24272,719,2.9
Wilson County,2020-Mar,24492,23396,1096,4.5
Wilson County,2020-Apr,22206,20406,1800,8.1
Wilson County,2020-May,23355,21278,2077,8.9
Wilson County,2020-Jun,24049,22133,1916,8
Wilson County,2020-Jul,24092,22321,1771,7.4
Wilson County,2020-Aug,24366,22941,1425,5.8
Wilson County,2020-Sep,24449,23070,1379,5.6
Wilson County,2020-Oct,24661,23449,1212,4.9
Wilson County,2020-Nov,24741,23472,1269,5.1
Wilson County,2020-Dec,24764,23510,1254,5.1
Wilson County,2021-Jan,24615,23275,1340,5.4
Wilson County,2021-Feb,24782,23472,1310,5.3
Wilson County,2021-Mar,24837,23610,1227,4.9
Wilson County,2021-Apr,24866,23771,1095,4.4
Wilson County,2021-May,24872,23802,1070,4.3
Wilson County,2021-Jun,25101,23847,1254,5
Wilson County,2021-Jul,25122,23977,1145,4.6
Wilson County,2021-Aug,25060,23971,1089,4.3
Wilson County,2021-Sep,25124,24122,1002,4
Wilson County,2021-Oct,25171,24226,945,3.8
Wilson County,2021-Nov,25246,24348,898,3.6
Wilson County,2021-Dec,25182,24362,820,3.3
Wilson County,2022-Jan,25302,24339,963,3.8
Wilson County,2022-Feb,25674,24709,965,3.8
Wilson County,2022-Mar,25591,24816,775,3
Wilson County,2022-Apr,25439,24722,717,2.8
Wilson County,2022-May,25481,24714,767,3
Wilson County,2022-Jun,25648,24737,911,3.6
Wilson County,2022-Jul,25684(P),24796(P),888(P),3.5(P)
Winkler County,2012-Jan,3140,2952,188,6
Winkler County,2012-Feb,3160,2982,178,5.6
Winkler County,2012-Mar,3186,3013,173,5.4
Winkler County,2012-Apr,3165,2999,166,5.2
Winkler County,2012-May,3137,2964,173,5.5
Winkler County,2012-Jun,3161,2958,203,6.4
Winkler County,2012-Jul,3175,2970,205,6.5
Winkler County,2012-Aug,3185,3000,185,5.8
Winkler County,2012-Sep,3190,3021,169,5.3
Winkler County,2012-Oct,3236,3068,168,5.2
Winkler County,2012-Nov,3204,3037,167,5.2
Winkler County,2012-Dec,3201,3032,169,5.3
Winkler County,2013-Jan,3267,3075,192,5.9
Winkler County,2013-Feb,3240,3061,179,5.5
Winkler County,2013-Mar,3253,3086,167,5.1
Winkler County,2013-Apr,3245,3081,164,5.1
Winkler County,2013-May,3278,3104,174,5.3
Winkler County,2013-Jun,3277,3082,195,6
Winkler County,2013-Jul,3365,3171,194,5.8
Winkler County,2013-Aug,3416,3229,187,5.5
Winkler County,2013-Sep,3388,3210,178,5.3
Winkler County,2013-Oct,3345,3180,165,4.9
Winkler County,2013-Nov,3363,3208,155,4.6
Winkler County,2013-Dec,3349,3187,162,4.8
Winkler County,2014-Jan,3318,3144,174,5.2
Winkler County,2014-Feb,3274,3109,165,5
Winkler County,2014-Mar,3273,3117,156,4.8
Winkler County,2014-Apr,3246,3113,133,4.1
Winkler County,2014-May,3240,3100,140,4.3
Winkler County,2014-Jun,3327,3174,153,4.6
Winkler County,2014-Jul,3276,3115,161,4.9
Winkler County,2014-Aug,3280,3134,146,4.5
Winkler County,2014-Sep,3288,3141,147,4.5
Winkler County,2014-Oct,3304,3171,133,4
Winkler County,2014-Nov,3288,3159,129,3.9
Winkler County,2014-Dec,3258,3141,117,3.6
Winkler County,2015-Jan,3224,3082,142,4.4
Winkler County,2015-Feb,3126,2970,156,5
Winkler County,2015-Mar,3124,2958,166,5.3
Winkler County,2015-Apr,3124,2960,164,5.2
Winkler County,2015-May,3127,2946,181,5.8
Winkler County,2015-Jun,3129,2931,198,6.3
Winkler County,2015-Jul,3126,2924,202,6.5
Winkler County,2015-Aug,3094,2902,192,6.2
Winkler County,2015-Sep,3060,2879,181,5.9
Winkler County,2015-Oct,3046,2850,196,6.4
Winkler County,2015-Nov,3055,2868,187,6.1
Winkler County,2015-Dec,3021,2847,174,5.8
Winkler County,2016-Jan,3083,2890,193,6.3
Winkler County,2016-Feb,3099,2886,213,6.9
Winkler County,2016-Mar,3114,2884,230,7.4
Winkler County,2016-Apr,3081,2847,234,7.6
Winkler County,2016-May,3061,2815,246,8
Winkler County,2016-Jun,3089,2816,273,8.8
Winkler County,2016-Jul,3090,2815,275,8.9
Winkler County,2016-Aug,3043,2792,251,8.2
Winkler County,2016-Sep,2999,2744,255,8.5
Winkler County,2016-Oct,3059,2836,223,7.3
Winkler County,2016-Nov,3056,2833,223,7.3
Winkler County,2016-Dec,3075,2844,231,7.5
Winkler County,2017-Jan,3063,2833,230,7.5
Winkler County,2017-Feb,3127,2907,220,7
Winkler County,2017-Mar,3146,2944,202,6.4
Winkler County,2017-Apr,3135,2968,167,5.3
Winkler County,2017-May,3211,3033,178,5.5
Winkler County,2017-Jun,3201,3032,169,5.3
Winkler County,2017-Jul,3229,3071,158,4.9
Winkler County,2017-Aug,3228,3065,163,5
Winkler County,2017-Sep,3247,3104,143,4.4
Winkler County,2017-Oct,3320,3195,125,3.8
Winkler County,2017-Nov,3440,3310,130,3.8
Winkler County,2017-Dec,3468,3344,124,3.6
Winkler County,2018-Jan,3665,3536,129,3.5
Winkler County,2018-Feb,3806,3683,123,3.2
Winkler County,2018-Mar,3840,3718,122,3.2
Winkler County,2018-Apr,3840,3730,110,2.9
Winkler County,2018-May,3903,3797,106,2.7
Winkler County,2018-Jun,3926,3802,124,3.2
Winkler County,2018-Jul,4086,3969,117,2.9
Winkler County,2018-Aug,4032,3921,111,2.8
Winkler County,2018-Sep,4037,3928,109,2.7
Winkler County,2018-Oct,4207,4106,101,2.4
Winkler County,2018-Nov,4257,4147,110,2.6
Winkler County,2018-Dec,4232,4122,110,2.6
Winkler County,2019-Jan,4036,3916,120,3
Winkler County,2019-Feb,4063,3947,116,2.9
Winkler County,2019-Mar,4063,3953,110,2.7
Winkler County,2019-Apr,3877,3787,90,2.3
Winkler County,2019-May,3891,3791,100,2.6
Winkler County,2019-Jun,3942,3821,121,3.1
Winkler County,2019-Jul,4034,3909,125,3.1
Winkler County,2019-Aug,3992,3871,121,3
Winkler County,2019-Sep,4026,3904,122,3
Winkler County,2019-Oct,4036,3930,106,2.6
Winkler County,2019-Nov,4043,3922,121,3
Winkler County,2019-Dec,4104,3981,123,3
Winkler County,2020-Jan,4290,4147,143,3.3
Winkler County,2020-Feb,4287,4160,127,3
Winkler County,2020-Mar,4231,4028,203,4.8
Winkler County,2020-Apr,4100,3716,384,9.4
Winkler County,2020-May,3889,3361,528,13.6
Winkler County,2020-Jun,3868,3332,536,13.9
Winkler County,2020-Jul,3851,3326,525,13.6
Winkler County,2020-Aug,3766,3326,440,11.7
Winkler County,2020-Sep,3778,3345,433,11.5
Winkler County,2020-Oct,3738,3354,384,10.3
Winkler County,2020-Nov,3736,3358,378,10.1
Winkler County,2020-Dec,3754,3374,380,10.1
Winkler County,2021-Jan,3766,3391,375,10
Winkler County,2021-Feb,3804,3447,357,9.4
Winkler County,2021-Mar,3778,3446,332,8.8
Winkler County,2021-Apr,3726,3428,298,8
Winkler County,2021-May,3711,3432,279,7.5
Winkler County,2021-Jun,3743,3440,303,8.1
Winkler County,2021-Jul,3696,3419,277,7.5
Winkler County,2021-Aug,3679,3416,263,7.1
Winkler County,2021-Sep,3692,3435,257,7
Winkler County,2021-Oct,3689,3443,246,6.7
Winkler County,2021-Nov,3708,3475,233,6.3
Winkler County,2021-Dec,3725,3499,226,6.1
Winkler County,2022-Jan,3765,3512,253,6.7
Winkler County,2022-Feb,3757,3509,248,6.6
Winkler County,2022-Mar,3750,3547,203,5.4
Winkler County,2022-Apr,3669,3486,183,5
Winkler County,2022-May,3668,3491,177,4.8
Winkler County,2022-Jun,3697,3500,197,5.3
Winkler County,2022-Jul,3653(P),3460(P),193(P),5.3(P)
Wise County,2012-Jan,27783,25873,1910,6.9
Wise County,2012-Feb,27924,26017,1907,6.8
Wise County,2012-Mar,28028,26163,1865,6.7
Wise County,2012-Apr,27994,26328,1666,6
Wise County,2012-May,28142,26375,1767,6.3
Wise County,2012-Jun,28482,26447,2035,7.1
Wise County,2012-Jul,28445,26412,2033,7.1
Wise County,2012-Aug,28297,26388,1909,6.7
Wise County,2012-Sep,28265,26572,1693,6
Wise County,2012-Oct,28257,26613,1644,5.8
Wise County,2012-Nov,28299,26695,1604,5.7
Wise County,2012-Dec,28314,26662,1652,5.8
Wise County,2013-Jan,27982,26109,1873,6.7
Wise County,2013-Feb,28066,26287,1779,6.3
Wise County,2013-Mar,28106,26323,1783,6.3
Wise County,2013-Apr,28225,26611,1614,5.7
Wise County,2013-May,28399,26725,1674,5.9
Wise County,2013-Jun,28646,26730,1916,6.7
Wise County,2013-Jul,28660,26787,1873,6.5
Wise County,2013-Aug,28483,26735,1748,6.1
Wise County,2013-Sep,28555,26860,1695,5.9
Wise County,2013-Oct,28290,26689,1601,5.7
Wise County,2013-Nov,28407,26868,1539,5.4
Wise County,2013-Dec,28401,26948,1453,5.1
Wise County,2014-Jan,28034,26482,1552,5.5
Wise County,2014-Feb,28293,26738,1555,5.5
Wise County,2014-Mar,28487,26908,1579,5.5
Wise County,2014-Apr,28374,27078,1296,4.6
Wise County,2014-May,28488,27129,1359,4.8
Wise County,2014-Jun,28688,27153,1535,5.4
Wise County,2014-Jul,28697,27094,1603,5.6
Wise County,2014-Aug,28506,27012,1494,5.2
Wise County,2014-Sep,28466,27141,1325,4.7
Wise County,2014-Oct,28486,27256,1230,4.3
Wise County,2014-Nov,28498,27277,1221,4.3
Wise County,2014-Dec,28382,27267,1115,3.9
Wise County,2015-Jan,28280,27010,1270,4.5
Wise County,2015-Feb,28380,27135,1245,4.4
Wise County,2015-Mar,28502,27164,1338,4.7
Wise County,2015-Apr,28583,27388,1195,4.2
Wise County,2015-May,28778,27509,1269,4.4
Wise County,2015-Jun,28877,27400,1477,5.1
Wise County,2015-Jul,28856,27354,1502,5.2
Wise County,2015-Aug,28731,27327,1404,4.9
Wise County,2015-Sep,28666,27327,1339,4.7
Wise County,2015-Oct,28779,27425,1354,4.7
Wise County,2015-Nov,28872,27493,1379,4.8
Wise County,2015-Dec,28920,27613,1307,4.5
Wise County,2016-Jan,28837,27475,1362,4.7
Wise County,2016-Feb,29229,27855,1374,4.7
Wise County,2016-Mar,29343,27956,1387,4.7
Wise County,2016-Apr,29396,28100,1296,4.4
Wise County,2016-May,29463,28170,1293,4.4
Wise County,2016-Jun,29646,28057,1589,5.4
Wise County,2016-Jul,29639,28051,1588,5.4
Wise County,2016-Aug,29574,28094,1480,5
Wise County,2016-Sep,29556,28118,1438,4.9
Wise County,2016-Oct,29439,28104,1335,4.5
Wise County,2016-Nov,29584,28283,1301,4.4
Wise County,2016-Dec,29539,28259,1280,4.3
Wise County,2017-Jan,29471,28116,1355,4.6
Wise County,2017-Feb,29699,28328,1371,4.6
Wise County,2017-Mar,29957,28571,1386,4.6
Wise County,2017-Apr,29857,28717,1140,3.8
Wise County,2017-May,29806,28652,1154,3.9
Wise County,2017-Jun,30055,28703,1352,4.5
Wise County,2017-Jul,30106,28750,1356,4.5
Wise County,2017-Aug,30105,28815,1290,4.3
Wise County,2017-Sep,30079,28998,1081,3.6
Wise County,2017-Oct,29989,29002,987,3.3
Wise County,2017-Nov,30148,29106,1042,3.5
Wise County,2017-Dec,30102,29099,1003,3.3
Wise County,2018-Jan,30445,29321,1124,3.7
Wise County,2018-Feb,30756,29651,1105,3.6
Wise County,2018-Mar,30939,29750,1189,3.8
Wise County,2018-Apr,30834,29854,980,3.2
Wise County,2018-May,30869,29924,945,3.1
Wise County,2018-Jun,31095,29891,1204,3.9
Wise County,2018-Jul,31141,29932,1209,3.9
Wise County,2018-Aug,30998,29863,1135,3.7
Wise County,2018-Sep,30982,29955,1027,3.3
Wise County,2018-Oct,31076,30084,992,3.2
Wise County,2018-Nov,31129,30144,985,3.2
Wise County,2018-Dec,31132,30143,989,3.2
Wise County,2019-Jan,31449,30297,1152,3.7
Wise County,2019-Feb,31641,30586,1055,3.3
Wise County,2019-Mar,31771,30666,1105,3.5
Wise County,2019-Apr,31500,30649,851,2.7
Wise County,2019-May,31574,30705,869,2.8
Wise County,2019-Jun,31918,30739,1179,3.7
Wise County,2019-Jul,32085,30873,1212,3.8
Wise County,2019-Aug,32057,30983,1074,3.4
Wise County,2019-Sep,32089,31101,988,3.1
Wise County,2019-Oct,32243,31286,957,3
Wise County,2019-Nov,32385,31409,976,3
Wise County,2019-Dec,32378,31452,926,2.9
Wise County,2020-Jan,32330,31251,1079,3.3
Wise County,2020-Feb,32573,31511,1062,3.3
Wise County,2020-Mar,32229,30428,1801,5.6
Wise County,2020-Apr,29801,26704,3097,10.4
Wise County,2020-May,30866,27767,3099,10
Wise County,2020-Jun,31612,28755,2857,9
Wise County,2020-Jul,31845,29266,2579,8.1
Wise County,2020-Aug,32027,29979,2048,6.4
Wise County,2020-Sep,32024,30056,1968,6.1
Wise County,2020-Oct,32552,30793,1759,5.4
Wise County,2020-Nov,32609,30757,1852,5.7
Wise County,2020-Dec,32679,30824,1855,5.7
Wise County,2021-Jan,32512,30569,1943,6
Wise County,2021-Feb,32677,30788,1889,5.8
Wise County,2021-Mar,32852,31062,1790,5.4
Wise County,2021-Apr,32713,31133,1580,4.8
Wise County,2021-May,32634,31096,1538,4.7
Wise County,2021-Jun,32936,31094,1842,5.6
Wise County,2021-Jul,33020,31345,1675,5.1
Wise County,2021-Aug,33017,31494,1523,4.6
Wise County,2021-Sep,33226,31636,1590,4.8
Wise County,2021-Oct,33234,31858,1376,4.1
Wise County,2021-Nov,33503,32216,1287,3.8
Wise County,2021-Dec,33445,32274,1171,3.5
Wise County,2022-Jan,33355,31984,1371,4.1
Wise County,2022-Feb,33904,32540,1364,4
Wise County,2022-Mar,34084,32972,1112,3.3
Wise County,2022-Apr,33895,32857,1038,3.1
Wise County,2022-May,33901,32827,1074,3.2
Wise County,2022-Jun,34049,32705,1344,3.9
Wise County,2022-Jul,34268(P),33006(P),1262(P),3.7(P)
Wood County,2012-Jan,16634,15226,1408,8.5
Wood County,2012-Feb,16640,15266,1374,8.3
Wood County,2012-Mar,16639,15354,1285,7.7
Wood County,2012-Apr,16668,15482,1186,7.1
Wood County,2012-May,16710,15436,1274,7.6
Wood County,2012-Jun,16918,15514,1404,8.3
Wood County,2012-Jul,16800,15384,1416,8.4
Wood County,2012-Aug,16632,15285,1347,8.1
Wood County,2012-Sep,16771,15500,1271,7.6
Wood County,2012-Oct,16676,15424,1252,7.5
Wood County,2012-Nov,16612,15398,1214,7.3
Wood County,2012-Dec,16624,15403,1221,7.3
Wood County,2013-Jan,16618,15232,1386,8.3
Wood County,2013-Feb,16626,15324,1302,7.8
Wood County,2013-Mar,16635,15399,1236,7.4
Wood County,2013-Apr,16792,15611,1181,7
Wood County,2013-May,16870,15654,1216,7.2
Wood County,2013-Jun,16964,15662,1302,7.7
Wood County,2013-Jul,16778,15493,1285,7.7
Wood County,2013-Aug,16642,15417,1225,7.4
Wood County,2013-Sep,16732,15505,1227,7.3
Wood County,2013-Oct,16581,15415,1166,7
Wood County,2013-Nov,16556,15434,1122,6.8
Wood County,2013-Dec,16523,15468,1055,6.4
Wood County,2014-Jan,16445,15334,1111,6.8
Wood County,2014-Feb,16605,15485,1120,6.7
Wood County,2014-Mar,16726,15647,1079,6.5
Wood County,2014-Apr,16739,15825,914,5.5
Wood County,2014-May,16859,15863,996,5.9
Wood County,2014-Jun,16928,15871,1057,6.2
Wood County,2014-Jul,16870,15770,1100,6.5
Wood County,2014-Aug,16704,15635,1069,6.4
Wood County,2014-Sep,16701,15701,1000,6
Wood County,2014-Oct,16914,15971,943,5.6
Wood County,2014-Nov,16820,15902,918,5.5
Wood County,2014-Dec,16648,15812,836,5
Wood County,2015-Jan,16557,15619,938,5.7
Wood County,2015-Feb,16576,15686,890,5.4
Wood County,2015-Mar,16557,15690,867,5.2
Wood County,2015-Apr,16699,15885,814,4.9
Wood County,2015-May,16926,16040,886,5.2
Wood County,2015-Jun,16924,15967,957,5.7
Wood County,2015-Jul,16894,15906,988,5.8
Wood County,2015-Aug,16778,15867,911,5.4
Wood County,2015-Sep,16875,15977,898,5.3
Wood County,2015-Oct,16796,15918,878,5.2
Wood County,2015-Nov,16828,15947,881,5.2
Wood County,2015-Dec,16825,15972,853,5.1
Wood County,2016-Jan,16850,15974,876,5.2
Wood County,2016-Feb,17167,16292,875,5.1
Wood County,2016-Mar,17337,16466,871,5
Wood County,2016-Apr,17351,16522,829,4.8
Wood County,2016-May,17371,16531,840,4.8
Wood County,2016-Jun,17435,16467,968,5.6
Wood County,2016-Jul,17279,16289,990,5.7
Wood County,2016-Aug,17263,16284,979,5.7
Wood County,2016-Sep,17313,16315,998,5.8
Wood County,2016-Oct,17217,16311,906,5.3
Wood County,2016-Nov,17199,16324,875,5.1
Wood County,2016-Dec,17194,16290,904,5.3
Wood County,2017-Jan,17031,16057,974,5.7
Wood County,2017-Feb,17321,16356,965,5.6
Wood County,2017-Mar,17328,16467,861,5
Wood County,2017-Apr,17375,16600,775,4.5
Wood County,2017-May,17325,16542,783,4.5
Wood County,2017-Jun,17292,16455,837,4.8
Wood County,2017-Jul,17134,16295,839,4.9
Wood County,2017-Aug,17129,16310,819,4.8
Wood County,2017-Sep,17157,16404,753,4.4
Wood County,2017-Oct,17198,16490,708,4.1
Wood County,2017-Nov,17125,16386,739,4.3
Wood County,2017-Dec,17139,16440,699,4.1
Wood County,2018-Jan,17032,16258,774,4.5
Wood County,2018-Feb,17253,16466,787,4.6
Wood County,2018-Mar,17301,16538,763,4.4
Wood County,2018-Apr,17266,16584,682,3.9
Wood County,2018-May,17266,16602,664,3.8
Wood County,2018-Jun,17296,16495,801,4.6
Wood County,2018-Jul,17130,16374,756,4.4
Wood County,2018-Aug,17018,16270,748,4.4
Wood County,2018-Sep,17121,16386,735,4.3
Wood County,2018-Oct,17176,16461,715,4.2
Wood County,2018-Nov,17220,16498,722,4.2
Wood County,2018-Dec,17198,16489,709,4.1
Wood County,2019-Jan,17264,16464,800,4.6
Wood County,2019-Feb,17422,16675,747,4.3
Wood County,2019-Mar,17367,16682,685,3.9
Wood County,2019-Apr,17289,16695,594,3.4
Wood County,2019-May,17453,16864,589,3.4
Wood County,2019-Jun,17566,16867,699,4
Wood County,2019-Jul,17571,16846,725,4.1
Wood County,2019-Aug,17612,16906,706,4
Wood County,2019-Sep,17606,16926,680,3.9
Wood County,2019-Oct,17645,16990,655,3.7
Wood County,2019-Nov,17554,16895,659,3.8
Wood County,2019-Dec,17550,16914,636,3.6
Wood County,2020-Jan,17644,16915,729,4.1
Wood County,2020-Feb,17887,17190,697,3.9
Wood County,2020-Mar,17654,16592,1062,6
Wood County,2020-Apr,16553,14984,1569,9.5
Wood County,2020-May,17291,15717,1574,9.1
Wood County,2020-Jun,17720,16199,1521,8.6
Wood County,2020-Jul,17817,16403,1414,7.9
Wood County,2020-Aug,18009,16863,1146,6.4
Wood County,2020-Sep,18056,16920,1136,6.3
Wood County,2020-Oct,18175,17146,1029,5.7
Wood County,2020-Nov,17950,16852,1098,6.1
Wood County,2020-Dec,17936,16831,1105,6.2
Wood County,2021-Jan,17869,16689,1180,6.6
Wood County,2021-Feb,18052,16862,1190,6.6
Wood County,2021-Mar,18177,17013,1164,6.4
Wood County,2021-Apr,18078,17076,1002,5.5
Wood County,2021-May,17991,17013,978,5.4
Wood County,2021-Jun,18068,16951,1117,6.2
Wood County,2021-Jul,18170,17156,1014,5.6
Wood County,2021-Aug,18041,17058,983,5.4
Wood County,2021-Sep,17938,17014,924,5.2
Wood County,2021-Oct,17960,17049,911,5.1
Wood County,2021-Nov,17780,16917,863,4.9
Wood County,2021-Dec,17723,16921,802,4.5
Wood County,2022-Jan,17681,16763,918,5.2
Wood County,2022-Feb,17972,17044,928,5.2
Wood County,2022-Mar,18100,17322,778,4.3
Wood County,2022-Apr,17804,17093,711,4
Wood County,2022-May,17751,16995,756,4.3
Wood County,2022-Jun,17877,17001,876,4.9
Wood County,2022-Jul,18015(P),17163(P),852(P),4.7(P)
Yoakum County,2012-Jan,4382,4194,188,4.3
Yoakum County,2012-Feb,4320,4138,182,4.2
Yoakum County,2012-Mar,4356,4186,170,3.9
Yoakum County,2012-Apr,4345,4183,162,3.7
Yoakum County,2012-May,4327,4156,171,4
Yoakum County,2012-Jun,4438,4248,190,4.3
Yoakum County,2012-Jul,4305,4114,191,4.4
Yoakum County,2012-Aug,4237,4060,177,4.2
Yoakum County,2012-Sep,4323,4157,166,3.8
Yoakum County,2012-Oct,4305,4142,163,3.8
Yoakum County,2012-Nov,4298,4139,159,3.7
Yoakum County,2012-Dec,4276,4123,153,3.6
Yoakum County,2013-Jan,4174,3995,179,4.3
Yoakum County,2013-Feb,4201,4033,168,4
Yoakum County,2013-Mar,4169,4007,162,3.9
Yoakum County,2013-Apr,4158,4005,153,3.7
Yoakum County,2013-May,4190,4023,167,4
Yoakum County,2013-Jun,4244,4061,183,4.3
Yoakum County,2013-Jul,4253,4073,180,4.2
Yoakum County,2013-Aug,4114,3950,164,4
Yoakum County,2013-Sep,4210,4046,164,3.9
Yoakum County,2013-Oct,4256,4103,153,3.6
Yoakum County,2013-Nov,4220,4073,147,3.5
Yoakum County,2013-Dec,4260,4119,141,3.3
Yoakum County,2014-Jan,4216,4069,147,3.5
Yoakum County,2014-Feb,4315,4167,148,3.4
Yoakum County,2014-Mar,4291,4150,141,3.3
Yoakum County,2014-Apr,4297,4181,116,2.7
Yoakum County,2014-May,4315,4187,128,3
Yoakum County,2014-Jun,4344,4202,142,3.3
Yoakum County,2014-Jul,4301,4155,146,3.4
Yoakum County,2014-Aug,4249,4116,133,3.1
Yoakum County,2014-Sep,4325,4199,126,2.9
Yoakum County,2014-Oct,4286,4165,121,2.8
Yoakum County,2014-Nov,4251,4133,118,2.8
Yoakum County,2014-Dec,4244,4139,105,2.5
Yoakum County,2015-Jan,4169,4030,139,3.3
Yoakum County,2015-Feb,4162,4022,140,3.4
Yoakum County,2015-Mar,4179,4031,148,3.5
Yoakum County,2015-Apr,4145,4001,144,3.5
Yoakum County,2015-May,4128,3967,161,3.9
Yoakum County,2015-Jun,4155,3983,172,4.1
Yoakum County,2015-Jul,3994,3825,169,4.2
Yoakum County,2015-Aug,3964,3809,155,3.9
Yoakum County,2015-Sep,3997,3842,155,3.9
Yoakum County,2015-Oct,3945,3793,152,3.9
Yoakum County,2015-Nov,3881,3729,152,3.9
Yoakum County,2015-Dec,3848,3696,152,4
Yoakum County,2016-Jan,3689,3522,167,4.5
Yoakum County,2016-Feb,3794,3621,173,4.6
Yoakum County,2016-Mar,3836,3640,196,5.1
Yoakum County,2016-Apr,3877,3687,190,4.9
Yoakum County,2016-May,3884,3701,183,4.7
Yoakum County,2016-Jun,3867,3665,202,5.2
Yoakum County,2016-Jul,3707,3508,199,5.4
Yoakum County,2016-Aug,3705,3520,185,5
Yoakum County,2016-Sep,3692,3525,167,4.5
Yoakum County,2016-Oct,3700,3530,170,4.6
Yoakum County,2016-Nov,3686,3523,163,4.4
Yoakum County,2016-Dec,3697,3537,160,4.3
Yoakum County,2017-Jan,3813,3643,170,4.5
Yoakum County,2017-Feb,3860,3695,165,4.3
Yoakum County,2017-Mar,3930,3775,155,3.9
Yoakum County,2017-Apr,3870,3729,141,3.6
Yoakum County,2017-May,3855,3718,137,3.6
Yoakum County,2017-Jun,3883,3740,143,3.7
Yoakum County,2017-Jul,3733,3601,132,3.5
Yoakum County,2017-Aug,3758,3624,134,3.6
Yoakum County,2017-Sep,3737,3619,118,3.2
Yoakum County,2017-Oct,3730,3626,104,2.8
Yoakum County,2017-Nov,3686,3572,114,3.1
Yoakum County,2017-Dec,3669,3563,106,2.9
Yoakum County,2018-Jan,3648,3531,117,3.2
Yoakum County,2018-Feb,3685,3573,112,3
Yoakum County,2018-Mar,3772,3664,108,2.9
Yoakum County,2018-Apr,3673,3575,98,2.7
Yoakum County,2018-May,3696,3603,93,2.5
Yoakum County,2018-Jun,3759,3641,118,3.1
Yoakum County,2018-Jul,3695,3584,111,3
Yoakum County,2018-Aug,3689,3575,114,3.1
Yoakum County,2018-Sep,3699,3594,105,2.8
Yoakum County,2018-Oct,3623,3525,98,2.7
Yoakum County,2018-Nov,3609,3510,99,2.7
Yoakum County,2018-Dec,3576,3479,97,2.7
Yoakum County,2019-Jan,3678,3566,112,3
Yoakum County,2019-Feb,3728,3615,113,3
Yoakum County,2019-Mar,3777,3673,104,2.8
Yoakum County,2019-Apr,3710,3623,87,2.3
Yoakum County,2019-May,3764,3672,92,2.4
Yoakum County,2019-Jun,3821,3701,120,3.1
Yoakum County,2019-Jul,3701,3588,113,3.1
Yoakum County,2019-Aug,3733,3622,111,3
Yoakum County,2019-Sep,3679,3569,110,3
Yoakum County,2019-Oct,3679,3569,110,3
Yoakum County,2019-Nov,3568,3461,107,3
Yoakum County,2019-Dec,3588,3483,105,2.9
Yoakum County,2020-Jan,3525,3400,125,3.5
Yoakum County,2020-Feb,3535,3413,122,3.5
Yoakum County,2020-Mar,3480,3291,189,5.4
Yoakum County,2020-Apr,3538,2987,551,15.6
Yoakum County,2020-May,3610,2917,693,19.2
Yoakum County,2020-Jun,3591,2924,667,18.6
Yoakum County,2020-Jul,3480,2881,599,17.2
Yoakum County,2020-Aug,3474,3003,471,13.6
Yoakum County,2020-Sep,3457,3004,453,13.1
Yoakum County,2020-Oct,3419,3026,393,11.5
Yoakum County,2020-Nov,3361,2968,393,11.7
Yoakum County,2020-Dec,3333,2976,357,10.7
Yoakum County,2021-Jan,3341,2985,356,10.7
Yoakum County,2021-Feb,3379,3042,337,10
Yoakum County,2021-Mar,3425,3120,305,8.9
Yoakum County,2021-Apr,3374,3096,278,8.2
Yoakum County,2021-May,3294,3041,253,7.7
Yoakum County,2021-Jun,3292,3001,291,8.8
Yoakum County,2021-Jul,3225,2969,256,7.9
Yoakum County,2021-Aug,3241,3006,235,7.3
Yoakum County,2021-Sep,3290,3080,210,6.4
Yoakum County,2021-Oct,3223,3025,198,6.1
Yoakum County,2021-Nov,3161,2974,187,5.9
Yoakum County,2021-Dec,3156,2980,176,5.6
Yoakum County,2022-Jan,3159,2963,196,6.2
Yoakum County,2022-Feb,3276,3084,192,5.9
Yoakum County,2022-Mar,3345,3183,162,4.8
Yoakum County,2022-Apr,3247,3096,151,4.7
Yoakum County,2022-May,3168,3015,153,4.8
Yoakum County,2022-Jun,3156,2986,170,5.4
Yoakum County,2022-Jul,3175(P),3011(P),164(P),5.2(P)
Young County,2012-Jan,8427,7896,531,6.3
Young County,2012-Feb,8384,7874,510,6.1
Young County,2012-Mar,8456,7981,475,5.6
Young County,2012-Apr,8501,8051,450,5.3
Young County,2012-May,8568,8086,482,5.6
Young County,2012-Jun,8712,8162,550,6.3
Young County,2012-Jul,8700,8146,554,6.4
Young County,2012-Aug,8573,8077,496,5.8
Young County,2012-Sep,8594,8131,463,5.4
Young County,2012-Oct,8569,8125,444,5.2
Young County,2012-Nov,8551,8127,424,5
Young County,2012-Dec,8557,8121,436,5.1
Young County,2013-Jan,8582,8083,499,5.8
Young County,2013-Feb,8548,8081,467,5.5
Young County,2013-Mar,8526,8085,441,5.2
Young County,2013-Apr,8559,8143,416,4.9
Young County,2013-May,8641,8201,440,5.1
Young County,2013-Jun,8675,8184,491,5.7
Young County,2013-Jul,8628,8149,479,5.6
Young County,2013-Aug,8539,8092,447,5.2
Young County,2013-Sep,8545,8104,441,5.2
Young County,2013-Oct,8500,8080,420,4.9
Young County,2013-Nov,8468,8060,408,4.8
Young County,2013-Dec,8461,8074,387,4.6
Young County,2014-Jan,8488,8094,394,4.6
Young County,2014-Feb,8538,8138,400,4.7
Young County,2014-Mar,8584,8211,373,4.3
Young County,2014-Apr,8615,8283,332,3.9
Young County,2014-May,8682,8326,356,4.1
Young County,2014-Jun,8764,8387,377,4.3
Young County,2014-Jul,8781,8387,394,4.5
Young County,2014-Aug,8670,8306,364,4.2
Young County,2014-Sep,8697,8347,350,4
Young County,2014-Oct,8779,8444,335,3.8
Young County,2014-Nov,8690,8364,326,3.8
Young County,2014-Dec,8596,8306,290,3.4
Young County,2015-Jan,8457,8107,350,4.1
Young County,2015-Feb,8473,8115,358,4.2
Young County,2015-Mar,8519,8139,380,4.5
Young County,2015-Apr,8529,8198,331,3.9
Young County,2015-May,8534,8158,376,4.4
Young County,2015-Jun,8549,8164,385,4.5
Young County,2015-Jul,8557,8158,399,4.7
Young County,2015-Aug,8398,8039,359,4.3
Young County,2015-Sep,8325,7954,371,4.5
Young County,2015-Oct,8374,8005,369,4.4
Young County,2015-Nov,8612,8254,358,4.2
Young County,2015-Dec,8343,8011,332,4
Young County,2016-Jan,8227,7886,341,4.1
Young County,2016-Feb,8309,7966,343,4.1
Young County,2016-Mar,8391,8024,367,4.4
Young County,2016-Apr,8391,8047,344,4.1
Young County,2016-May,8468,8120,348,4.1
Young County,2016-Jun,8460,8078,382,4.5
Young County,2016-Jul,8394,8000,394,4.7
Young County,2016-Aug,8355,7967,388,4.6
Young County,2016-Sep,8268,7873,395,4.8
Young County,2016-Oct,8174,7817,357,4.4
Young County,2016-Nov,8163,7808,355,4.3
Young County,2016-Dec,8139,7778,361,4.4
Young County,2017-Jan,7865,7491,374,4.8
Young County,2017-Feb,7938,7555,383,4.8
Young County,2017-Mar,7953,7624,329,4.1
Young County,2017-Apr,8061,7771,290,3.6
Young County,2017-May,8050,7756,294,3.7
Young County,2017-Jun,8168,7848,320,3.9
Young County,2017-Jul,8034,7722,312,3.9
Young County,2017-Aug,8039,7732,307,3.8
Young County,2017-Sep,8040,7762,278,3.5
Young County,2017-Oct,8066,7816,250,3.1
Young County,2017-Nov,7998,7734,264,3.3
Young County,2017-Dec,7978,7721,257,3.2
Young County,2018-Jan,7921,7624,297,3.7
Young County,2018-Feb,8018,7720,298,3.7
Young County,2018-Mar,8093,7801,292,3.6
Young County,2018-Apr,8069,7819,250,3.1
Young County,2018-May,8112,7861,251,3.1
Young County,2018-Jun,8163,7885,278,3.4
Young County,2018-Jul,8151,7886,265,3.3
Young County,2018-Aug,8122,7857,265,3.3
Young County,2018-Sep,8118,7866,252,3.1
Young County,2018-Oct,8119,7880,239,2.9
Young County,2018-Nov,8098,7853,245,3
Young County,2018-Dec,8074,7831,243,3
Young County,2019-Jan,7839,7563,276,3.5
Young County,2019-Feb,7866,7618,248,3.2
Young County,2019-Mar,7876,7640,236,3
Young County,2019-Apr,7915,7717,198,2.5
Young County,2019-May,7885,7679,206,2.6
Young County,2019-Jun,7963,7714,249,3.1
Young County,2019-Jul,7968,7705,263,3.3
Young County,2019-Aug,7969,7719,250,3.1
Young County,2019-Sep,7980,7747,233,2.9
Young County,2019-Oct,7953,7732,221,2.8
Young County,2019-Nov,7817,7591,226,2.9
Young County,2019-Dec,7804,7592,212,2.7
Young County,2020-Jan,7728,7489,239,3.1
Young County,2020-Feb,7773,7552,221,2.8
Young County,2020-Mar,7614,7259,355,4.7
Young County,2020-Apr,7277,6748,529,7.3
Young County,2020-May,7492,6969,523,7
Young County,2020-Jun,7718,7187,531,6.9
Young County,2020-Jul,7795,7296,499,6.4
Young County,2020-Aug,7834,7425,409,5.2
Young County,2020-Sep,7729,7327,402,5.2
Young County,2020-Oct,7809,7448,361,4.6
Young County,2020-Nov,7757,7355,402,5.2
Young County,2020-Dec,7697,7301,396,5.1
Young County,2021-Jan,7800,7372,428,5.5
Young County,2021-Feb,7983,7559,424,5.3
Young County,2021-Mar,8089,7656,433,5.4
Young County,2021-Apr,8223,7838,385,4.7
Young County,2021-May,8158,7783,375,4.6
Young County,2021-Jun,8184,7776,408,5
Young County,2021-Jul,8160,7795,365,4.5
Young County,2021-Aug,8109,7759,350,4.3
Young County,2021-Sep,8089,7759,330,4.1
Young County,2021-Oct,8078,7762,316,3.9
Young County,2021-Nov,7986,7693,293,3.7
Young County,2021-Dec,7929,7659,270,3.4
Young County,2022-Jan,7940,7625,315,4
Young County,2022-Feb,8086,7768,318,3.9
Young County,2022-Mar,8164,7902,262,3.2
Young County,2022-Apr,8120,7867,253,3.1
Young County,2022-May,8110,7849,261,3.2
Young County,2022-Jun,8145,7859,286,3.5
Young County,2022-Jul,8172(P),7896(P),276(P),3.4(P)
Zapata County,2012-Jan,6669,6211,458,6.9
Zapata County,2012-Feb,6695,6244,451,6.7
Zapata County,2012-Mar,6647,6232,415,6.2
Zapata County,2012-Apr,6615,6221,394,6
Zapata County,2012-May,6640,6235,405,6.1
Zapata County,2012-Jun,6783,6284,499,7.4
Zapata County,2012-Jul,6749,6258,491,7.3
Zapata County,2012-Aug,6792,6366,426,6.3
Zapata County,2012-Sep,6904,6511,393,5.7
Zapata County,2012-Oct,6968,6575,393,5.6
Zapata County,2012-Nov,7072,6669,403,5.7
Zapata County,2012-Dec,7091,6683,408,5.8
Zapata County,2013-Jan,7210,6727,483,6.7
Zapata County,2013-Feb,7147,6695,452,6.3
Zapata County,2013-Mar,7078,6655,423,6
Zapata County,2013-Apr,7098,6688,410,5.8
Zapata County,2013-May,7076,6629,447,6.3
Zapata County,2013-Jun,7121,6618,503,7.1
Zapata County,2013-Jul,7089,6600,489,6.9
Zapata County,2013-Aug,7048,6603,445,6.3
Zapata County,2013-Sep,6990,6566,424,6.1
Zapata County,2013-Oct,6909,6505,404,5.8
Zapata County,2013-Nov,6969,6550,419,6
Zapata County,2013-Dec,6865,6451,414,6
Zapata County,2014-Jan,6954,6526,428,6.2
Zapata County,2014-Feb,7004,6583,421,6
Zapata County,2014-Mar,6981,6594,387,5.5
Zapata County,2014-Apr,6967,6622,345,5
Zapata County,2014-May,6946,6597,349,5
Zapata County,2014-Jun,7007,6595,412,5.9
Zapata County,2014-Jul,7014,6601,413,5.9
Zapata County,2014-Aug,6848,6494,354,5.2
Zapata County,2014-Sep,6876,6536,340,4.9
Zapata County,2014-Oct,6867,6553,314,4.6
Zapata County,2014-Nov,6867,6554,313,4.6
Zapata County,2014-Dec,6816,6518,298,4.4
Zapata County,2015-Jan,6772,6427,345,5.1
Zapata County,2015-Feb,6740,6346,394,5.8
Zapata County,2015-Mar,6713,6272,441,6.6
Zapata County,2015-Apr,6612,6181,431,6.5
Zapata County,2015-May,6442,5971,471,7.3
Zapata County,2015-Jun,6383,5840,543,8.5
Zapata County,2015-Jul,5943,5390,553,9.3
Zapata County,2015-Aug,5885,5364,521,8.9
Zapata County,2015-Sep,5814,5308,506,8.7
Zapata County,2015-Oct,5727,5219,508,8.9
Zapata County,2015-Nov,5674,5159,515,9.1
Zapata County,2015-Dec,5620,5133,487,8.7
Zapata County,2016-Jan,5513,4979,534,9.7
Zapata County,2016-Feb,5477,4926,551,10.1
Zapata County,2016-Mar,5434,4855,579,10.7
Zapata County,2016-Apr,5243,4651,592,11.3
Zapata County,2016-May,5241,4679,562,10.7
Zapata County,2016-Jun,5276,4630,646,12.2
Zapata County,2016-Jul,5067,4430,637,12.6
Zapata County,2016-Aug,5010,4402,608,12.1
Zapata County,2016-Sep,4901,4363,538,11
Zapata County,2016-Oct,5132,4630,502,9.8
Zapata County,2016-Nov,5126,4631,495,9.7
Zapata County,2016-Dec,5096,4602,494,9.7
Zapata County,2017-Jan,5315,4800,515,9.7
Zapata County,2017-Feb,5320,4807,513,9.6
Zapata County,2017-Mar,5335,4854,481,9
Zapata County,2017-Apr,5462,5037,425,7.8
Zapata County,2017-May,5388,5013,375,7
Zapata County,2017-Jun,5444,5021,423,7.8
Zapata County,2017-Jul,5392,4993,399,7.4
Zapata County,2017-Aug,5374,4995,379,7.1
Zapata County,2017-Sep,5321,4988,333,6.3
Zapata County,2017-Oct,5208,4904,304,5.8
Zapata County,2017-Nov,5310,4973,337,6.3
Zapata County,2017-Dec,5341,5006,335,6.3
Zapata County,2018-Jan,5295,4920,375,7.1
Zapata County,2018-Feb,5346,4996,350,6.5
Zapata County,2018-Mar,5357,5024,333,6.2
Zapata County,2018-Apr,5354,5063,291,5.4
Zapata County,2018-May,5340,5069,271,5.1
Zapata County,2018-Jun,5358,5023,335,6.3
Zapata County,2018-Jul,5337,5032,305,5.7
Zapata County,2018-Aug,5262,4987,275,5.2
Zapata County,2018-Sep,5344,5079,265,5
Zapata County,2018-Oct,5209,4952,257,4.9
Zapata County,2018-Nov,5234,4983,251,4.8
Zapata County,2018-Dec,5262,5011,251,4.8
Zapata County,2019-Jan,5279,4980,299,5.7
Zapata County,2019-Feb,5232,4953,279,5.3
Zapata County,2019-Mar,5192,4943,249,4.8
Zapata County,2019-Apr,5187,4967,220,4.2
Zapata County,2019-May,5094,4873,221,4.3
Zapata County,2019-Jun,5041,4775,266,5.3
Zapata County,2019-Jul,5012,4720,292,5.8
Zapata County,2019-Aug,4975,4736,239,4.8
Zapata County,2019-Sep,4985,4755,230,4.6
Zapata County,2019-Oct,4881,4642,239,4.9
Zapata County,2019-Nov,4882,4623,259,5.3
Zapata County,2019-Dec,4931,4659,272,5.5
Zapata County,2020-Jan,4988,4682,306,6.1
Zapata County,2020-Feb,5018,4734,284,5.7
Zapata County,2020-Mar,5007,4580,427,8.5
Zapata County,2020-Apr,4411,3865,546,12.4
Zapata County,2020-May,4409,3697,712,16.1
Zapata County,2020-Jun,4435,3686,749,16.9
Zapata County,2020-Jul,4623,3891,732,15.8
Zapata County,2020-Aug,4615,4006,609,13.2
Zapata County,2020-Sep,4520,3915,605,13.4
Zapata County,2020-Oct,4560,3975,585,12.8
Zapata County,2020-Nov,4580,3956,624,13.6
Zapata County,2020-Dec,4514,3882,632,14
Zapata County,2021-Jan,4466,3828,638,14.3
Zapata County,2021-Feb,4419,3825,594,13.4
Zapata County,2021-Mar,4412,3861,551,12.5
Zapata County,2021-Apr,4343,3813,530,12.2
Zapata County,2021-May,4435,3851,584,13.2
Zapata County,2021-Jun,4555,3889,666,14.6
Zapata County,2021-Jul,4703,4117,586,12.5
Zapata County,2021-Aug,4683,4137,546,11.7
Zapata County,2021-Sep,4644,4145,499,10.7
Zapata County,2021-Oct,4585,4116,469,10.2
Zapata County,2021-Nov,4549,4107,442,9.7
Zapata County,2021-Dec,4511,4070,441,9.8
Zapata County,2022-Jan,4489,3997,492,11
Zapata County,2022-Feb,4463,3994,469,10.5
Zapata County,2022-Mar,4448,4068,380,8.5
Zapata County,2022-Apr,4335,3955,380,8.8
Zapata County,2022-May,4364,3994,370,8.5
Zapata County,2022-Jun,4450,4055,395,8.9
Zapata County,2022-Jul,4517(P),4146(P),371(P),8.2(P)
Zavala County,2012-Jan,4664,4005,659,14.1
Zavala County,2012-Feb,4623,3982,641,13.9
Zavala County,2012-Mar,4534,3939,595,13.1
Zavala County,2012-Apr,4496,3976,520,11.6
Zavala County,2012-May,4537,3982,555,12.2
Zavala County,2012-Jun,4487,3870,617,13.8
Zavala County,2012-Jul,4332,3700,632,14.6
Zavala County,2012-Aug,4271,3652,619,14.5
Zavala County,2012-Sep,4235,3657,578,13.6
Zavala County,2012-Oct,4187,3639,548,13.1
Zavala County,2012-Nov,4076,3552,524,12.9
Zavala County,2012-Dec,4088,3522,566,13.8
Zavala County,2013-Jan,4154,3516,638,15.4
Zavala County,2013-Feb,4097,3490,607,14.8
Zavala County,2013-Mar,4015,3445,570,14.2
Zavala County,2013-Apr,3998,3451,547,13.7
Zavala County,2013-May,3954,3378,576,14.6
Zavala County,2013-Jun,4138,3520,618,14.9
Zavala County,2013-Jul,4052,3411,641,15.8
Zavala County,2013-Aug,3988,3355,633,15.9
Zavala County,2013-Sep,3874,3295,579,14.9
Zavala County,2013-Oct,3942,3417,525,13.3
Zavala County,2013-Nov,3840,3294,546,14.2
Zavala County,2013-Dec,4018,3483,535,13.3
Zavala County,2014-Jan,3886,3308,578,14.9
Zavala County,2014-Feb,4045,3489,556,13.7
Zavala County,2014-Mar,4017,3488,529,13.2
Zavala County,2014-Apr,4029,3570,459,11.4
Zavala County,2014-May,4146,3683,463,11.2
Zavala County,2014-Jun,3864,3355,509,13.2
Zavala County,2014-Jul,3823,3294,529,13.8
Zavala County,2014-Aug,3803,3249,554,14.6
Zavala County,2014-Sep,3723,3258,465,12.5
Zavala County,2014-Oct,3793,3411,382,10.1
Zavala County,2014-Nov,3839,3462,377,9.8
Zavala County,2014-Dec,3787,3437,350,9.2
Zavala County,2015-Jan,3688,3268,420,11.4
Zavala County,2015-Feb,3883,3479,404,10.4
Zavala County,2015-Mar,3876,3475,401,10.3
Zavala County,2015-Apr,3894,3523,371,9.5
Zavala County,2015-May,3961,3584,377,9.5
Zavala County,2015-Jun,3733,3280,453,12.1
Zavala County,2015-Jul,3749,3265,484,12.9
Zavala County,2015-Aug,3732,3254,478,12.8
Zavala County,2015-Sep,3864,3453,411,10.6
Zavala County,2015-Oct,3767,3352,415,11
Zavala County,2015-Nov,3764,3301,463,12.3
Zavala County,2015-Dec,3812,3343,469,12.3
Zavala County,2016-Jan,3889,3412,477,12.3
Zavala County,2016-Feb,4015,3524,491,12.2
Zavala County,2016-Mar,4065,3540,525,12.9
Zavala County,2016-Apr,3986,3466,520,13
Zavala County,2016-May,3975,3482,493,12.4
Zavala County,2016-Jun,3817,3201,616,16.1
Zavala County,2016-Jul,3817,3176,641,16.8
Zavala County,2016-Aug,3830,3199,631,16.5
Zavala County,2016-Sep,3766,3166,600,15.9
Zavala County,2016-Oct,3754,3224,530,14.1
Zavala County,2016-Nov,3807,3329,478,12.6
Zavala County,2016-Dec,3928,3445,483,12.3
Zavala County,2017-Jan,3911,3401,510,13
Zavala County,2017-Feb,3903,3423,480,12.3
Zavala County,2017-Mar,3950,3511,439,11.1
Zavala County,2017-Apr,3844,3447,397,10.3
Zavala County,2017-May,3817,3443,374,9.8
Zavala County,2017-Jun,3723,3264,459,12.3
Zavala County,2017-Jul,3617,3162,455,12.6
Zavala County,2017-Aug,3619,3168,451,12.5
Zavala County,2017-Sep,3460,3075,385,11.1
Zavala County,2017-Oct,3513,3155,358,10.2
Zavala County,2017-Nov,3455,3100,355,10.3
Zavala County,2017-Dec,3656,3313,343,9.4
Zavala County,2018-Jan,3698,3326,372,10.1
Zavala County,2018-Feb,3687,3313,374,10.1
Zavala County,2018-Mar,3716,3365,351,9.4
Zavala County,2018-Apr,3642,3319,323,8.9
Zavala County,2018-May,3538,3219,319,9
Zavala County,2018-Jun,3594,3180,414,11.5
Zavala County,2018-Jul,3483,3099,384,11
Zavala County,2018-Aug,3465,3120,345,10
Zavala County,2018-Sep,3386,3060,326,9.6
Zavala County,2018-Oct,3373,3073,300,8.9
Zavala County,2018-Nov,3379,3101,278,8.2
Zavala County,2018-Dec,3367,3053,314,9.3
Zavala County,2019-Jan,3351,3007,344,10.3
Zavala County,2019-Feb,3309,3011,298,9
Zavala County,2019-Mar,3320,3047,273,8.2
Zavala County,2019-Apr,3220,2987,233,7.2
Zavala County,2019-May,3235,2996,239,7.4
Zavala County,2019-Jun,3254,2958,296,9.1
Zavala County,2019-Jul,3273,2955,318,9.7
Zavala County,2019-Aug,3302,3001,301,9.1
Zavala County,2019-Sep,3241,2975,266,8.2
Zavala County,2019-Oct,3386,3119,267,7.9
Zavala County,2019-Nov,3387,3127,260,7.7
Zavala County,2019-Dec,3437,3178,259,7.5
Zavala County,2020-Jan,3540,3244,296,8.4
Zavala County,2020-Feb,3539,3253,286,8.1
Zavala County,2020-Mar,3506,3079,427,12.2
Zavala County,2020-Apr,3186,2704,482,15.1
Zavala County,2020-May,3339,2731,608,18.2
Zavala County,2020-Jun,3393,2757,636,18.7
Zavala County,2020-Jul,3332,2726,606,18.2
Zavala County,2020-Aug,3316,2818,498,15
Zavala County,2020-Sep,3318,2820,498,15
Zavala County,2020-Oct,3323,2883,440,13.2
Zavala County,2020-Nov,3335,2839,496,14.9
Zavala County,2020-Dec,3307,2813,494,14.9
Zavala County,2021-Jan,3319,2795,524,15.8
Zavala County,2021-Feb,3334,2820,514,15.4
Zavala County,2021-Mar,3339,2864,475,14.2
Zavala County,2021-Apr,3350,2913,437,13
Zavala County,2021-May,3238,2845,393,12.1
Zavala County,2021-Jun,3288,2835,453,13.8
Zavala County,2021-Jul,3210,2789,421,13.1
Zavala County,2021-Aug,3224,2834,390,12.1
Zavala County,2021-Sep,3246,2888,358,11
Zavala County,2021-Oct,3282,2927,355,10.8
Zavala County,2021-Nov,3250,2914,336,10.3
Zavala County,2021-Dec,3232,2908,324,10
Zavala County,2022-Jan,3288,2911,377,11.5
Zavala County,2022-Feb,3329,2963,366,11
Zavala County,2022-Mar,3313,3007,306,9.2
Zavala County,2022-Apr,3317,3001,316,9.5
Zavala County,2022-May,3239,2926,313,9.7
Zavala County,2022-Jun,3261,2910,351,10.8
Zavala County,2022-Jul,3258(P),2911(P),347(P),10.7(P)
